사용일자,호선명,역명,승차 총 승객수,하차 총 승객수,승하차 총 승객수,등록일자
20201201,8호선,가락시장,7050,7931,14981,20201204
20201201,8호선,석촌,6902,7846,14748,20201204
20201201,8호선,잠실(송파구청),11865,13466,25331,20201204
20201201,8호선,몽촌토성(평화의문),4986,5191,10177,20201204
20201201,8호선,강동구청,9548,10062,19610,20201204
20201201,8호선,천호(풍납토성),13945,15417,29362,20201204
20201201,8호선,암사,17412,15561,32973,20201204
20201201,7호선,부평구청,10767,8840,19607,20201204
20201201,7호선,굴포천,7829,8399,16228,20201204
20201201,7호선,삼산체육관,4294,3939,8233,20201204
20201201,7호선,상동,10895,11272,22167,20201204
20201201,7호선,부천시청,10825,10794,21619,20201204
20201201,7호선,신중동,12868,12693,25561,20201204
20201201,7호선,춘의,9205,9050,18255,20201204
20201201,7호선,부천종합운동장,4053,3554,7607,20201204
20201201,7호선,까치울,6742,6430,13172,20201204
20201201,7호선,온수(성공회대입구),9748,8989,18737,20201204
20201201,7호선,천왕,9999,9567,19566,20201204
20201201,7호선,광명사거리,20575,20392,40967,20201204
20201201,7호선,철산,19363,19712,39075,20201204
20201201,7호선,가산디지털단지,44949,45150,90099,20201204
20201201,7호선,남구로,15568,16486,32054,20201204
20201201,7호선,대림(구로구청),7089,7022,14111,20201204
20201201,7호선,신풍,10591,10106,20697,20201204
20201201,7호선,보라매,8882,8833,17715,20201204
20201201,7호선,신대방삼거리,15043,14798,29841,20201204
20201201,7호선,장승배기,8839,8751,17590,20201204
20201201,7호선,상도,9408,9331,18739,20201204
20201201,7호선,숭실대입구(살피재),10627,10924,21551,20201204
20201201,7호선,남성,10330,9604,19934,20201204
20201201,7호선,이수,13558,13210,26768,20201204
20201201,7호선,내방,13418,13710,27128,20201204
20201201,7호선,고속터미널,12827,11346,24173,20201204
20201201,7호선,반포,4941,4801,9742,20201204
20201201,7호선,논현,18859,20020,38879,20201204
20201201,7호선,학동,23092,24310,47402,20201204
20201201,7호선,강남구청,14794,16026,30820,20201204
20201201,7호선,청담,18453,20299,38752,20201204
20201201,7호선,뚝섬유원지,6307,6205,12512,20201204
20201201,7호선,건대입구,10250,10482,20732,20201204
20201201,7호선,어린이대공원(세종대),10520,10387,20907,20201204
20201201,7호선,군자(능동),13191,10727,23918,20201204
20201201,7호선,중곡,9010,8568,17578,20201204
20201201,7호선,용마산(용마폭포공원),5570,5387,10957,20201204
20201201,7호선,사가정,15084,15033,30117,20201204
20201201,7호선,면목,14295,14021,28316,20201204
20201201,7호선,상봉(시외버스터미널),15332,14471,29803,20201204
20201201,7호선,중화,9937,9901,19838,20201204
20201201,7호선,먹골,9152,9047,18199,20201204
20201201,7호선,태릉입구,7243,6708,13951,20201204
20201201,7호선,공릉(서울과학기술대),9989,10210,20199,20201204
20201201,7호선,하계,15586,14864,30450,20201204
20201201,7호선,중계,12919,11943,24862,20201204
20201201,7호선,노원,16358,17226,33584,20201204
20201201,7호선,마들,10995,10615,21610,20201204
20201201,7호선,수락산,11269,11437,22706,20201204
20201201,7호선,도봉산,8317,9876,18193,20201204
20201201,7호선,장암,2173,811,2984,20201204
20201201,6호선,봉화산(서울의료원),8193,7618,15811,20201204
20201201,6호선,화랑대(서울여대입구),10295,8033,18328,20201204
20201201,6호선,태릉입구,4766,5281,10047,20201204
20201201,6호선,석계,11230,11217,22447,20201204
20201201,6호선,돌곶이,7912,7397,15309,20201204
20201201,6호선,상월곡(한국과학기술연구원),5770,5202,10972,20201204
20201201,6호선,월곡(동덕여대),10031,9987,20018,20201204
20201201,6호선,고려대(종암),6695,6476,13171,20201204
20201201,6호선,안암(고대병원앞),8349,8448,16797,20201204
20201201,6호선,보문,6500,5986,12486,20201204
20201201,6호선,창신,3216,2632,5848,20201204
20201201,6호선,동묘앞,7083,7184,14267,20201204
20201201,6호선,신당,6812,7254,14066,20201204
20201201,6호선,청구,3467,3719,7186,20201204
20201201,6호선,약수,3208,3212,6420,20201204
20201201,6호선,버티고개,2021,1916,3937,20201204
20201201,6호선,한강진,5868,6632,12500,20201204
20201201,6호선,이태원,7108,7298,14406,20201204
20201201,6호선,녹사평(용산구청),3620,3488,7108,20201204
20201201,6호선,삼각지,4799,4354,9153,20201204
20201201,6호선,효창공원앞,6177,5696,11873,20201204
20201201,6호선,공덕,16587,15840,32427,20201204
20201201,6호선,대흥(서강대앞),6913,7143,14056,20201204
20201201,6호선,광흥창(서강),7780,7588,15368,20201204
20201201,6호선,상수,5982,6434,12416,20201204
20201201,6호선,합정,10515,10233,20748,20201204
20201201,6호선,망원,11676,12754,24430,20201204
20201201,6호선,마포구청,12745,11657,24402,20201204
20201201,6호선,월드컵경기장(성산),3963,4113,8076,20201204
20201201,6호선,디지털미디어시티,12646,13839,26485,20201204
20201201,6호선,증산(명지대앞),9154,9052,18206,20201204
20201201,6호선,새절(신사),11575,10867,22442,20201204
20201201,6호선,구산,6269,4945,11214,20201204
20201201,6호선,독바위,2535,2688,5223,20201204
20201201,6호선,불광,3911,4040,7951,20201204
20201201,6호선,역촌,3397,3848,7245,20201204
20201201,6호선,응암,16102,15985,32087,20201204
20201201,5호선,하남풍산,4246,4301,8547,20201204
20201201,5호선,미사,11848,11796,23644,20201204
20201201,5호선,마천,5354,5380,10734,20201204
20201201,5호선,거여,7233,6840,14073,20201204
20201201,5호선,개롱,5569,5899,11468,20201204
20201201,5호선,오금,3393,3337,6730,20201204
20201201,5호선,방이,6096,6380,12476,20201204
20201201,5호선,올림픽공원(한국체대),3551,3000,6551,20201204
20201201,5호선,둔촌동,7441,7584,15025,20201204
20201201,5호선,상일동,14459,13215,27674,20201204
20201201,5호선,고덕,7839,7728,15567,20201204
20201201,5호선,명일,7605,7865,15470,20201204
20201201,5호선,굽은다리(강동구민회관앞),8354,8012,16366,20201204
20201201,5호선,길동,7040,7450,14490,20201204
20201201,5호선,강동,17569,16418,33987,20201204
20201201,5호선,천호(풍납토성),15532,15663,31195,20201204
20201201,5호선,광나루(장신대),11395,10379,21774,20201204
20201201,5호선,아차산(어린이대공원후문),12291,12352,24643,20201204
20201201,5호선,군자(능동),9823,10556,20379,20201204
20201201,5호선,장한평,16862,16854,33716,20201204
20201201,5호선,답십리,14678,13536,28214,20201204
20201201,5호선,마장,4975,4643,9618,20201204
20201201,5호선,왕십리(성동구청),3862,4225,8087,20201204
20201201,5호선,행당,7418,6627,14045,20201204
20201201,5호선,신금호,5349,5619,10968,20201204
20201201,5호선,청구,3709,3444,7153,20201204
20201201,5호선,동대문역사문화공원(DDP),2826,3147,5973,20201204
20201201,5호선,을지로4가,5735,5857,11592,20201204
20201201,5호선,종로3가,9245,9151,18396,20201204
20201201,5호선,광화문(세종문화회관),27490,28461,55951,20201204
20201201,5호선,서대문,16701,17041,33742,20201204
20201201,5호선,충정로(경기대입구),4619,4639,9258,20201204
20201201,5호선,애오개,5896,6105,12001,20201204
20201201,5호선,공덕,12887,13582,26469,20201204
20201201,5호선,마포,12973,13291,26264,20201204
20201201,5호선,여의나루,5684,5890,11574,20201204
20201201,5호선,여의도,24486,25151,49637,20201204
20201201,5호선,신길,3466,3941,7407,20201204
20201201,5호선,영등포시장,8263,8627,16890,20201204
20201201,5호선,영등포구청,3734,3807,7541,20201204
20201201,5호선,양평,6775,6866,13641,20201204
20201201,5호선,오목교(목동운동장앞),19283,20852,40135,20201204
20201201,5호선,목동,15196,16945,32141,20201204
20201201,5호선,신정(은행정),12928,10204,23132,20201204
20201201,5호선,까치산,25706,24684,50390,20201204
20201201,5호선,화곡,25392,23960,49352,20201204
20201201,5호선,우장산,11894,12048,23942,20201204
20201201,5호선,발산,16165,16409,32574,20201204
20201201,5호선,마곡,8192,7983,16175,20201204
20201201,5호선,송정,5830,5406,11236,20201204
20201201,5호선,김포공항,5297,5038,10335,20201204
20201201,5호선,개화산,4578,4419,8997,20201204
20201201,5호선,방화,5930,5663,11593,20201204
20201201,4호선,쌍문,27043,24814,51857,20201204
20201201,4호선,창동,22754,24336,47090,20201204
20201201,4호선,노원,16123,18200,34323,20201204
20201201,4호선,상계,17094,15925,33019,20201204
20201201,4호선,당고개,11282,10384,21666,20201204
20201201,4호선,남태령,974,860,1834,20201204
20201201,4호선,사당,20618,17238,37856,20201204
20201201,4호선,총신대입구(이수),16409,17954,34363,20201204
20201201,4호선,동작(현충원),2138,2253,4391,20201204
20201201,4호선,이촌(국립중앙박물관),6113,6757,12870,20201204
20201201,4호선,신용산,12202,12698,24900,20201204
20201201,4호선,삼각지,4099,4359,8458,20201204
20201201,4호선,숙대입구(갈월),10848,10682,21530,20201204
20201201,4호선,서울역,9570,12041,21611,20201204
20201201,4호선,회현(남대문시장),21323,22155,43478,20201204
20201201,4호선,명동,15219,15529,30748,20201204
20201201,4호선,충무로,24259,24877,49136,20201204
20201201,4호선,동대문역사문화공원(DDP),13212,12522,25734,20201204
20201201,4호선,동대문,18430,18667,37097,20201204
20201201,4호선,혜화,25299,25091,50390,20201204
20201201,4호선,한성대입구(삼선교),11733,11619,23352,20201204
20201201,4호선,성신여대입구(돈암),16706,16160,32866,20201204
20201201,4호선,길음,17946,17638,35584,20201204
20201201,4호선,미아사거리,24722,24246,48968,20201204
20201201,4호선,미아(서울사이버대학),13503,13262,26765,20201204
20201201,4호선,수유(강북구청),30691,30608,61299,20201204
20201201,3호선,오금,5621,4994,10615,20201204
20201201,3호선,경찰병원,6969,7089,14058,20201204
20201201,3호선,가락시장,8172,7954,16126,20201204
20201201,3호선,수서,13695,13992,27687,20201204
20201201,3호선,일원,8669,8507,17176,20201204
20201201,3호선,대청,8529,7878,16407,20201204
20201201,3호선,학여울,1566,1578,3144,20201204
20201201,3호선,대치,8758,8800,17558,20201204
20201201,3호선,도곡,4788,4787,9575,20201204
20201201,3호선,매봉,11519,10902,22421,20201204
20201201,3호선,양재(서초구청),34668,37303,71971,20201204
20201201,3호선,남부터미널(예술의전당),24971,25765,50736,20201204
20201201,3호선,교대(법원.검찰청),12384,8337,20721,20201204
20201201,3호선,고속터미널,30320,28993,59313,20201204
20201201,3호선,신사,25702,27050,52752,20201204
20201201,3호선,압구정,27951,29556,57507,20201204
20201201,3호선,옥수,7925,8232,16157,20201204
20201201,3호선,금호,7090,6783,13873,20201204
20201201,3호선,약수,11339,11211,22550,20201204
20201201,3호선,동대입구,6436,6737,13173,20201204
20201201,3호선,을지로3가,9447,9731,19178,20201204
20201201,3호선,종로3가,8799,10033,18832,20201204
20201201,3호선,안국,16326,16595,32921,20201204
20201201,3호선,경복궁(정부서울청사),15472,15133,30605,20201204
20201201,3호선,독립문,6381,6536,12917,20201204
20201201,3호선,무악재,3537,3597,7134,20201204
20201201,3호선,홍제,15292,14749,30041,20201204
20201201,3호선,녹번,13440,12605,26045,20201204
20201201,3호선,불광,14888,15917,30805,20201204
20201201,3호선,연신내,33155,31236,64391,20201204
20201201,3호선,구파발,18233,17136,35369,20201204
20201201,3호선,지축,2946,2912,5858,20201204
20201201,2호선,용두(동대문구청),2131,2176,4307,20201204
20201201,2호선,신정네거리,8671,9112,17783,20201204
20201201,2호선,양천구청,5916,6424,12340,20201204
20201201,2호선,도림천,1176,1277,2453,20201204
20201201,2호선,신설동,2730,2800,5530,20201204
20201201,2호선,신답,1424,1693,3117,20201204
20201201,2호선,용답,2360,2324,4684,20201204
20201201,2호선,충정로(경기대입구),9431,9970,19401,20201204
20201201,2호선,아현,8906,8691,17597,20201204
20201201,2호선,이대,10541,10852,21393,20201204
20201201,2호선,신촌,25380,26304,51684,20201204
20201201,2호선,홍대입구,36787,37900,74687,20201204
20201201,2호선,합정,24727,25681,50408,20201204
20201201,2호선,당산,16766,19676,36442,20201204
20201201,2호선,영등포구청,21335,21572,42907,20201204
20201201,2호선,문래,19121,19476,38597,20201204
20201201,2호선,신도림,42449,41177,83626,20201204
20201201,2호선,대림(구로구청),23100,23684,46784,20201204
20201201,2호선,구로디지털단지,55583,56033,111616,20201204
20201201,2호선,신대방,23816,23591,47407,20201204
20201201,2호선,신림,56607,55210,111817,20201204
20201201,2호선,봉천,22110,20675,42785,20201204
20201201,2호선,서울대입구(관악구청),41094,40295,81389,20201204
20201201,2호선,낙성대(강감찬),24017,23773,47790,20201204
20201201,2호선,사당,30669,33303,63972,20201204
20201201,2호선,방배,15030,15510,30540,20201204
20201201,2호선,서초,19284,19281,38565,20201204
20201201,2호선,교대(법원.검찰청),30913,34285,65198,20201204
20201201,2호선,강남,71889,69871,141760,20201204
20201201,2호선,역삼,46072,50080,96152,20201204
20201201,2호선,선릉,51866,45860,97726,20201204
20201201,2호선,삼성(무역센터),44475,44912,89387,20201204
20201201,2호선,종합운동장,5919,6368,12287,20201204
20201201,2호선,잠실새내,17070,16920,33990,20201204
20201201,2호선,잠실(송파구청),53069,53450,106519,20201204
20201201,2호선,잠실나루,13034,12599,25633,20201204
20201201,2호선,강변(동서울터미널),24981,24822,49803,20201204
20201201,2호선,구의(광진구청),20985,20788,41773,20201204
20201201,2호선,건대입구,26873,28594,55467,20201204
20201201,2호선,성수,30904,33371,64275,20201204
20201201,2호선,뚝섬,18018,19439,37457,20201204
20201201,2호선,한양대,6047,6268,12315,20201204
20201201,2호선,왕십리(성동구청),12862,10412,23274,20201204
20201201,2호선,상왕십리,12345,12172,24517,20201204
20201201,2호선,신당,12172,12561,24733,20201204
20201201,2호선,동대문역사문화공원(DDP),10157,11201,21358,20201204
20201201,2호선,을지로4가,12533,12080,24613,20201204
20201201,2호선,을지로3가,18606,18234,36840,20201204
20201201,2호선,을지로입구,35604,35841,71445,20201204
20201201,2호선,시청,21709,21024,42733,20201204
20201201,1호선,청량리(서울시립대입구),18035,18007,36042,20201204
20201201,1호선,제기동,15436,15902,31338,20201204
20201201,1호선,신설동,12591,12337,24928,20201204
20201201,1호선,동대문,9633,9282,18915,20201204
20201201,1호선,종로5가,19797,19485,39282,20201204
20201201,1호선,종로3가,21112,19187,40299,20201204
20201201,1호선,종각,30900,30029,60929,20201204
20201201,1호선,시청,19416,19293,38709,20201204
20201201,1호선,동묘앞,7174,7260,14434,20201204
20201201,1호선,서울역,34223,32123,66346,20201204
20201201,3호선,잠원,4130,4123,8253,20201204
20201201,중앙선,지평,32,28,60,20201204
20201201,중앙선,용문,1215,1311,2526,20201204
20201201,중앙선,원덕,284,252,536,20201204
20201201,중앙선,양평,1917,1909,3826,20201204
20201201,중앙선,오빈,242,238,480,20201204
20201201,중앙선,아신,422,433,855,20201204
20201201,중앙선,국수,492,518,1010,20201204
20201201,중앙선,신원,156,156,312,20201204
20201201,중앙선,양수,1409,1344,2753,20201204
20201201,중앙선,운길산,486,469,955,20201204
20201201,중앙선,팔당,627,613,1240,20201204
20201201,중앙선,도심,2177,1655,3832,20201204
20201201,중앙선,덕소,4793,4890,9683,20201204
20201201,9호선,증미,6464,6631,13095,20201204
20201201,중앙선,양정,745,625,1370,20201204
20201201,중앙선,양원,1356,1358,2714,20201204
20201201,중앙선,망우,6633,6539,13172,20201204
20201201,중앙선,상봉(시외버스터미널),5150,4963,10113,20201204
20201201,중앙선,중랑,4847,4682,9529,20201204
20201201,중앙선,회기,20349,19825,40174,20201204
20201201,장항선,신창(순천향대),1183,1222,2405,20201204
20201201,장항선,온양온천,2645,2643,5288,20201204
20201201,장항선,배방,750,733,1483,20201204
20201201,장항선,아산,2052,1877,3929,20201204
20201201,장항선,쌍용(나사렛대),1725,1597,3322,20201204
20201201,장항선,봉명,1077,1061,2138,20201204
20201201,일산선,대화,11557,8926,20483,20201204
20201201,일산선,주엽,7669,7674,15343,20201204
20201201,일산선,정발산,5798,5715,11513,20201204
20201201,일산선,마두,6652,6920,13572,20201204
20201201,일산선,백석,8861,8996,17857,20201204
20201201,일산선,대곡,1586,1156,2742,20201204
20201201,일산선,화정,14390,15082,29472,20201204
20201201,중앙선,도농,8655,7819,16474,20201204
20201201,일산선,원당,9950,9641,19591,20201204
20201201,일산선,삼송,15917,15659,31576,20201204
20201201,일산선,원흥,8262,7930,16192,20201204
20201201,우이신설선,신설동,2160,2055,4215,20201204
20201201,우이신설선,보문,1317,1305,2622,20201204
20201201,우이신설선,성신여대입구(돈암),2616,2841,5457,20201204
20201201,우이신설선,정릉,3871,3755,7626,20201204
20201201,우이신설선,북한산보국문,5091,5051,10142,20201204
20201201,우이신설선,솔샘,5048,4818,9866,20201204
20201201,우이신설선,삼양사거리,2164,2224,4388,20201204
20201201,우이신설선,삼양,1744,1955,3699,20201204
20201201,우이신설선,화계,2937,2891,5828,20201204
20201201,우이신설선,가오리,3540,3592,7132,20201204
20201201,우이신설선,4.19민주묘지,2374,2427,4801,20201204
20201201,우이신설선,솔밭공원,2139,2107,4246,20201204
20201201,우이신설선,북한산우이,2088,1769,3857,20201204
20201201,안산선,수리산,3910,3242,7152,20201204
20201201,안산선,오이도,7209,6947,14156,20201204
20201201,안산선,정왕,7845,8323,16168,20201204
20201201,안산선,신길온천,1534,1440,2974,20201204
20201201,안산선,안산,10998,9744,20742,20201204
20201201,안산선,초지,4404,4724,9128,20201204
20201201,안산선,고잔,7627,7497,15124,20201204
20201201,안산선,중앙,14263,14785,29048,20201204
20201201,안산선,한대앞,7287,7453,14740,20201204
20201201,안산선,상록수,14639,14767,29406,20201204
20201201,안산선,반월,3865,3627,7492,20201204
20201201,안산선,대야미,4479,4097,8576,20201204
20201201,안산선,산본,14355,15502,29857,20201204
20201201,수인선,인천,798,1309,2107,20201204
20201201,수인선,신포,1425,1364,2789,20201204
20201201,수인선,숭의,3456,3265,6721,20201204
20201201,수인선,인하대,4884,4608,9492,20201204
20201201,수인선,송도,2120,1936,4056,20201204
20201201,수인선,연수,3834,3779,7613,20201204
20201201,수인선,원인재,3731,3882,7613,20201204
20201201,수인선,남동인더스파크,2249,2512,4761,20201204
20201201,수인선,호구포,3188,3384,6572,20201204
20201201,수인선,인천논현,4663,4983,9646,20201204
20201201,수인선,소래포구,4117,3867,7984,20201204
20201201,수인선,월곶,2137,1991,4128,20201204
20201201,수인선,달월,86,61,147,20201204
20201201,수인선,사리,2910,2752,5662,20201204
20201201,수인선,야목,147,132,279,20201204
20201201,수인선,어천,445,468,913,20201204
20201201,수인선,오목천,1935,1844,3779,20201204
20201201,수인선,고색,2799,2615,5414,20201204
20201201,분당선,매교,2350,2374,4724,20201204
20201201,분당선,수원시청,10363,10970,21333,20201204
20201201,분당선,매탄권선,3849,3802,7651,20201204
20201201,중앙선,구리,11970,11946,23916,20201204
20201201,분당선,망포,12120,11672,23792,20201204
20201201,분당선,영통,6765,6964,13729,20201204
20201201,분당선,청명,3616,3485,7101,20201204
20201201,분당선,상갈,4534,4382,8916,20201204
20201201,분당선,기흥,7943,7790,15733,20201204
20201201,분당선,신갈,3886,3850,7736,20201204
20201201,분당선,구성,4265,4365,8630,20201204
20201201,분당선,죽전,11332,12380,23712,20201204
20201201,분당선,보정,2042,1718,3760,20201204
20201201,분당선,이매,4356,4179,8535,20201204
20201201,분당선,오리,10515,8935,19450,20201204
20201201,분당선,미금,13390,14154,27544,20201204
20201201,분당선,정자,13803,14653,28456,20201204
20201201,분당선,수내,11394,11496,22890,20201204
20201201,분당선,서현,20475,20726,41201,20201204
20201201,분당선,야탑,22365,23404,45769,20201204
20201201,분당선,모란,17322,17246,34568,20201204
20201201,분당선,태평,12008,11771,23779,20201204
20201201,분당선,가천대,6602,7646,14248,20201204
20201201,분당선,선정릉,7502,7951,15453,20201204
20201201,분당선,강남구청,8658,9909,18567,20201204
20201201,분당선,압구정로데오,14889,16053,30942,20201204
20201201,분당선,서울숲,7279,7276,14555,20201204
20201201,분당선,수원,6817,5656,12473,20201204
20201201,분당선,수서,10671,11002,21673,20201204
20201201,분당선,대모산입구,3191,2996,6187,20201204
20201201,분당선,개포동,3197,3260,6457,20201204
20201201,분당선,구룡,1528,1517,3045,20201204
20201201,분당선,도곡,5703,5772,11475,20201204
20201201,분당선,한티,11509,12438,23947,20201204
20201201,분당선,선릉,12500,18327,30827,20201204
20201201,과천선,범계,22182,21763,43945,20201204
20201201,과천선,평촌,16369,16221,32590,20201204
20201201,과천선,인덕원,21606,22506,44112,20201204
20201201,과천선,정부과천청사,8779,8436,17215,20201204
20201201,과천선,과천,4389,4090,8479,20201204
20201201,과천선,대공원,1568,1659,3227,20201204
20201201,과천선,경마공원,1291,1290,2581,20201204
20201201,과천선,선바위,7591,6801,14392,20201204
20201201,공항철도 1호선,영종,2375,2362,4737,20201204
20201201,공항철도 1호선,인천공항2터미널,1642,1657,3299,20201204
20201201,공항철도 1호선,인천공항1터미널,3003,3128,6131,20201204
20201201,공항철도 1호선,공항화물청사,2242,2425,4667,20201204
20201201,공항철도 1호선,운서,5029,5007,10036,20201204
20201201,공항철도 1호선,청라국제도시,5771,5321,11092,20201204
20201201,공항철도 1호선,검암,6285,6189,12474,20201204
20201201,공항철도 1호선,계양,8283,7682,15965,20201204
20201201,공항철도 1호선,김포공항,7868,4859,12727,20201204
20201201,공항철도 1호선,마곡나루(서울식물원),6527,6179,12706,20201204
20201201,공항철도 1호선,디지털미디어시티,12302,10903,23205,20201204
20201201,공항철도 1호선,홍대입구,5915,6157,12072,20201204
20201201,공항철도 1호선,공덕,1841,2378,4219,20201204
20201201,공항철도 1호선,서울역,5038,4669,9707,20201204
20201201,경춘선,춘천,838,796,1634,20201204
20201201,경춘선,남춘천,1533,1578,3111,20201204
20201201,경춘선,김유정,172,171,343,20201204
20201201,경춘선,강촌,312,358,670,20201204
20201201,경춘선,백양리,79,64,143,20201204
20201201,경춘선,굴봉산,68,69,137,20201204
20201201,경춘선,가평,987,958,1945,20201204
20201201,경춘선,상천,174,179,353,20201204
20201201,경춘선,청평,1065,1070,2135,20201204
20201201,경춘선,대성리,366,308,674,20201204
20201201,경춘선,마석,3184,3084,6268,20201204
20201201,경춘선,천마산,1449,1340,2789,20201204
20201201,경춘선,평내호평,5025,5037,10062,20201204
20201201,경춘선,금곡,1339,1264,2603,20201204
20201201,경춘선,사릉,3125,2981,6106,20201204
20201201,경춘선,퇴계원,3213,2936,6149,20201204
20201201,경춘선,별내,2368,2297,4665,20201204
20201201,경춘선,갈매,2732,2373,5105,20201204
20201201,경춘선,신내,1340,1374,2714,20201204
20201201,경인선,도화,3387,3206,6593,20201204
20201201,경인선,중동,8301,8011,16312,20201204
20201201,경인선,온수(성공회대입구),5712,5632,11344,20201204
20201201,경인선,도원,2467,2581,5048,20201204
20201201,경인선,간석,5048,4908,9956,20201204
20201201,경인선,부개,7521,7201,14722,20201204
20201201,경인선,소사,8599,8337,16936,20201204
20201201,경인선,구일,5521,5801,11322,20201204
20201201,경인선,인천,2780,2070,4850,20201204
20201201,경인선,동인천,11725,11301,23026,20201204
20201201,경인선,제물포,8916,8448,17364,20201204
20201201,경인선,주안,16221,14969,31190,20201204
20201201,경인선,동암,13827,13991,27818,20201204
20201201,경인선,백운,6367,6297,12664,20201204
20201201,경인선,부평,24879,26173,51052,20201204
20201201,경인선,송내,25299,25392,50691,20201204
20201201,경인선,부천,28956,29168,58124,20201204
20201201,경인선,역곡,24705,24793,49498,20201204
20201201,경인선,오류동,10588,10010,20598,20201204
20201201,경인선,개봉,19468,19963,39431,20201204
20201201,경의선,서울역,1018,125,1143,20201204
20201201,경의선,임진강,18,6,24,20201204
20201201,경의선,문산,4127,4109,8236,20201204
20201201,경의선,파주,1357,1190,2547,20201204
20201201,경의선,월롱,1769,1698,3467,20201204
20201201,경의선,금촌,5377,5430,10807,20201204
20201201,경의선,금릉,3811,3736,7547,20201204
20201201,경의선,운정,5391,5030,10421,20201204
20201201,경의선,야당,5148,4870,10018,20201204
20201201,경의선,탄현,6471,6272,12743,20201204
20201201,경의선,일산,7790,7880,15670,20201204
20201201,경의선,풍산,4550,4343,8893,20201204
20201201,경의선,백마,5899,5651,11550,20201204
20201201,경의선,곡산,498,536,1034,20201204
20201201,경의선,능곡,3268,2921,6189,20201204
20201201,경의선,행신,6731,6740,13471,20201204
20201201,경의선,강매,2697,2363,5060,20201204
20201201,경의선,화전,1381,1275,2656,20201204
20201201,경의선,수색,2380,2437,4817,20201204
20201201,경의선,디지털미디어시티,2122,1997,4119,20201204
20201201,경의선,가좌,4609,4251,8860,20201204
20201201,경의선,홍대입구,1168,1304,2472,20201204
20201201,경의선,서강대,1683,1649,3332,20201204
20201201,경의선,공덕,2912,2669,5581,20201204
20201201,경의선,효창공원앞,2545,2935,5480,20201204
20201201,경의선,신촌,718,899,1617,20201204
20201201,경의선,서울역,2691,4358,7049,20201204
20201201,경원선,소요산,2055,1740,3795,20201204
20201201,경원선,동두천,1852,2071,3923,20201204
20201201,경원선,보산,1231,1137,2368,20201204
20201201,경원선,동두천중앙,2639,2615,5254,20201204
20201201,경원선,지행,5391,5282,10673,20201204
20201201,경원선,덕정,4952,4874,9826,20201204
20201201,경원선,덕계,2441,2178,4619,20201204
20201201,경원선,양주,6566,6114,12680,20201204
20201201,경원선,녹양,4093,4005,8098,20201204
20201201,경원선,가능,5738,5511,11249,20201204
20201201,경원선,의정부,15409,15512,30921,20201204
20201201,경원선,회룡,11081,10993,22074,20201204
20201201,경원선,망월사,6645,6891,13536,20201204
20201201,경원선,도봉산,6794,4088,10882,20201204
20201201,경원선,도봉,5465,5324,10789,20201204
20201201,경원선,방학,8564,8452,17016,20201204
20201201,경원선,녹천,4337,3654,7991,20201204
20201201,경원선,월계,5615,5220,10835,20201204
20201201,경원선,광운대,7363,7148,14511,20201204
20201201,경원선,석계,7234,8391,15625,20201204
20201201,경원선,신이문,7939,7297,15236,20201204
20201201,경원선,외대앞,6231,6244,12475,20201204
20201201,경원선,청량리(서울시립대입구),11353,12550,23903,20201204
20201201,경원선,왕십리(성동구청),11033,12775,23808,20201204
20201201,경원선,응봉,1585,1367,2952,20201204
20201201,경원선,옥수,45,26,71,20201204
20201201,경원선,한남,3700,3506,7206,20201204
20201201,경원선,서빙고,1714,1558,3272,20201204
20201201,경원선,이촌(국립중앙박물관),3280,2523,5803,20201204
20201201,경부선,광명,2476,2180,4656,20201204
20201201,경부선,서동탄,1375,1132,2507,20201204
20201201,경부선,당정,5743,5435,11178,20201204
20201201,경부선,천안,3623,3748,7371,20201204
20201201,경부선,두정,4200,4187,8387,20201204
20201201,경부선,직산,620,626,1246,20201204
20201201,경부선,성환,3095,3114,6209,20201204
20201201,경부선,평택,9231,9066,18297,20201204
20201201,경부선,지제,2208,2142,4350,20201204
20201201,경부선,서정리,5207,4941,10148,20201204
20201201,경부선,송탄,3345,3319,6664,20201204
20201201,경부선,진위,1375,1198,2573,20201204
20201201,경부선,오산,7908,8073,15981,20201204
20201201,경부선,오산대,2721,2531,5252,20201204
20201201,경부선,세마,2193,1985,4178,20201204
20201201,경부선,병점,11379,11126,22505,20201204
20201201,경부선,세류,2635,2461,5096,20201204
20201201,경부선,독산,15539,16558,32097,20201204
20201201,경부선,수원,26492,27965,54457,20201204
20201201,경부선,화서,6389,6214,12603,20201204
20201201,경부선,성균관대,13086,13039,26125,20201204
20201201,경부선,의왕,8230,8230,16460,20201204
20201201,경부선,군포,7340,7348,14688,20201204
20201201,경부선,금정,23664,24335,47999,20201204
20201201,경부선,명학,8684,8550,17234,20201204
20201201,경부선,안양,19165,19588,38753,20201204
20201201,경부선,관악,6663,6126,12789,20201204
20201201,경부선,석수,9484,8183,17667,20201204
20201201,경부선,금천구청,10546,10414,20960,20201204
20201201,경부선,가산디지털단지,16816,19781,36597,20201204
20201201,경부선,구로,17511,17727,35238,20201204
20201201,경부선,신길,8463,7128,15591,20201204
20201201,경부선,신도림,3625,3550,7175,20201204
20201201,경부선,영등포,31071,32160,63231,20201204
20201201,경부선,대방,11894,12364,24258,20201204
20201201,경부선,노량진,7217,7499,14716,20201204
20201201,경부선,용산,23688,23957,47645,20201204
20201201,경부선,남영,8449,8754,17203,20201204
20201201,경부선,서울역,3240,1088,4328,20201204
20201201,경강선,여주,1331,1340,2671,20201204
20201201,경강선,세종대왕릉,217,200,417,20201204
20201201,경강선,부발,1519,1425,2944,20201204
20201201,경강선,이천,1788,1929,3717,20201204
20201201,경강선,신둔도예촌,991,931,1922,20201204
20201201,경강선,곤지암,1734,1732,3466,20201204
20201201,경강선,초월,2574,2528,5102,20201204
20201201,경강선,경기광주,5997,5756,11753,20201204
20201201,경강선,삼동,1985,1954,3939,20201204
20201201,경강선,이매,883,755,1638,20201204
20201201,경강선,판교,3799,3643,7442,20201204
20201201,9호선2~3단계,중앙보훈병원,8690,7848,16538,20201204
20201201,9호선2~3단계,둔촌오륜,798,722,1520,20201204
20201201,9호선2~3단계,올림픽공원(한국체대),4654,4508,9162,20201204
20201201,9호선2~3단계,한성백제,1996,1863,3859,20201204
20201201,9호선2~3단계,송파나루,3891,4021,7912,20201204
20201201,9호선2~3단계,석촌,6740,5939,12679,20201204
20201201,9호선2~3단계,석촌고분,5010,5012,10022,20201204
20201201,9호선2~3단계,삼전,5750,5611,11361,20201204
20201201,9호선2~3단계,종합운동장,3506,3508,7014,20201204
20201201,9호선2~3단계,봉은사,13601,13678,27279,20201204
20201201,9호선2~3단계,삼성중앙,6106,6343,12449,20201204
20201201,9호선2~3단계,선정릉,8456,8977,17433,20201204
20201201,9호선2~3단계,언주,8873,9027,17900,20201204
20201201,9호선,신논현,26493,26284,52777,20201204
20201201,9호선,사평,2594,2582,5176,20201204
20201201,9호선,고속터미널,8769,11117,19886,20201204
20201201,9호선,신반포,2553,2525,5078,20201204
20201201,9호선,구반포,2319,2383,4702,20201204
20201201,9호선,동작(현충원),1538,1204,2742,20201204
20201201,9호선,흑석(중앙대입구),6545,6865,13410,20201204
20201201,9호선,노들,3859,3478,7337,20201204
20201201,9호선,노량진,21718,21322,43040,20201204
20201201,9호선,샛강,4976,5172,10148,20201204
20201201,9호선,여의도,21023,20258,41281,20201204
20201201,9호선,국회의사당,14755,14633,29388,20201204
20201201,9호선,당산,15618,15627,31245,20201204
20201201,9호선,선유도,6755,6527,13282,20201204
20201201,9호선,신목동,3385,3094,6479,20201204
20201201,9호선,염창,15095,15056,30151,20201204
20201201,9호선,등촌,9762,9679,19441,20201204
20201201,9호선,가양,17961,17801,35762,20201204
20201201,9호선,양천향교,8506,8823,17329,20201204
20201201,9호선,마곡나루(서울식물원),9215,9176,18391,20201204
20201201,9호선,신방화,5949,5896,11845,20201204
20201201,9호선,공항시장,2485,2802,5287,20201204
20201201,9호선,김포공항,5814,7437,13251,20201204
20201201,9호선,개화,2235,1632,3867,20201204
20201201,8호선,모란,3557,2599,6156,20201204
20201201,8호선,수진,4477,4195,8672,20201204
20201201,8호선,신흥,3829,4164,7993,20201204
20201201,8호선,단대오거리,9206,8972,18178,20201204
20201201,8호선,남한산성입구(성남법원.검찰청),12697,11918,24615,20201204
20201201,8호선,산성,6330,6304,12634,20201204
20201201,8호선,복정,9420,8197,17617,20201204
20201201,8호선,장지,15315,14785,30100,20201204
20201201,8호선,문정,20568,21619,42187,20201204
20201201,8호선,송파,7054,7064,14118,20201204
20201202,1호선,서울역,34819,32245,67064,20201205
20201202,우이신설선,보문,1423,1360,2783,20201205
20201202,1호선,시청,19403,19465,38868,20201205
20201202,1호선,종각,31239,30098,61337,20201205
20201202,1호선,종로3가,22184,20204,42388,20201205
20201202,1호선,종로5가,19825,19554,39379,20201205
20201202,1호선,동대문,10053,9416,19469,20201205
20201202,1호선,신설동,13003,12827,25830,20201205
20201202,1호선,제기동,15514,15989,31503,20201205
20201202,1호선,청량리(서울시립대입구),18592,18451,37043,20201205
20201202,2호선,시청,21713,21023,42736,20201205
20201202,2호선,을지로입구,35239,35618,70857,20201205
20201202,2호선,을지로3가,18620,18131,36751,20201205
20201202,2호선,을지로4가,12450,12069,24519,20201205
20201202,2호선,동대문역사문화공원(DDP),10432,11499,21931,20201205
20201202,2호선,신당,12584,13011,25595,20201205
20201202,2호선,상왕십리,12724,12414,25138,20201205
20201202,2호선,왕십리(성동구청),13371,10798,24169,20201205
20201202,2호선,한양대,6189,6447,12636,20201205
20201202,2호선,뚝섬,18507,19947,38454,20201205
20201202,2호선,성수,31244,34127,65371,20201205
20201202,2호선,건대입구,27134,28873,56007,20201205
20201202,우이신설선,성신여대입구(돈암),2710,2921,5631,20201205
20201202,우이신설선,정릉,4041,3904,7945,20201205
20201202,우이신설선,북한산보국문,5280,5241,10521,20201205
20201202,우이신설선,솔샘,5141,5042,10183,20201205
20201202,분당선,복정,1,0,1,20201205
20201202,우이신설선,삼양사거리,2192,2211,4403,20201205
20201202,우이신설선,삼양,1775,1975,3750,20201205
20201202,우이신설선,화계,3003,2851,5854,20201205
20201202,우이신설선,가오리,3596,3687,7283,20201205
20201202,우이신설선,4.19민주묘지,2529,2484,5013,20201205
20201202,우이신설선,솔밭공원,2189,2082,4271,20201205
20201202,2호선,구의(광진구청),21392,21184,42576,20201205
20201202,우이신설선,북한산우이,2181,1987,4168,20201205
20201202,안산선,수리산,3902,3234,7136,20201205
20201202,안산선,오이도,7369,7117,14486,20201205
20201202,안산선,정왕,8027,8345,16372,20201205
20201202,안산선,신길온천,1476,1386,2862,20201205
20201202,안산선,안산,10888,9870,20758,20201205
20201202,안산선,초지,4766,5235,10001,20201205
20201202,안산선,고잔,7727,7420,15147,20201205
20201202,안산선,중앙,14428,14929,29357,20201205
20201202,안산선,한대앞,7525,7509,15034,20201205
20201202,안산선,상록수,14876,14881,29757,20201205
20201202,안산선,반월,3906,3763,7669,20201205
20201202,안산선,대야미,4549,4116,8665,20201205
20201202,2호선,강변(동서울터미널),25467,25302,50769,20201205
20201202,2호선,잠실나루,13057,12574,25631,20201205
20201202,2호선,잠실(송파구청),53829,53977,107806,20201205
20201202,2호선,잠실새내,17730,17490,35220,20201205
20201202,2호선,종합운동장,6242,6810,13052,20201205
20201202,2호선,삼성(무역센터),44736,45345,90081,20201205
20201202,2호선,선릉,51778,46078,97856,20201205
20201202,2호선,역삼,46627,50312,96939,20201205
20201202,2호선,강남,71388,67461,138849,20201205
20201202,2호선,교대(법원.검찰청),30820,34147,64967,20201205
20201202,2호선,서초,20001,20127,40128,20201205
20201202,2호선,방배,15054,15745,30799,20201205
20201202,2호선,사당,30990,33876,64866,20201205
20201202,2호선,낙성대(강감찬),24580,24111,48691,20201205
20201202,2호선,서울대입구(관악구청),41877,40458,82335,20201205
20201202,2호선,봉천,22392,20920,43312,20201205
20201202,2호선,신림,56859,55814,112673,20201205
20201202,2호선,신대방,24114,23510,47624,20201205
20201202,2호선,구로디지털단지,55902,56199,112101,20201205
20201202,2호선,대림(구로구청),23031,23536,46567,20201205
20201202,2호선,신도림,42841,41683,84524,20201205
20201202,2호선,문래,19498,19757,39255,20201205
20201202,2호선,영등포구청,21392,21628,43020,20201205
20201202,2호선,당산,17047,20069,37116,20201205
20201202,2호선,합정,25246,26140,51386,20201205
20201202,2호선,홍대입구,37273,38737,76010,20201205
20201202,2호선,신촌,26080,26997,53077,20201205
20201202,안산선,산본,14286,15407,29693,20201205
20201202,수인선,인천,820,1358,2178,20201205
20201202,수인선,신포,1459,1473,2932,20201205
20201202,수인선,숭의,3529,3380,6909,20201205
20201202,수인선,인하대,4998,4672,9670,20201205
20201202,수인선,송도,2181,2006,4187,20201205
20201202,수인선,연수,3873,3891,7764,20201205
20201202,수인선,원인재,3785,3997,7782,20201205
20201202,수인선,남동인더스파크,2223,2490,4713,20201205
20201202,수인선,호구포,3393,3457,6850,20201205
20201202,수인선,사리,2972,2872,5844,20201205
20201202,수인선,야목,170,126,296,20201205
20201202,수인선,어천,487,503,990,20201205
20201202,수인선,오목천,1910,1865,3775,20201205
20201202,수인선,고색,2858,2733,5591,20201205
20201202,분당선,매교,2509,2576,5085,20201205
20201202,분당선,수원시청,10473,11055,21528,20201205
20201202,분당선,매탄권선,4236,4034,8270,20201205
20201202,분당선,망포,12139,11594,23733,20201205
20201202,분당선,영통,6979,7123,14102,20201205
20201202,분당선,청명,3724,3542,7266,20201205
20201202,분당선,상갈,4639,4570,9209,20201205
20201202,분당선,기흥,8219,7927,16146,20201205
20201202,분당선,신갈,3998,4026,8024,20201205
20201202,분당선,구성,4194,4472,8666,20201205
20201202,분당선,죽전,11558,12560,24118,20201205
20201202,분당선,보정,2081,1809,3890,20201205
20201202,분당선,이매,4566,4428,8994,20201205
20201202,2호선,이대,10559,11139,21698,20201205
20201202,2호선,아현,9314,9136,18450,20201205
20201202,2호선,충정로(경기대입구),9492,9943,19435,20201205
20201202,2호선,용답,2388,2336,4724,20201205
20201202,2호선,신답,1402,1702,3104,20201205
20201202,2호선,신설동,2795,2863,5658,20201205
20201202,2호선,도림천,1278,1344,2622,20201205
20201202,2호선,양천구청,5990,6505,12495,20201205
20201202,2호선,신정네거리,8860,9179,18039,20201205
20201202,2호선,용두(동대문구청),2171,2232,4403,20201205
20201202,3호선,지축,2914,2855,5769,20201205
20201202,3호선,구파발,18450,17286,35736,20201205
20201202,3호선,연신내,33921,31909,65830,20201205
20201202,3호선,불광,15043,16109,31152,20201205
20201202,3호선,녹번,13706,12791,26497,20201205
20201202,3호선,홍제,15557,15309,30866,20201205
20201202,3호선,무악재,3581,3653,7234,20201205
20201202,3호선,독립문,6480,6747,13227,20201205
20201202,3호선,경복궁(정부서울청사),16458,15894,32352,20201205
20201202,3호선,안국,16455,16638,33093,20201205
20201202,3호선,종로3가,8936,10081,19017,20201205
20201202,3호선,을지로3가,9336,9487,18823,20201205
20201202,3호선,충무로,1,0,1,20201205
20201202,3호선,동대입구,6497,6754,13251,20201205
20201202,3호선,약수,11590,11363,22953,20201205
20201202,3호선,금호,7178,6970,14148,20201205
20201202,3호선,옥수,8044,8362,16406,20201205
20201202,3호선,압구정,28219,29820,58039,20201205
20201202,3호선,신사,25513,26585,52098,20201205
20201202,3호선,잠원,4138,4085,8223,20201205
20201202,3호선,고속터미널,30800,29762,60562,20201205
20201202,3호선,교대(법원.검찰청),12674,8462,21136,20201205
20201202,3호선,남부터미널(예술의전당),25129,25794,50923,20201205
20201202,3호선,양재(서초구청),35174,37770,72944,20201205
20201202,3호선,매봉,11385,10721,22106,20201205
20201202,3호선,도곡,4986,4924,9910,20201205
20201202,3호선,대치,8974,8897,17871,20201205
20201202,3호선,학여울,1546,1573,3119,20201205
20201202,3호선,대청,9020,8352,17372,20201205
20201202,3호선,일원,8852,8773,17625,20201205
20201202,3호선,수서,13917,14029,27946,20201205
20201202,3호선,가락시장,8155,8121,16276,20201205
20201202,3호선,경찰병원,7207,7212,14419,20201205
20201202,3호선,오금,5572,5077,10649,20201205
20201202,4호선,수유(강북구청),31285,31033,62318,20201205
20201202,4호선,미아(서울사이버대학),14073,13825,27898,20201205
20201202,4호선,미아사거리,25110,24901,50011,20201205
20201202,4호선,길음,18086,17857,35943,20201205
20201202,4호선,성신여대입구(돈암),17297,16591,33888,20201205
20201202,4호선,한성대입구(삼선교),12108,12045,24153,20201205
20201202,4호선,혜화,26433,26587,53020,20201205
20201202,4호선,동대문,18373,18875,37248,20201205
20201202,4호선,동대문역사문화공원(DDP),13624,12550,26174,20201205
20201202,4호선,충무로,24357,25099,49456,20201205
20201202,4호선,명동,15362,15896,31258,20201205
20201202,4호선,회현(남대문시장),21362,22213,43575,20201205
20201202,4호선,서울역,9619,12018,21637,20201205
20201202,4호선,숙대입구(갈월),11365,11153,22518,20201205
20201202,4호선,삼각지,4032,4416,8448,20201205
20201202,4호선,신용산,12883,13271,26154,20201205
20201202,4호선,이촌(국립중앙박물관),6236,6878,13114,20201205
20201202,4호선,동작(현충원),2071,2219,4290,20201205
20201202,4호선,총신대입구(이수),16935,18434,35369,20201205
20201202,4호선,사당,20953,17147,38100,20201205
20201202,4호선,남태령,959,866,1825,20201205
20201202,4호선,당고개,11371,10379,21750,20201205
20201202,4호선,상계,17510,16543,34053,20201205
20201202,4호선,노원,16532,18427,34959,20201205
20201202,4호선,창동,23310,24776,48086,20201205
20201202,4호선,쌍문,27602,25313,52915,20201205
20201202,5호선,방화,5980,5741,11721,20201205
20201202,5호선,개화산,4785,4496,9281,20201205
20201202,5호선,김포공항,5436,5389,10825,20201205
20201202,5호선,송정,5900,5566,11466,20201205
20201202,5호선,마곡,8294,8070,16364,20201205
20201202,5호선,발산,16678,16884,33562,20201205
20201202,5호선,우장산,12694,12728,25422,20201205
20201202,5호선,화곡,25821,24358,50179,20201205
20201202,5호선,까치산,25783,25045,50828,20201205
20201202,5호선,신정(은행정),13102,10388,23490,20201205
20201202,5호선,목동,15436,17298,32734,20201205
20201202,5호선,오목교(목동운동장앞),19409,21026,40435,20201205
20201202,5호선,양평,6944,6990,13934,20201205
20201202,5호선,영등포구청,3767,3806,7573,20201205
20201202,5호선,영등포시장,8417,8639,17056,20201205
20201202,5호선,신길,3570,3989,7559,20201205
20201202,5호선,여의도,24680,25269,49949,20201205
20201202,5호선,여의나루,6182,6366,12548,20201205
20201202,5호선,마포,13097,13358,26455,20201205
20201202,5호선,공덕,12780,13688,26468,20201205
20201202,5호선,애오개,6268,6324,12592,20201205
20201202,5호선,충정로(경기대입구),4581,4626,9207,20201205
20201202,5호선,서대문,17126,17355,34481,20201205
20201202,5호선,광화문(세종문화회관),27455,28258,55713,20201205
20201202,5호선,종로3가,9415,9506,18921,20201205
20201202,5호선,을지로4가,5823,5839,11662,20201205
20201202,5호선,동대문역사문화공원(DDP),2612,3066,5678,20201205
20201202,5호선,청구,3822,3454,7276,20201205
20201202,5호선,신금호,5559,5904,11463,20201205
20201202,5호선,행당,7612,6886,14498,20201205
20201202,5호선,왕십리(성동구청),4042,4316,8358,20201205
20201202,5호선,마장,4915,4667,9582,20201205
20201202,5호선,답십리,14831,13649,28480,20201205
20201202,5호선,장한평,16975,17024,33999,20201205
20201202,5호선,군자(능동),9996,10542,20538,20201205
20201202,5호선,아차산(어린이대공원후문),12622,12602,25224,20201205
20201202,5호선,광나루(장신대),11586,10609,22195,20201205
20201202,5호선,천호(풍납토성),15899,15987,31886,20201205
20201202,5호선,강동,17658,16332,33990,20201205
20201202,5호선,길동,7039,7454,14493,20201205
20201202,5호선,굽은다리(강동구민회관앞),8493,8156,16649,20201205
20201202,5호선,명일,7695,8097,15792,20201205
20201202,5호선,고덕,7905,8043,15948,20201205
20201202,5호선,상일동,14445,13214,27659,20201205
20201202,5호선,둔촌동,7435,7503,14938,20201205
20201202,5호선,올림픽공원(한국체대),3703,3155,6858,20201205
20201202,5호선,방이,6358,6538,12896,20201205
20201202,5호선,오금,3556,3440,6996,20201205
20201202,5호선,개롱,5831,6164,11995,20201205
20201202,5호선,거여,7249,6972,14221,20201205
20201202,5호선,마천,5355,5416,10771,20201205
20201202,5호선,미사,11882,11773,23655,20201205
20201202,5호선,하남풍산,4431,4358,8789,20201205
20201202,6호선,응암,16029,15958,31987,20201205
20201202,6호선,역촌,3365,4058,7423,20201205
20201202,6호선,불광,4083,4166,8249,20201205
20201202,6호선,독바위,2523,2777,5300,20201205
20201202,6호선,구산,6656,5153,11809,20201205
20201202,6호선,새절(신사),11867,11171,23038,20201205
20201202,6호선,증산(명지대앞),9322,9180,18502,20201205
20201202,6호선,디지털미디어시티,13023,14083,27106,20201205
20201202,6호선,월드컵경기장(성산),3933,4020,7953,20201205
20201202,6호선,마포구청,12792,11731,24523,20201205
20201202,6호선,망원,12089,13143,25232,20201205
20201202,6호선,합정,10706,10528,21234,20201205
20201202,6호선,상수,6148,6705,12853,20201205
20201202,6호선,광흥창(서강),8085,7951,16036,20201205
20201202,6호선,대흥(서강대앞),7353,7460,14813,20201205
20201202,6호선,공덕,16412,15932,32344,20201205
20201202,6호선,효창공원앞,6423,5802,12225,20201205
20201202,6호선,삼각지,4826,4261,9087,20201205
20201202,6호선,녹사평(용산구청),3807,3721,7528,20201205
20201202,6호선,이태원,7224,7468,14692,20201205
20201202,6호선,한강진,6038,6866,12904,20201205
20201202,6호선,버티고개,2058,1949,4007,20201205
20201202,6호선,약수,3192,3312,6504,20201205
20201202,6호선,청구,3458,3778,7236,20201205
20201202,6호선,신당,7200,7707,14907,20201205
20201202,6호선,동묘앞,7182,7438,14620,20201205
20201202,6호선,창신,3303,2670,5973,20201205
20201202,6호선,보문,6547,6097,12644,20201205
20201202,6호선,안암(고대병원앞),8336,8259,16595,20201205
20201202,6호선,고려대(종암),6732,6620,13352,20201205
20201202,6호선,월곡(동덕여대),10216,10199,20415,20201205
20201202,6호선,상월곡(한국과학기술연구원),5959,5288,11247,20201205
20201202,6호선,돌곶이,7925,7520,15445,20201205
20201202,6호선,석계,11327,11537,22864,20201205
20201202,6호선,태릉입구,4772,5319,10091,20201205
20201202,6호선,화랑대(서울여대입구),10413,8242,18655,20201205
20201202,6호선,봉화산(서울의료원),8166,7545,15711,20201205
20201202,7호선,장암,2173,838,3011,20201205
20201202,7호선,도봉산,8510,9956,18466,20201205
20201202,7호선,수락산,11491,11601,23092,20201205
20201202,7호선,마들,11047,10783,21830,20201205
20201202,7호선,노원,16432,17095,33527,20201205
20201202,7호선,중계,13146,12113,25259,20201205
20201202,7호선,하계,16177,15664,31841,20201205
20201202,7호선,공릉(서울과학기술대),10178,10274,20452,20201205
20201202,7호선,태릉입구,7459,6831,14290,20201205
20201202,7호선,먹골,9233,9115,18348,20201205
20201202,7호선,중화,10275,10131,20406,20201205
20201202,7호선,상봉(시외버스터미널),15263,14373,29636,20201205
20201202,7호선,면목,14090,13846,27936,20201205
20201202,7호선,사가정,15066,15223,30289,20201205
20201202,7호선,용마산(용마폭포공원),5516,5312,10828,20201205
20201202,7호선,중곡,9286,8806,18092,20201205
20201202,7호선,군자(능동),13135,10718,23853,20201205
20201202,7호선,어린이대공원(세종대),10492,10558,21050,20201205
20201202,7호선,건대입구,10383,10713,21096,20201205
20201202,7호선,뚝섬유원지,6411,6339,12750,20201205
20201202,7호선,청담,18804,20375,39179,20201205
20201202,7호선,강남구청,14934,16114,31048,20201205
20201202,7호선,학동,23113,24223,47336,20201205
20201202,7호선,논현,18457,20094,38551,20201205
20201202,7호선,반포,5144,4910,10054,20201205
20201202,7호선,고속터미널,12559,11146,23705,20201205
20201202,7호선,내방,13366,13547,26913,20201205
20201202,7호선,이수,13872,13593,27465,20201205
20201202,7호선,남성,10584,9958,20542,20201205
20201202,7호선,숭실대입구(살피재),10758,11006,21764,20201205
20201202,7호선,상도,9518,9202,18720,20201205
20201202,7호선,장승배기,9320,9048,18368,20201205
20201202,7호선,신대방삼거리,15403,14907,30310,20201205
20201202,7호선,보라매,8985,9026,18011,20201205
20201202,7호선,신풍,10571,10213,20784,20201205
20201202,7호선,대림(구로구청),7004,7078,14082,20201205
20201202,7호선,남구로,15376,16571,31947,20201205
20201202,7호선,가산디지털단지,44792,44885,89677,20201205
20201202,7호선,철산,19620,20245,39865,20201205
20201202,7호선,광명사거리,20877,20761,41638,20201205
20201202,7호선,천왕,10195,9731,19926,20201205
20201202,7호선,온수(성공회대입구),10102,9404,19506,20201205
20201202,7호선,까치울,6796,6607,13403,20201205
20201202,7호선,부천종합운동장,4048,3615,7663,20201205
20201202,7호선,춘의,9385,9093,18478,20201205
20201202,7호선,신중동,13036,12773,25809,20201205
20201202,7호선,부천시청,10965,10986,21951,20201205
20201202,7호선,상동,11013,11445,22458,20201205
20201202,7호선,삼산체육관,4291,3959,8250,20201205
20201202,7호선,굴포천,7752,8300,16052,20201205
20201202,7호선,부평구청,10794,8944,19738,20201205
20201202,8호선,암사,17407,15474,32881,20201205
20201202,8호선,천호(풍납토성),13976,15611,29587,20201205
20201202,8호선,강동구청,9816,10387,20203,20201205
20201202,8호선,몽촌토성(평화의문),5043,5195,10238,20201205
20201202,8호선,잠실(송파구청),11973,13469,25442,20201205
20201202,8호선,석촌,6852,7910,14762,20201205
20201202,8호선,송파,7160,7319,14479,20201205
20201202,8호선,가락시장,7355,8158,15513,20201205
20201202,8호선,문정,20697,21840,42537,20201205
20201202,8호선,장지,15739,15216,30955,20201205
20201202,8호선,복정,9591,8309,17900,20201205
20201202,8호선,산성,6429,6369,12798,20201205
20201202,8호선,남한산성입구(성남법원.검찰청),12932,12010,24942,20201205
20201202,8호선,단대오거리,9484,9121,18605,20201205
20201202,8호선,신흥,4078,4305,8383,20201205
20201202,8호선,수진,4697,4338,9035,20201205
20201202,8호선,모란,3810,2775,6585,20201205
20201202,9호선,개화,2225,1566,3791,20201205
20201202,9호선,김포공항,5468,7657,13125,20201205
20201202,9호선,공항시장,2542,2842,5384,20201205
20201202,9호선,신방화,6135,5973,12108,20201205
20201202,9호선,마곡나루(서울식물원),9391,9359,18750,20201205
20201202,9호선,양천향교,8570,8825,17395,20201205
20201202,9호선,가양,18241,18070,36311,20201205
20201202,9호선,등촌,9823,9781,19604,20201205
20201202,9호선,염창,15220,15204,30424,20201205
20201202,9호선,신목동,3454,3166,6620,20201205
20201202,9호선,선유도,6819,6654,13473,20201205
20201202,9호선,당산,16104,15864,31968,20201205
20201202,9호선,국회의사당,15024,15001,30025,20201205
20201202,9호선,여의도,21308,20408,41716,20201205
20201202,9호선,샛강,5061,5321,10382,20201205
20201202,9호선,노량진,21839,21547,43386,20201205
20201202,9호선,노들,3998,3516,7514,20201205
20201202,9호선,흑석(중앙대입구),6645,6993,13638,20201205
20201202,9호선,동작(현충원),1569,1198,2767,20201205
20201202,9호선,구반포,2458,2469,4927,20201205
20201202,9호선,신반포,2625,2722,5347,20201205
20201202,9호선,고속터미널,9104,11511,20615,20201205
20201202,9호선,사평,2716,2681,5397,20201205
20201202,9호선,신논현,26412,25645,52057,20201205
20201202,9호선2~3단계,언주,8963,9044,18007,20201205
20201202,9호선2~3단계,선정릉,8528,9202,17730,20201205
20201202,9호선2~3단계,삼성중앙,6241,6398,12639,20201205
20201202,9호선2~3단계,봉은사,14012,14177,28189,20201205
20201202,9호선2~3단계,종합운동장,3576,3575,7151,20201205
20201202,9호선2~3단계,삼전,5830,5722,11552,20201205
20201202,9호선2~3단계,석촌고분,5028,5116,10144,20201205
20201202,9호선2~3단계,석촌,6854,6009,12863,20201205
20201202,9호선2~3단계,송파나루,3910,4075,7985,20201205
20201202,9호선2~3단계,한성백제,2100,1901,4001,20201205
20201202,우이신설선,신설동,2194,2070,4264,20201205
20201202,일산선,원흥,8289,7993,16282,20201205
20201202,분당선,오리,10575,8928,19503,20201205
20201202,분당선,미금,13683,14482,28165,20201205
20201202,분당선,정자,13975,14941,28916,20201205
20201202,분당선,수내,11449,11552,23001,20201205
20201202,분당선,서현,20860,21188,42048,20201205
20201202,분당선,야탑,22819,24147,46966,20201205
20201202,분당선,모란,17560,17515,35075,20201205
20201202,분당선,태평,11986,11861,23847,20201205
20201202,분당선,가천대,6659,7608,14267,20201205
20201202,분당선,선정릉,7840,8182,16022,20201205
20201202,분당선,강남구청,8858,10200,19058,20201205
20201202,분당선,압구정로데오,14823,16085,30908,20201205
20201202,분당선,서울숲,7370,7400,14770,20201205
20201202,분당선,수원,6855,5632,12487,20201205
20201202,분당선,수서,11021,11361,22382,20201205
20201202,분당선,대모산입구,3289,3045,6334,20201205
20201202,분당선,개포동,3230,3342,6572,20201205
20201202,분당선,구룡,1539,1522,3061,20201205
20201202,분당선,도곡,5756,5988,11744,20201205
20201202,분당선,한티,11750,12460,24210,20201205
20201202,분당선,선릉,12362,18246,30608,20201205
20201202,과천선,범계,22179,21831,44010,20201205
20201202,과천선,평촌,16576,16388,32964,20201205
20201202,과천선,인덕원,21863,22791,44654,20201205
20201202,과천선,정부과천청사,8769,8311,17080,20201205
20201202,과천선,과천,4525,4131,8656,20201205
20201202,과천선,대공원,1508,1594,3102,20201205
20201202,과천선,경마공원,1388,1404,2792,20201205
20201202,과천선,선바위,7696,6919,14615,20201205
20201202,공항철도 1호선,영종,2348,2361,4709,20201205
20201202,공항철도 1호선,인천공항2터미널,1674,1628,3302,20201205
20201202,공항철도 1호선,인천공항1터미널,2931,3062,5993,20201205
20201202,공항철도 1호선,공항화물청사,2284,2413,4697,20201205
20201202,공항철도 1호선,운서,5094,5168,10262,20201205
20201202,공항철도 1호선,청라국제도시,5823,5396,11219,20201205
20201202,공항철도 1호선,검암,6392,6197,12589,20201205
20201202,공항철도 1호선,계양,8358,7763,16121,20201205
20201202,공항철도 1호선,김포공항,7596,4777,12373,20201205
20201202,공항철도 1호선,마곡나루(서울식물원),6532,6167,12699,20201205
20201202,공항철도 1호선,디지털미디어시티,11986,10785,22771,20201205
20201202,공항철도 1호선,홍대입구,6130,6385,12515,20201205
20201202,공항철도 1호선,공덕,1864,2385,4249,20201205
20201202,공항철도 1호선,서울역,5109,4536,9645,20201205
20201202,경춘선,춘천,857,802,1659,20201205
20201202,경춘선,남춘천,1794,1872,3666,20201205
20201202,경춘선,김유정,195,198,393,20201205
20201202,경춘선,강촌,267,282,549,20201205
20201202,경춘선,백양리,65,72,137,20201205
20201202,경춘선,굴봉산,61,75,136,20201205
20201202,경춘선,가평,1055,1046,2101,20201205
20201202,경춘선,상천,177,161,338,20201205
20201202,경춘선,청평,1071,1073,2144,20201205
20201202,경춘선,대성리,395,332,727,20201205
20201202,경춘선,마석,3242,3188,6430,20201205
20201202,경춘선,천마산,1421,1337,2758,20201205
20201202,경춘선,평내호평,5105,4942,10047,20201205
20201202,경춘선,금곡,1349,1329,2678,20201205
20201202,경춘선,사릉,3167,3029,6196,20201205
20201202,경춘선,퇴계원,3254,3057,6311,20201205
20201202,경춘선,별내,2387,2333,4720,20201205
20201202,경춘선,갈매,2759,2376,5135,20201205
20201202,경춘선,신내,1343,1321,2664,20201205
20201202,경인선,도화,3477,3223,6700,20201205
20201202,경인선,중동,8480,7970,16450,20201205
20201202,경인선,온수(성공회대입구),5986,5938,11924,20201205
20201202,경인선,도원,2478,2555,5033,20201205
20201202,경인선,간석,5165,5021,10186,20201205
20201202,경인선,부개,7699,7351,15050,20201205
20201202,경인선,소사,8765,8392,17157,20201205
20201202,경인선,구일,5686,5840,11526,20201205
20201202,경인선,인천,2846,2067,4913,20201205
20201202,경인선,동인천,12147,11613,23760,20201205
20201202,경인선,제물포,9142,8686,17828,20201205
20201202,경인선,주안,16599,15267,31866,20201205
20201202,경인선,동암,13964,14081,28045,20201205
20201202,경인선,백운,6568,6493,13061,20201205
20201202,경인선,부평,25550,27043,52593,20201205
20201202,경인선,송내,25449,25540,50989,20201205
20201202,경인선,부천,29653,29928,59581,20201205
20201202,경인선,역곡,25039,24977,50016,20201205
20201202,경인선,오류동,10750,10306,21056,20201205
20201202,경인선,개봉,19816,20605,40421,20201205
20201202,경의선,임진강,13,7,20,20201205
20201202,경의선,문산,4068,4129,8197,20201205
20201202,경의선,파주,1077,876,1953,20201205
20201202,경의선,월롱,1606,1611,3217,20201205
20201202,경의선,금촌,5376,5320,10696,20201205
20201202,경의선,금릉,3812,3733,7545,20201205
20201202,경의선,운정,5411,5117,10528,20201205
20201202,경의선,야당,5242,5011,10253,20201205
20201202,경의선,탄현,6527,6363,12890,20201205
20201202,경의선,일산,7822,7890,15712,20201205
20201202,경의선,풍산,4702,4360,9062,20201205
20201202,경의선,백마,5970,5637,11607,20201205
20201202,경의선,곡산,534,552,1086,20201205
20201202,경의선,능곡,3293,2954,6247,20201205
20201202,경의선,행신,6853,6889,13742,20201205
20201202,경의선,강매,2734,2400,5134,20201205
20201202,경의선,화전,1447,1351,2798,20201205
20201202,경의선,수색,2240,2331,4571,20201205
20201202,경의선,디지털미디어시티,2200,2069,4269,20201205
20201202,경의선,가좌,4678,4325,9003,20201205
20201202,경의선,홍대입구,1211,1290,2501,20201205
20201202,경의선,서강대,1723,1591,3314,20201205
20201202,경의선,공덕,2940,2688,5628,20201205
20201202,경의선,효창공원앞,2513,2897,5410,20201205
20201202,경의선,신촌,738,890,1628,20201205
20201202,경의선,서울역,3651,4511,8162,20201205
20201202,경원선,소요산,2214,1855,4069,20201205
20201202,경원선,동두천,1813,2067,3880,20201205
20201202,경원선,보산,1262,1156,2418,20201205
20201202,경원선,동두천중앙,2698,2601,5299,20201205
20201202,경원선,지행,5572,5541,11113,20201205
20201202,경원선,덕정,5104,4949,10053,20201205
20201202,경원선,덕계,2548,2285,4833,20201205
20201202,경원선,양주,6494,6235,12729,20201205
20201202,경원선,녹양,4206,4054,8260,20201205
20201202,경원선,가능,5721,5533,11254,20201205
20201202,경원선,의정부,15756,16080,31836,20201205
20201202,경원선,회룡,11254,11190,22444,20201205
20201202,경원선,망월사,6728,6887,13615,20201205
20201202,경원선,도봉산,6842,4146,10988,20201205
20201202,경원선,도봉,5376,5214,10590,20201205
20201202,경원선,방학,8718,8489,17207,20201205
20201202,경원선,녹천,4381,3709,8090,20201205
20201202,경원선,월계,5684,5390,11074,20201205
20201202,경원선,광운대,7437,7171,14608,20201205
20201202,경원선,석계,7263,8589,15852,20201205
20201202,경원선,신이문,7798,7343,15141,20201205
20201202,경원선,외대앞,6304,6353,12657,20201205
20201202,경원선,청량리(서울시립대입구),11334,12396,23730,20201205
20201202,경원선,왕십리(성동구청),11258,13021,24279,20201205
20201202,경원선,응봉,1622,1336,2958,20201205
20201202,경원선,옥수,52,26,78,20201205
20201202,경원선,한남,3653,3508,7161,20201205
20201202,경원선,서빙고,1713,1523,3236,20201205
20201202,경원선,이촌(국립중앙박물관),3377,2647,6024,20201205
20201202,경부선,광명,2441,2243,4684,20201205
20201202,경부선,서동탄,1381,1074,2455,20201205
20201202,경부선,당정,5766,5523,11289,20201205
20201202,경부선,천안,3741,3863,7604,20201205
20201202,경부선,두정,4167,4220,8387,20201205
20201202,경부선,직산,600,612,1212,20201205
20201202,경부선,성환,3193,3153,6346,20201205
20201202,경부선,평택,9475,9525,19000,20201205
20201202,경부선,지제,2321,2196,4517,20201205
20201202,경부선,서정리,5343,5160,10503,20201205
20201202,경부선,송탄,3465,3384,6849,20201205
20201202,경부선,진위,1378,1194,2572,20201205
20201202,경부선,오산,8065,7993,16058,20201205
20201202,경부선,오산대,2756,2666,5422,20201205
20201202,경부선,세마,2225,2117,4342,20201205
20201202,경부선,병점,11324,11249,22573,20201205
20201202,경부선,세류,2673,2377,5050,20201205
20201202,경부선,독산,15687,16941,32628,20201205
20201202,경부선,수원,26909,28739,55648,20201205
20201202,경부선,화서,6566,6404,12970,20201205
20201202,경부선,성균관대,13130,13060,26190,20201205
20201202,경부선,의왕,8410,8388,16798,20201205
20201202,경부선,군포,7267,7413,14680,20201205
20201202,경부선,금정,23865,24489,48354,20201205
20201202,경부선,명학,8664,8576,17240,20201205
20201202,경부선,안양,20191,20523,40714,20201205
20201202,경부선,관악,6739,6199,12938,20201205
20201202,경부선,석수,9558,8176,17734,20201205
20201202,경부선,금천구청,10648,10710,21358,20201205
20201202,경부선,가산디지털단지,16875,19874,36749,20201205
20201202,경부선,구로,18159,18446,36605,20201205
20201202,경부선,신길,8746,7291,16037,20201205
20201202,경부선,신도림,3726,3759,7485,20201205
20201202,경부선,영등포,31653,32243,63896,20201205
20201202,경부선,대방,12065,12421,24486,20201205
20201202,경부선,노량진,7488,7660,15148,20201205
20201202,경부선,용산,24174,24382,48556,20201205
20201202,경부선,남영,8711,9039,17750,20201205
20201202,경부선,서울역,3161,1049,4210,20201205
20201202,경강선,여주,1327,1342,2669,20201205
20201202,경강선,세종대왕릉,193,176,369,20201205
20201202,경강선,부발,1539,1519,3058,20201205
20201202,경강선,이천,1866,2000,3866,20201205
20201202,경강선,신둔도예촌,964,934,1898,20201205
20201202,경강선,곤지암,1786,1707,3493,20201205
20201202,경강선,초월,2613,2576,5189,20201205
20201202,경강선,경기광주,5982,5730,11712,20201205
20201202,경강선,삼동,2091,1890,3981,20201205
20201202,경강선,이매,861,781,1642,20201205
20201202,경강선,판교,3859,3647,7506,20201205
20201202,9호선2~3단계,중앙보훈병원,9079,7907,16986,20201205
20201202,9호선2~3단계,둔촌오륜,1015,913,1928,20201205
20201202,9호선2~3단계,올림픽공원(한국체대),4605,4699,9304,20201205
20201202,일산선,삼송,16161,15757,31918,20201205
20201202,일산선,원당,10122,9663,19785,20201205
20201202,일산선,화정,14723,15271,29994,20201205
20201202,일산선,대곡,1546,1189,2735,20201205
20201202,일산선,백석,8845,9126,17971,20201205
20201202,일산선,마두,6670,6900,13570,20201205
20201202,일산선,정발산,5981,5835,11816,20201205
20201202,일산선,주엽,7686,7879,15565,20201205
20201202,일산선,대화,11744,9335,21079,20201205
20201202,장항선,봉명,1040,1029,2069,20201205
20201202,장항선,쌍용(나사렛대),1654,1545,3199,20201205
20201202,장항선,아산,2084,1951,4035,20201205
20201202,장항선,배방,792,763,1555,20201205
20201202,장항선,온양온천,2636,2755,5391,20201205
20201202,장항선,신창(순천향대),1184,1171,2355,20201205
20201202,중앙선,회기,20307,19823,40130,20201205
20201202,중앙선,중랑,4904,4736,9640,20201205
20201202,중앙선,상봉(시외버스터미널),5258,5151,10409,20201205
20201202,중앙선,망우,6632,6516,13148,20201205
20201202,중앙선,양원,1516,1533,3049,20201205
20201202,중앙선,구리,12013,11999,24012,20201205
20201202,중앙선,도농,8931,8180,17111,20201205
20201202,중앙선,양정,707,626,1333,20201205
20201202,9호선,증미,6646,6786,13432,20201205
20201202,수인선,인천논현,4852,5069,9921,20201205
20201202,수인선,소래포구,4220,3871,8091,20201205
20201202,수인선,월곶,2166,2000,4166,20201205
20201202,수인선,달월,79,55,134,20201205
20201202,중앙선,덕소,4936,4972,9908,20201205
20201202,중앙선,도심,2191,1665,3856,20201205
20201202,중앙선,팔당,658,601,1259,20201205
20201202,중앙선,운길산,517,490,1007,20201205
20201202,중앙선,양수,1340,1419,2759,20201205
20201202,중앙선,신원,157,148,305,20201205
20201202,중앙선,국수,563,568,1131,20201205
20201202,중앙선,아신,430,441,871,20201205
20201202,중앙선,오빈,260,231,491,20201205
20201202,중앙선,양평,2104,2128,4232,20201205
20201202,중앙선,원덕,257,242,499,20201205
20201202,중앙선,용문,1260,1277,2537,20201205
20201202,중앙선,지평,33,32,65,20201205
20201202,1호선,동묘앞,7224,7566,14790,20201205
20201203,경부선,신길,8555,7184,15739,20201206
20201203,경부선,구로,17652,17819,35471,20201206
20201203,경부선,신도림,3756,3710,7466,20201206
20201203,경부선,영등포,31210,32239,63449,20201206
20201203,경부선,대방,11852,12296,24148,20201206
20201203,경부선,노량진,7204,7622,14826,20201206
20201203,경부선,용산,24682,25093,49775,20201206
20201203,경부선,남영,8376,8759,17135,20201206
20201203,경부선,서울역,3243,1113,4356,20201206
20201203,경강선,여주,1287,1336,2623,20201206
20201203,경강선,세종대왕릉,226,214,440,20201206
20201203,경강선,부발,1499,1375,2874,20201206
20201203,경강선,이천,1858,1951,3809,20201206
20201203,경강선,신둔도예촌,938,917,1855,20201206
20201203,경강선,곤지암,1730,1814,3544,20201206
20201203,경강선,초월,2575,2555,5130,20201206
20201203,경강선,경기광주,5935,5651,11586,20201206
20201203,경강선,삼동,2062,1879,3941,20201206
20201203,경강선,이매,867,751,1618,20201206
20201203,경강선,판교,3861,3680,7541,20201206
20201203,경부선,금천구청,10651,10586,21237,20201206
20201203,경부선,석수,9179,8175,17354,20201206
20201203,경부선,관악,6620,6056,12676,20201206
20201203,경부선,안양,19540,19806,39346,20201206
20201203,경부선,명학,8564,8406,16970,20201206
20201203,경부선,금정,23387,24219,47606,20201206
20201203,경부선,군포,7297,7245,14542,20201206
20201203,경부선,의왕,8307,8208,16515,20201206
20201203,경부선,성균관대,13009,12890,25899,20201206
20201203,경부선,화서,6436,6309,12745,20201206
20201203,경부선,수원,26912,28525,55437,20201206
20201203,경부선,독산,15498,16542,32040,20201206
20201203,경부선,세류,2538,2363,4901,20201206
20201203,경부선,병점,11297,11289,22586,20201206
20201203,경부선,세마,2239,2027,4266,20201206
20201203,경부선,오산대,2718,2521,5239,20201206
20201203,경부선,오산,8216,8312,16528,20201206
20201203,경부선,진위,1407,1194,2601,20201206
20201203,경부선,송탄,3435,3264,6699,20201206
20201203,경부선,서정리,5096,4889,9985,20201206
20201203,경부선,지제,2256,2180,4436,20201206
20201203,경부선,평택,9350,9261,18611,20201206
20201203,경부선,성환,3138,3002,6140,20201206
20201203,경부선,직산,575,609,1184,20201206
20201203,경부선,두정,4270,4187,8457,20201206
20201203,경부선,천안,3710,3828,7538,20201206
20201203,경부선,당정,5698,5514,11212,20201206
20201203,경부선,서동탄,1395,1180,2575,20201206
20201203,경부선,광명,2430,2250,4680,20201206
20201203,경원선,이촌(국립중앙박물관),3223,2614,5837,20201206
20201203,경원선,서빙고,1679,1571,3250,20201206
20201203,경원선,한남,3794,3632,7426,20201206
20201203,경원선,옥수,37,29,66,20201206
20201203,경원선,응봉,1592,1333,2925,20201206
20201203,경원선,왕십리(성동구청),11449,12888,24337,20201206
20201203,경원선,청량리(서울시립대입구),11493,12538,24031,20201206
20201203,경원선,외대앞,6304,6286,12590,20201206
20201203,경원선,신이문,7798,7270,15068,20201206
20201203,경원선,석계,7167,8322,15489,20201206
20201203,경원선,광운대,7164,6945,14109,20201206
20201203,경원선,월계,5671,5263,10934,20201206
20201203,경원선,녹천,4282,3656,7938,20201206
20201203,경원선,방학,8473,8227,16700,20201206
20201203,경원선,도봉,5444,5275,10719,20201206
20201203,경원선,도봉산,6867,4171,11038,20201206
20201203,경원선,망월사,6605,6748,13353,20201206
20201203,경원선,회룡,11034,11023,22057,20201206
20201203,경원선,의정부,15688,15743,31431,20201206
20201203,경원선,가능,5686,5495,11181,20201206
20201203,경원선,녹양,4018,3896,7914,20201206
20201203,경원선,양주,6491,6149,12640,20201206
20201203,경원선,덕계,2448,2157,4605,20201206
20201203,경원선,덕정,4886,4868,9754,20201206
20201203,경원선,지행,5344,5251,10595,20201206
20201203,경원선,동두천중앙,2598,2568,5166,20201206
20201203,경원선,보산,1263,1166,2429,20201206
20201203,경원선,동두천,1713,1953,3666,20201206
20201203,경원선,소요산,2125,1782,3907,20201206
20201203,경의선,서울역,3660,4527,8187,20201206
20201203,경의선,신촌,743,885,1628,20201206
20201203,경의선,효창공원앞,2527,2889,5416,20201206
20201203,경의선,공덕,3011,2692,5703,20201206
20201203,경의선,서강대,1696,1662,3358,20201206
20201203,경의선,홍대입구,1209,1287,2496,20201206
20201203,경의선,가좌,4739,4468,9207,20201206
20201203,경의선,디지털미디어시티,2139,1995,4134,20201206
20201203,경의선,수색,2351,2366,4717,20201206
20201203,경의선,화전,1310,1230,2540,20201206
20201203,경의선,강매,2702,2342,5044,20201206
20201203,경의선,행신,6633,6720,13353,20201206
20201203,경의선,능곡,3240,2892,6132,20201206
20201203,경의선,곡산,478,506,984,20201206
20201203,경의선,백마,5868,5656,11524,20201206
20201203,경의선,풍산,4697,4433,9130,20201206
20201203,경의선,일산,8339,8473,16812,20201206
20201203,경의선,탄현,6417,6354,12771,20201206
20201203,경의선,야당,5189,4968,10157,20201206
20201203,경의선,운정,5376,4959,10335,20201206
20201203,경의선,금릉,3772,3675,7447,20201206
20201203,경의선,금촌,5165,5190,10355,20201206
20201203,경의선,월롱,1750,1588,3338,20201206
20201203,경의선,파주,1063,813,1876,20201206
20201203,경의선,문산,4111,4092,8203,20201206
20201203,경의선,임진강,10,10,20,20201206
20201203,경의선,계양,1,0,1,20201206
20201203,경인선,개봉,19464,19993,39457,20201206
20201203,경인선,오류동,10735,10210,20945,20201206
20201203,경인선,역곡,24653,24731,49384,20201206
20201203,경인선,부천,29201,29459,58660,20201206
20201203,경인선,송내,24988,25030,50018,20201206
20201203,경인선,부평,25570,26956,52526,20201206
20201203,경인선,백운,6369,6345,12714,20201206
20201203,경인선,동암,13652,13783,27435,20201206
20201203,경인선,주안,16352,15099,31451,20201206
20201203,경인선,제물포,8832,8271,17103,20201206
20201203,경인선,동인천,12021,11486,23507,20201206
20201203,경인선,인천,2796,2163,4959,20201206
20201203,경인선,구일,5830,5957,11787,20201206
20201203,경인선,소사,8740,8244,16984,20201206
20201203,경인선,부개,7814,7233,15047,20201206
20201203,경인선,간석,5160,5097,10257,20201206
20201203,경인선,도원,2291,2440,4731,20201206
20201203,경인선,온수(성공회대입구),5798,5825,11623,20201206
20201203,경인선,중동,8203,7836,16039,20201206
20201203,경인선,도화,3358,3180,6538,20201206
20201203,경춘선,신내,1342,1292,2634,20201206
20201203,경춘선,갈매,2659,2315,4974,20201206
20201203,경춘선,별내,2459,2348,4807,20201206
20201203,경춘선,퇴계원,3159,2947,6106,20201206
20201203,경춘선,사릉,3030,2924,5954,20201206
20201203,경춘선,금곡,1356,1266,2622,20201206
20201203,경춘선,평내호평,4999,4892,9891,20201206
20201203,경춘선,천마산,1435,1293,2728,20201206
20201203,경춘선,마석,3327,3303,6630,20201206
20201203,경춘선,대성리,380,321,701,20201206
20201203,경춘선,청평,1078,1126,2204,20201206
20201203,경춘선,상천,169,155,324,20201206
20201203,경춘선,가평,961,998,1959,20201206
20201203,경춘선,굴봉산,76,79,155,20201206
20201203,경춘선,백양리,55,69,124,20201206
20201203,경춘선,강촌,260,309,569,20201206
20201203,경춘선,김유정,173,175,348,20201206
20201203,경춘선,남춘천,1654,1594,3248,20201206
20201203,경춘선,춘천,907,752,1659,20201206
20201203,공항철도 1호선,서울역,5240,4683,9923,20201206
20201203,공항철도 1호선,공덕,1928,2451,4379,20201206
20201203,공항철도 1호선,홍대입구,6047,6357,12404,20201206
20201203,공항철도 1호선,디지털미디어시티,12228,10899,23127,20201206
20201203,공항철도 1호선,마곡나루(서울식물원),6285,6139,12424,20201206
20201203,공항철도 1호선,김포공항,8005,5210,13215,20201206
20201203,공항철도 1호선,계양,8226,7541,15767,20201206
20201203,공항철도 1호선,검암,6297,6160,12457,20201206
20201203,공항철도 1호선,청라국제도시,5687,5253,10940,20201206
20201203,공항철도 1호선,운서,5091,5058,10149,20201206
20201203,공항철도 1호선,공항화물청사,2261,2480,4741,20201206
20201203,공항철도 1호선,인천공항1터미널,3036,3201,6237,20201206
20201203,공항철도 1호선,인천공항2터미널,1724,1679,3403,20201206
20201203,공항철도 1호선,영종,2306,2342,4648,20201206
20201203,과천선,선바위,7547,6715,14262,20201206
20201203,과천선,경마공원,1235,1174,2409,20201206
20201203,과천선,대공원,1583,1702,3285,20201206
20201203,과천선,과천,4525,4128,8653,20201206
20201203,과천선,정부과천청사,8401,8675,17076,20201206
20201203,과천선,인덕원,21776,22302,44078,20201206
20201203,과천선,평촌,16203,16168,32371,20201206
20201203,과천선,범계,21973,21495,43468,20201206
20201203,분당선,선릉,12427,18260,30687,20201206
20201203,분당선,한티,11726,12652,24378,20201206
20201203,분당선,도곡,5964,5836,11800,20201206
20201203,분당선,구룡,1639,1541,3180,20201206
20201203,분당선,개포동,3131,3218,6349,20201206
20201203,분당선,대모산입구,3244,3013,6257,20201206
20201203,분당선,수서,11012,11581,22593,20201206
20201203,분당선,복정,1,0,1,20201206
20201203,분당선,수원,6838,5600,12438,20201206
20201203,분당선,서울숲,7366,7408,14774,20201206
20201203,분당선,압구정로데오,15357,16527,31884,20201206
20201203,분당선,강남구청,8757,10150,18907,20201206
20201203,분당선,선정릉,7177,7742,14919,20201206
20201203,분당선,가천대,6520,7461,13981,20201206
20201203,분당선,태평,11836,11633,23469,20201206
20201203,분당선,모란,17262,17365,34627,20201206
20201203,분당선,야탑,22274,23274,45548,20201206
20201203,분당선,서현,20615,20831,41446,20201206
20201203,분당선,수내,11525,11645,23170,20201206
20201203,분당선,정자,13842,14544,28386,20201206
20201203,분당선,미금,13472,14389,27861,20201206
20201203,분당선,오리,10608,8946,19554,20201206
20201203,분당선,이매,4452,4209,8661,20201206
20201203,분당선,보정,2083,1779,3862,20201206
20201203,분당선,죽전,11310,12496,23806,20201206
20201203,분당선,구성,4243,4468,8711,20201206
20201203,분당선,신갈,3942,3856,7798,20201206
20201203,분당선,기흥,8155,7946,16101,20201206
20201203,분당선,상갈,4556,4515,9071,20201206
20201203,분당선,청명,3775,3497,7272,20201206
20201203,분당선,영통,6837,7064,13901,20201206
20201203,분당선,망포,12115,11703,23818,20201206
20201203,분당선,매탄권선,4205,4078,8283,20201206
20201203,분당선,수원시청,10368,10989,21357,20201206
20201203,분당선,매교,2422,2414,4836,20201206
20201203,수인선,고색,2862,2739,5601,20201206
20201203,수인선,오목천,1827,1792,3619,20201206
20201203,수인선,어천,510,513,1023,20201206
20201203,수인선,야목,159,136,295,20201206
20201203,수인선,사리,2925,2840,5765,20201206
20201203,수인선,달월,74,55,129,20201206
20201203,수인선,월곶,2009,1918,3927,20201206
20201203,수인선,소래포구,4074,3831,7905,20201206
20201203,수인선,인천논현,4870,5011,9881,20201206
20201203,수인선,호구포,3200,3300,6500,20201206
20201203,수인선,남동인더스파크,2238,2464,4702,20201206
20201203,수인선,원인재,3830,3872,7702,20201206
20201203,수인선,연수,3797,3764,7561,20201206
20201203,수인선,송도,2170,2078,4248,20201206
20201203,수인선,인하대,4793,4604,9397,20201206
20201203,수인선,숭의,3344,3150,6494,20201206
20201203,수인선,신포,1400,1352,2752,20201206
20201203,수인선,인천,849,1340,2189,20201206
20201203,안산선,산본,14095,15089,29184,20201206
20201203,안산선,대야미,4379,4026,8405,20201206
20201203,안산선,반월,3855,3790,7645,20201206
20201203,안산선,상록수,14714,14812,29526,20201206
20201203,안산선,한대앞,7434,7479,14913,20201206
20201203,안산선,중앙,14385,14842,29227,20201206
20201203,안산선,고잔,7716,7449,15165,20201206
20201203,안산선,초지,4380,4837,9217,20201206
20201203,안산선,안산,10803,9616,20419,20201206
20201203,안산선,신길온천,1465,1370,2835,20201206
20201203,안산선,정왕,7922,8317,16239,20201206
20201203,안산선,오이도,7154,6928,14082,20201206
20201203,안산선,수리산,3927,3209,7136,20201206
20201203,우이신설선,북한산우이,2182,2009,4191,20201206
20201203,우이신설선,솔밭공원,2112,2087,4199,20201206
20201203,우이신설선,4.19민주묘지,2434,2400,4834,20201206
20201203,우이신설선,가오리,3532,3616,7148,20201206
20201203,우이신설선,화계,2900,2864,5764,20201206
20201203,우이신설선,삼양,1781,1996,3777,20201206
20201203,우이신설선,삼양사거리,2148,2230,4378,20201206
20201203,우이신설선,솔샘,5104,4885,9989,20201206
20201203,우이신설선,북한산보국문,5071,5058,10129,20201206
20201203,우이신설선,정릉,3927,3787,7714,20201206
20201203,우이신설선,성신여대입구(돈암),2734,2892,5626,20201206
20201203,우이신설선,보문,1411,1477,2888,20201206
20201203,우이신설선,신설동,2046,1993,4039,20201206
20201203,일산선,원흥,8258,7971,16229,20201206
20201203,일산선,삼송,16007,15739,31746,20201206
20201203,일산선,원당,9938,9608,19546,20201206
20201203,일산선,화정,14380,14992,29372,20201206
20201203,일산선,대곡,1515,1153,2668,20201206
20201203,일산선,백석,9065,8973,18038,20201206
20201203,일산선,마두,6583,6711,13294,20201206
20201203,일산선,정발산,5906,5773,11679,20201206
20201203,일산선,주엽,7487,7554,15041,20201206
20201203,일산선,대화,11298,9101,20399,20201206
20201203,장항선,봉명,1015,983,1998,20201206
20201203,장항선,쌍용(나사렛대),1784,1605,3389,20201206
20201203,장항선,아산,2132,2022,4154,20201206
20201203,장항선,배방,783,782,1565,20201206
20201203,장항선,온양온천,2677,2772,5449,20201206
20201203,장항선,신창(순천향대),1331,1151,2482,20201206
20201203,중앙선,회기,20038,19441,39479,20201206
20201203,중앙선,중랑,4998,4757,9755,20201206
20201203,중앙선,상봉(시외버스터미널),5129,5054,10183,20201206
20201203,9호선2~3단계,중앙보훈병원,8841,7851,16692,20201206
20201203,중앙선,망우,6556,6547,13103,20201206
20201203,중앙선,양원,1440,1372,2812,20201206
20201203,중앙선,구리,11972,12008,23980,20201206
20201203,중앙선,도농,8603,7946,16549,20201206
20201203,중앙선,양정,755,647,1402,20201206
20201203,중앙선,덕소,5068,5050,10118,20201206
20201203,중앙선,도심,2097,1656,3753,20201206
20201203,중앙선,팔당,652,675,1327,20201206
20201203,중앙선,운길산,524,495,1019,20201206
20201203,중앙선,양수,1512,1510,3022,20201206
20201203,중앙선,신원,209,151,360,20201206
20201203,중앙선,국수,542,574,1116,20201206
20201203,중앙선,아신,413,427,840,20201206
20201203,중앙선,오빈,238,226,464,20201206
20201203,중앙선,양평,2472,2491,4963,20201206
20201203,중앙선,원덕,265,245,510,20201206
20201203,중앙선,용문,1231,1238,2469,20201206
20201203,경부선,가산디지털단지,16496,19467,35963,20201206
20201203,9호선2~3단계,둔촌오륜,887,735,1622,20201206
20201203,9호선2~3단계,올림픽공원(한국체대),4637,4629,9266,20201206
20201203,9호선2~3단계,한성백제,2029,1851,3880,20201206
20201203,9호선2~3단계,송파나루,3846,3970,7816,20201206
20201203,9호선2~3단계,석촌,6648,5976,12624,20201206
20201203,9호선2~3단계,석촌고분,5156,5144,10300,20201206
20201203,9호선2~3단계,삼전,5790,5665,11455,20201206
20201203,9호선2~3단계,종합운동장,3540,3479,7019,20201206
20201203,9호선2~3단계,봉은사,14307,14293,28600,20201206
20201203,9호선2~3단계,삼성중앙,6033,6283,12316,20201206
20201203,9호선2~3단계,선정릉,8187,8904,17091,20201206
20201203,9호선2~3단계,언주,9092,9021,18113,20201206
20201203,9호선,신논현,26172,25709,51881,20201206
20201203,9호선,사평,2702,2681,5383,20201206
20201203,9호선,고속터미널,8869,11408,20277,20201206
20201203,9호선,신반포,2675,2629,5304,20201206
20201203,9호선,구반포,2487,2615,5102,20201206
20201203,9호선,동작(현충원),1527,1260,2787,20201206
20201203,9호선,흑석(중앙대입구),6567,6929,13496,20201206
20201203,9호선,노들,3874,3462,7336,20201206
20201203,9호선,노량진,21667,21274,42941,20201206
20201203,9호선,샛강,4991,5181,10172,20201206
20201203,9호선,여의도,20928,20057,40985,20201206
20201203,9호선,국회의사당,15107,14930,30037,20201206
20201203,9호선,당산,15768,15589,31357,20201206
20201203,9호선,선유도,6862,6725,13587,20201206
20201203,9호선,신목동,3440,3225,6665,20201206
20201203,9호선,염창,15058,15033,30091,20201206
20201203,9호선,등촌,9829,9695,19524,20201206
20201203,9호선,증미,6628,6554,13182,20201206
20201203,9호선,가양,17622,17365,34987,20201206
20201203,9호선,양천향교,8672,8869,17541,20201206
20201203,9호선,마곡나루(서울식물원),9237,9178,18415,20201206
20201203,9호선,신방화,6105,5990,12095,20201206
20201203,9호선,공항시장,2506,2785,5291,20201206
20201203,9호선,김포공항,5731,8303,14034,20201206
20201203,9호선,개화,2257,1632,3889,20201206
20201203,8호선,모란,3781,2744,6525,20201206
20201203,8호선,수진,4655,4232,8887,20201206
20201203,8호선,신흥,3992,4310,8302,20201206
20201203,8호선,단대오거리,9236,8949,18185,20201206
20201203,8호선,남한산성입구(성남법원.검찰청),12615,11850,24465,20201206
20201203,8호선,산성,6330,6358,12688,20201206
20201203,8호선,복정,9539,8348,17887,20201206
20201203,8호선,장지,15568,15127,30695,20201206
20201203,8호선,문정,20505,21590,42095,20201206
20201203,8호선,가락시장,7302,8083,15385,20201206
20201203,8호선,송파,7133,7202,14335,20201206
20201203,8호선,석촌,6735,7730,14465,20201206
20201203,8호선,잠실(송파구청),12303,13624,25927,20201206
20201203,8호선,몽촌토성(평화의문),5196,5249,10445,20201206
20201203,8호선,강동구청,9685,10169,19854,20201206
20201203,8호선,천호(풍납토성),13603,15243,28846,20201206
20201203,8호선,암사,17164,15581,32745,20201206
20201203,7호선,부평구청,10608,8787,19395,20201206
20201203,7호선,굴포천,7840,8235,16075,20201206
20201203,7호선,삼산체육관,4181,3840,8021,20201206
20201203,7호선,상동,10963,11296,22259,20201206
20201203,7호선,부천시청,10855,10783,21638,20201206
20201203,7호선,신중동,12794,12475,25269,20201206
20201203,7호선,춘의,9141,9012,18153,20201206
20201203,7호선,부천종합운동장,3955,3534,7489,20201206
20201203,7호선,까치울,6631,6441,13072,20201206
20201203,7호선,온수(성공회대입구),9714,9004,18718,20201206
20201203,7호선,천왕,9924,9418,19342,20201206
20201203,7호선,광명사거리,20465,20500,40965,20201206
20201203,7호선,철산,19327,19656,38983,20201206
20201203,7호선,가산디지털단지,44321,44478,88799,20201206
20201203,7호선,남구로,15197,16328,31525,20201206
20201203,7호선,대림(구로구청),7152,7072,14224,20201206
20201203,7호선,신풍,10590,10107,20697,20201206
20201203,7호선,보라매,8805,8751,17556,20201206
20201203,7호선,신대방삼거리,15310,14848,30158,20201206
20201203,7호선,장승배기,9040,8778,17818,20201206
20201203,7호선,상도,9281,9188,18469,20201206
20201203,7호선,숭실대입구(살피재),10553,10739,21292,20201206
20201203,7호선,남성,10303,9677,19980,20201206
20201203,7호선,이수,13722,13454,27176,20201206
20201203,7호선,내방,13367,13549,26916,20201206
20201203,7호선,고속터미널,12565,11474,24039,20201206
20201203,7호선,반포,5046,4916,9962,20201206
20201203,7호선,논현,18238,19893,38131,20201206
20201203,7호선,학동,22424,23938,46362,20201206
20201203,7호선,강남구청,14575,16037,30612,20201206
20201203,7호선,청담,18360,20005,38365,20201206
20201203,7호선,뚝섬유원지,6145,6169,12314,20201206
20201203,7호선,건대입구,10174,10295,20469,20201206
20201203,7호선,어린이대공원(세종대),10170,10139,20309,20201206
20201203,7호선,군자(능동),12940,10528,23468,20201206
20201203,7호선,중곡,9147,8617,17764,20201206
20201203,7호선,용마산(용마폭포공원),5580,5413,10993,20201206
20201203,7호선,사가정,14886,15127,30013,20201206
20201203,7호선,면목,13829,13733,27562,20201206
20201203,7호선,상봉(시외버스터미널),15244,14472,29716,20201206
20201203,7호선,중화,10137,9914,20051,20201206
20201203,7호선,먹골,9119,8864,17983,20201206
20201203,7호선,태릉입구,7304,6744,14048,20201206
20201203,7호선,공릉(서울과학기술대),10090,10120,20210,20201206
20201203,7호선,하계,15834,15176,31010,20201206
20201203,7호선,중계,12936,11823,24759,20201206
20201203,7호선,노원,16742,17435,34177,20201206
20201203,7호선,마들,11083,10684,21767,20201206
20201203,7호선,수락산,11259,11337,22596,20201206
20201203,7호선,도봉산,8474,9864,18338,20201206
20201203,7호선,장암,2131,824,2955,20201206
20201203,6호선,봉화산(서울의료원),8114,7563,15677,20201206
20201203,6호선,화랑대(서울여대입구),10104,7972,18076,20201206
20201203,6호선,태릉입구,4703,5154,9857,20201206
20201203,6호선,석계,11183,11429,22612,20201206
20201203,6호선,돌곶이,7849,7325,15174,20201206
20201203,6호선,상월곡(한국과학기술연구원),5678,5106,10784,20201206
20201203,6호선,월곡(동덕여대),10026,9982,20008,20201206
20201203,6호선,고려대(종암),6699,6575,13274,20201206
20201203,6호선,안암(고대병원앞),8238,8138,16376,20201206
20201203,6호선,보문,6542,6112,12654,20201206
20201203,6호선,창신,3067,2608,5675,20201206
20201203,6호선,동묘앞,7110,7214,14324,20201206
20201203,6호선,신당,7330,7517,14847,20201206
20201203,6호선,청구,3482,3729,7211,20201206
20201203,6호선,약수,3258,3263,6521,20201206
20201203,6호선,버티고개,1994,1949,3943,20201206
20201203,6호선,한강진,6059,6994,13053,20201206
20201203,6호선,이태원,7229,7585,14814,20201206
20201203,6호선,녹사평(용산구청),3677,3691,7368,20201206
20201203,6호선,삼각지,4772,4277,9049,20201206
20201203,6호선,효창공원앞,6306,5783,12089,20201206
20201203,6호선,공덕,16384,15773,32157,20201206
20201203,6호선,대흥(서강대앞),7303,7478,14781,20201206
20201203,6호선,광흥창(서강),7973,7767,15740,20201206
20201203,6호선,상수,6271,6777,13048,20201206
20201203,6호선,합정,10634,10236,20870,20201206
20201203,6호선,망원,12050,13218,25268,20201206
20201203,6호선,마포구청,12587,11677,24264,20201206
20201203,6호선,월드컵경기장(성산),3868,4040,7908,20201206
20201203,6호선,디지털미디어시티,12576,13782,26358,20201206
20201203,6호선,증산(명지대앞),9082,9095,18177,20201206
20201203,6호선,새절(신사),12033,11200,23233,20201206
20201203,6호선,구산,6708,5125,11833,20201206
20201203,6호선,연신내,1,0,1,20201206
20201203,6호선,독바위,2551,2811,5362,20201206
20201203,6호선,불광,3978,4026,8004,20201206
20201203,6호선,역촌,3394,4017,7411,20201206
20201203,6호선,응암,15951,15911,31862,20201206
20201203,5호선,하남풍산,4249,4256,8505,20201206
20201203,5호선,미사,11682,11639,23321,20201206
20201203,5호선,마천,5336,5369,10705,20201206
20201203,5호선,거여,6993,6643,13636,20201206
20201203,5호선,개롱,5689,6087,11776,20201206
20201203,5호선,오금,3495,3286,6781,20201206
20201203,5호선,방이,6188,6322,12510,20201206
20201203,5호선,올림픽공원(한국체대),3623,3069,6692,20201206
20201203,5호선,둔촌동,7274,7326,14600,20201206
20201203,5호선,상일동,14322,12972,27294,20201206
20201203,5호선,고덕,7890,7798,15688,20201206
20201203,5호선,명일,7658,7857,15515,20201206
20201203,5호선,굽은다리(강동구민회관앞),8540,8183,16723,20201206
20201203,5호선,길동,6962,7329,14291,20201206
20201203,5호선,강동,17736,16754,34490,20201206
20201203,5호선,천호(풍납토성),15588,15752,31340,20201206
20201203,5호선,광나루(장신대),11714,10531,22245,20201206
20201203,5호선,아차산(어린이대공원후문),12418,12343,24761,20201206
20201203,5호선,군자(능동),9802,10454,20256,20201206
20201203,5호선,장한평,16653,16609,33262,20201206
20201203,5호선,답십리,14658,13426,28084,20201206
20201203,5호선,마장,5003,4801,9804,20201206
20201203,5호선,왕십리(성동구청),3986,4358,8344,20201206
20201203,5호선,행당,7490,6805,14295,20201206
20201203,5호선,신금호,5517,5755,11272,20201206
20201203,5호선,청구,3664,3423,7087,20201206
20201203,5호선,동대문역사문화공원(DDP),2682,2984,5666,20201206
20201203,5호선,을지로4가,5638,5746,11384,20201206
20201203,5호선,종로3가,9234,9258,18492,20201206
20201203,5호선,광화문(세종문화회관),27216,28073,55289,20201206
20201203,5호선,서대문,17002,17172,34174,20201206
20201203,5호선,충정로(경기대입구),4495,4640,9135,20201206
20201203,5호선,애오개,6038,6123,12161,20201206
20201203,5호선,공덕,12785,13574,26359,20201206
20201203,5호선,마포,12951,13283,26234,20201206
20201203,5호선,여의나루,6486,6558,13044,20201206
20201203,5호선,여의도,23996,24818,48814,20201206
20201203,5호선,신길,3504,3901,7405,20201206
20201203,5호선,영등포시장,8324,8627,16951,20201206
20201203,5호선,영등포구청,3633,3761,7394,20201206
20201203,5호선,양평,6892,6937,13829,20201206
20201203,5호선,오목교(목동운동장앞),19355,21108,40463,20201206
20201203,5호선,목동,15478,17146,32624,20201206
20201203,5호선,신정(은행정),12859,10364,23223,20201206
20201203,5호선,까치산,25859,24868,50727,20201206
20201203,5호선,화곡,25284,23943,49227,20201206
20201203,5호선,우장산,13245,13088,26333,20201206
20201203,5호선,발산,16832,16729,33561,20201206
20201203,5호선,마곡,8320,8141,16461,20201206
20201203,5호선,송정,5963,5540,11503,20201206
20201203,5호선,김포공항,5474,5438,10912,20201206
20201203,5호선,개화산,4782,4535,9317,20201206
20201203,5호선,방화,6030,5771,11801,20201206
20201203,4호선,쌍문,27012,25071,52083,20201206
20201203,4호선,창동,22966,24444,47410,20201206
20201203,4호선,노원,16449,18345,34794,20201206
20201203,4호선,상계,17110,15935,33045,20201206
20201203,4호선,당고개,11168,10379,21547,20201206
20201203,4호선,남태령,1004,854,1858,20201206
20201203,4호선,사당,20576,17247,37823,20201206
20201203,4호선,총신대입구(이수),16455,17894,34349,20201206
20201203,4호선,동작(현충원),2045,2210,4255,20201206
20201203,4호선,이촌(국립중앙박물관),6159,6752,12911,20201206
20201203,4호선,신용산,12643,13290,25933,20201206
20201203,4호선,삼각지,3992,4316,8308,20201206
20201203,4호선,숙대입구(갈월),11149,10970,22119,20201206
20201203,4호선,서울역,9487,12010,21497,20201206
20201203,4호선,회현(남대문시장),20846,21785,42631,20201206
20201203,4호선,명동,15147,15625,30772,20201206
20201203,4호선,충무로,24349,24941,49290,20201206
20201203,4호선,동대문역사문화공원(DDP),13360,12614,25974,20201206
20201203,4호선,동대문,18222,18765,36987,20201206
20201203,4호선,혜화,25872,25519,51391,20201206
20201203,4호선,한성대입구(삼선교),12093,11985,24078,20201206
20201203,4호선,성신여대입구(돈암),17160,16511,33671,20201206
20201203,4호선,길음,17942,17617,35559,20201206
20201203,4호선,미아사거리,25017,24469,49486,20201206
20201203,4호선,미아(서울사이버대학),13721,13433,27154,20201206
20201203,4호선,수유(강북구청),30599,30631,61230,20201206
20201203,3호선,오금,5585,4979,10564,20201206
20201203,3호선,경찰병원,6917,6950,13867,20201206
20201203,3호선,가락시장,8109,8022,16131,20201206
20201203,3호선,수서,14201,14350,28551,20201206
20201203,3호선,일원,8874,8691,17565,20201206
20201203,3호선,대청,8946,8215,17161,20201206
20201203,3호선,학여울,1606,1677,3283,20201206
20201203,3호선,대치,8761,8891,17652,20201206
20201203,3호선,도곡,5114,5108,10222,20201206
20201203,3호선,매봉,11236,10836,22072,20201206
20201203,3호선,양재(서초구청),35062,37648,72710,20201206
20201203,3호선,남부터미널(예술의전당),25389,25812,51201,20201206
20201203,3호선,교대(법원.검찰청),12579,8385,20964,20201206
20201203,3호선,고속터미널,30969,30066,61035,20201206
20201203,3호선,잠원,4109,4143,8252,20201206
20201203,3호선,신사,25433,26471,51904,20201206
20201203,3호선,압구정,27799,29104,56903,20201206
20201203,3호선,옥수,7936,8273,16209,20201206
20201203,3호선,금호,7267,6951,14218,20201206
20201203,3호선,약수,11503,11258,22761,20201206
20201203,3호선,동대입구,6406,6845,13251,20201206
20201203,3호선,충무로,1,0,1,20201206
20201203,3호선,을지로3가,9274,9445,18719,20201206
20201203,3호선,종로3가,8882,9961,18843,20201206
20201203,3호선,안국,16222,16372,32594,20201206
20201203,3호선,경복궁(정부서울청사),16257,15951,32208,20201206
20201203,3호선,독립문,6359,6555,12914,20201206
20201203,3호선,무악재,3442,3584,7026,20201206
20201203,3호선,홍제,15465,14815,30280,20201206
20201203,3호선,녹번,13459,12474,25933,20201206
20201203,3호선,불광,14938,15786,30724,20201206
20201203,3호선,연신내,33453,31572,65025,20201206
20201203,3호선,구파발,18394,17461,35855,20201206
20201203,3호선,지축,2924,2877,5801,20201206
20201203,2호선,용두(동대문구청),2077,2190,4267,20201206
20201203,2호선,신정네거리,8775,9197,17972,20201206
20201203,2호선,양천구청,6247,6655,12902,20201206
20201203,2호선,도림천,1462,1412,2874,20201206
20201203,2호선,신설동,2861,2787,5648,20201206
20201203,2호선,신답,1435,1637,3072,20201206
20201203,2호선,용답,2338,2346,4684,20201206
20201203,2호선,충정로(경기대입구),9277,9802,19079,20201206
20201203,2호선,이대,10791,10990,21781,20201206
20201203,2호선,신촌,25495,26619,52114,20201206
20201203,2호선,홍대입구,37449,38677,76126,20201206
20201203,2호선,합정,25041,26041,51082,20201206
20201203,2호선,당산,16817,19473,36290,20201206
20201203,2호선,영등포구청,21242,21343,42585,20201206
20201203,2호선,문래,19033,19283,38316,20201206
20201203,2호선,신도림,42401,41291,83692,20201206
20201203,2호선,대림(구로구청),22715,23049,45764,20201206
20201203,2호선,구로디지털단지,55159,55651,110810,20201206
20201203,2호선,신대방,24166,23570,47736,20201206
20201203,2호선,신림,56879,55461,112340,20201206
20201203,2호선,봉천,21857,20529,42386,20201206
20201203,2호선,서울대입구(관악구청),41894,40599,82493,20201206
20201203,2호선,낙성대(강감찬),24382,23730,48112,20201206
20201203,2호선,사당,30864,33851,64715,20201206
20201203,2호선,방배,15054,15636,30690,20201206
20201203,2호선,서초,19523,19305,38828,20201206
20201203,2호선,교대(법원.검찰청),30553,34195,64748,20201206
20201203,2호선,강남,70117,66520,136637,20201206
20201203,2호선,역삼,46296,49785,96081,20201206
20201203,2호선,선릉,51314,45717,97031,20201206
20201203,2호선,삼성(무역센터),45526,45905,91431,20201206
20201203,2호선,종합운동장,6002,6426,12428,20201206
20201203,2호선,잠실새내,17415,17283,34698,20201206
20201203,2호선,잠실(송파구청),53563,53600,107163,20201206
20201203,2호선,잠실나루,12990,12772,25762,20201206
20201203,2호선,강변(동서울터미널),24870,25024,49894,20201206
20201203,2호선,구의(광진구청),21430,21002,42432,20201206
20201203,2호선,건대입구,27211,28836,56047,20201206
20201203,2호선,성수,31227,33829,65056,20201206
20201203,2호선,뚝섬,18640,19996,38636,20201206
20201203,2호선,한양대,6138,6340,12478,20201206
20201203,2호선,왕십리(성동구청),13265,10862,24127,20201206
20201203,2호선,상왕십리,12668,12334,25002,20201206
20201203,2호선,신당,12667,13007,25674,20201206
20201203,2호선,동대문역사문화공원(DDP),10630,11476,22106,20201206
20201203,2호선,을지로4가,12341,12081,24422,20201206
20201203,2호선,을지로3가,18521,18074,36595,20201206
20201203,2호선,을지로입구,35095,35380,70475,20201206
20201203,2호선,시청,21392,20867,42259,20201206
20201203,1호선,청량리(서울시립대입구),18100,18194,36294,20201206
20201203,1호선,제기동,15283,15720,31003,20201206
20201203,1호선,신설동,12836,12466,25302,20201206
20201203,1호선,동대문,9638,9343,18981,20201206
20201203,1호선,종로5가,19704,19502,39206,20201206
20201203,1호선,종로3가,21751,19867,41618,20201206
20201203,1호선,종각,30750,29566,60316,20201206
20201203,1호선,시청,19216,19178,38394,20201206
20201203,1호선,동묘앞,7221,7543,14764,20201206
20201203,1호선,서울역,34581,32527,67108,20201206
20201203,중앙선,지평,36,26,62,20201206
20201203,2호선,아현,9148,8765,17913,20201206
20201204,7호선,광명사거리,21015,21039,42054,20201207
20201204,7호선,철산,19822,20509,40331,20201207
20201204,7호선,가산디지털단지,43393,43102,86495,20201207
20201204,7호선,남구로,15099,16160,31259,20201207
20201204,7호선,대림(구로구청),6908,7148,14056,20201207
20201204,7호선,신풍,10535,10233,20768,20201207
20201204,7호선,보라매,9014,8745,17759,20201207
20201204,7호선,신대방삼거리,15392,14798,30190,20201207
20201204,7호선,장승배기,9122,8879,18001,20201207
20201204,7호선,상도,9571,9220,18791,20201207
20201204,7호선,숭실대입구(살피재),12751,12539,25290,20201207
20201204,7호선,남성,10519,9570,20089,20201207
20201204,7호선,이수,14003,13667,27670,20201207
20201204,7호선,내방,13526,13726,27252,20201207
20201204,7호선,고속터미널,13992,12331,26323,20201207
20201204,7호선,반포,5315,5033,10348,20201207
20201204,7호선,논현,18957,20628,39585,20201207
20201204,7호선,학동,22505,23827,46332,20201207
20201204,7호선,강남구청,14767,16052,30819,20201207
20201204,7호선,청담,18549,20473,39022,20201207
20201204,7호선,뚝섬유원지,6467,6419,12886,20201207
20201204,7호선,건대입구,10600,10674,21274,20201207
20201204,7호선,어린이대공원(세종대),10530,10217,20747,20201207
20201204,7호선,군자(능동),13427,10751,24178,20201207
20201204,7호선,중곡,9088,8721,17809,20201207
20201204,7호선,용마산(용마폭포공원),5485,5230,10715,20201207
20201204,7호선,사가정,15300,15262,30562,20201207
20201204,7호선,면목,14036,13909,27945,20201207
20201204,7호선,상봉(시외버스터미널),15461,14822,30283,20201207
20201204,분당선,한티,13198,13942,27140,20201207
20201204,분당선,선릉,12563,18272,30835,20201207
20201204,과천선,범계,22644,22405,45049,20201207
20201204,과천선,평촌,16239,16189,32428,20201207
20201204,과천선,인덕원,21684,22605,44289,20201207
20201204,과천선,정부과천청사,8517,8338,16855,20201207
20201204,경춘선,청평,1105,1199,2304,20201207
20201204,경춘선,상천,186,184,370,20201207
20201204,경춘선,가평,994,1092,2086,20201207
20201204,경춘선,굴봉산,70,79,149,20201207
20201204,경춘선,백양리,124,111,235,20201207
20201204,경춘선,강촌,286,319,605,20201207
20201204,경춘선,김유정,150,176,326,20201207
20201204,경춘선,남춘천,1873,1781,3654,20201207
20201204,중앙선,도농,8687,7991,16678,20201207
20201204,2호선,신도림,43706,42826,86532,20201207
20201204,일산선,화정,14539,15162,29701,20201207
20201204,경춘선,사릉,3105,2956,6061,20201207
20201204,경춘선,금곡,1312,1289,2601,20201207
20201204,경춘선,평내호평,4971,5075,10046,20201207
20201204,경춘선,천마산,1412,1324,2736,20201207
20201204,경춘선,마석,3217,3212,6429,20201207
20201204,중앙선,구리,12103,12293,24396,20201207
20201204,중앙선,지평,38,42,80,20201207
20201204,중앙선,용문,1133,1284,2417,20201207
20201204,중앙선,원덕,217,248,465,20201207
20201204,중앙선,양평,2082,2125,4207,20201207
20201204,중앙선,오빈,219,213,432,20201207
20201204,중앙선,아신,450,488,938,20201207
20201204,중앙선,국수,536,559,1095,20201207
20201204,중앙선,신원,158,135,293,20201207
20201204,중앙선,양수,1387,1452,2839,20201207
20201204,중앙선,운길산,511,506,1017,20201207
20201204,중앙선,팔당,659,641,1300,20201207
20201204,중앙선,도심,2100,1606,3706,20201207
20201204,중앙선,덕소,4937,4882,9819,20201207
20201204,중앙선,양정,713,612,1325,20201207
20201204,공항철도 1호선,김포공항,9896,5796,15692,20201207
20201204,경춘선,춘천,1062,913,1975,20201207
20201204,공항철도 1호선,서울역,6430,6164,12594,20201207
20201204,공항철도 1호선,공덕,1932,2455,4387,20201207
20201204,공항철도 1호선,홍대입구,6613,7063,13676,20201207
20201204,중앙선,양원,1298,1300,2598,20201207
20201204,중앙선,망우,6571,6526,13097,20201207
20201204,중앙선,상봉(시외버스터미널),5325,5197,10522,20201207
20201204,공항철도 1호선,검암,6496,6391,12887,20201207
20201204,중앙선,중랑,4936,4857,9793,20201207
20201204,중앙선,회기,20572,19775,40347,20201207
20201204,장항선,신창(순천향대),1556,1203,2759,20201207
20201204,장항선,온양온천,3556,3813,7369,20201207
20201204,장항선,배방,928,856,1784,20201207
20201204,장항선,아산,2550,2628,5178,20201207
20201204,장항선,쌍용(나사렛대),1826,1615,3441,20201207
20201204,장항선,봉명,1106,1045,2151,20201207
20201204,일산선,대화,11687,9519,21206,20201207
20201204,일산선,주엽,7797,7899,15696,20201207
20201204,일산선,정발산,6195,6219,12414,20201207
20201204,일산선,마두,6709,6963,13672,20201207
20201204,일산선,백석,9039,9210,18249,20201207
20201204,공항철도 1호선,디지털미디어시티,12471,10903,23374,20201207
20201204,과천선,과천,4502,4184,8686,20201207
20201204,과천선,대공원,1466,1548,3014,20201207
20201204,과천선,경마공원,1211,1187,2398,20201207
20201204,과천선,선바위,7788,6827,14615,20201207
20201204,공항철도 1호선,영종,2413,2490,4903,20201207
20201204,공항철도 1호선,인천공항2터미널,1793,1637,3430,20201207
20201204,공항철도 1호선,인천공항1터미널,2943,3181,6124,20201207
20201204,공항철도 1호선,공항화물청사,2127,2299,4426,20201207
20201204,공항철도 1호선,운서,5183,5309,10492,20201207
20201204,공항철도 1호선,청라국제도시,5723,5462,11185,20201207
20201204,1호선,서울역,37601,36009,73610,20201207
20201204,1호선,동묘앞,7288,7455,14743,20201207
20201204,1호선,시청,19023,18711,37734,20201207
20201204,1호선,종각,30724,29753,60477,20201207
20201204,1호선,종로3가,21718,19840,41558,20201207
20201204,1호선,종로5가,19362,19227,38589,20201207
20201204,1호선,동대문,9903,9449,19352,20201207
20201204,1호선,신설동,12874,12753,25627,20201207
20201204,1호선,제기동,15491,15625,31116,20201207
20201204,1호선,청량리(서울시립대입구),18463,18653,37116,20201207
20201204,2호선,시청,21073,20384,41457,20201207
20201204,2호선,을지로입구,35492,35814,71306,20201207
20201204,2호선,을지로3가,18199,18100,36299,20201207
20201204,2호선,을지로4가,12443,12067,24510,20201207
20201204,2호선,동대문역사문화공원(DDP),10447,11707,22154,20201207
20201204,2호선,신당,12556,12959,25515,20201207
20201204,공항철도 1호선,마곡나루(서울식물원),6261,5901,12162,20201207
20201204,일산선,원당,9991,9513,19504,20201207
20201204,일산선,삼송,15936,15711,31647,20201207
20201204,일산선,원흥,8261,7885,16146,20201207
20201204,우이신설선,신설동,2018,1952,3970,20201207
20201204,우이신설선,보문,1366,1366,2732,20201207
20201204,우이신설선,성신여대입구(돈암),2714,2867,5581,20201207
20201204,우이신설선,정릉,3954,3758,7712,20201207
20201204,우이신설선,북한산보국문,5140,4967,10107,20201207
20201204,우이신설선,솔샘,5052,4680,9732,20201207
20201204,우이신설선,삼양사거리,2184,2207,4391,20201207
20201204,우이신설선,삼양,1791,2030,3821,20201207
20201204,경춘선,퇴계원,3257,3014,6271,20201207
20201204,경춘선,별내,2440,2380,4820,20201207
20201204,경춘선,갈매,2684,2369,5053,20201207
20201204,경춘선,신내,1324,1342,2666,20201207
20201204,경인선,도화,3476,3143,6619,20201207
20201204,경인선,중동,8217,7841,16058,20201207
20201204,경인선,온수(성공회대입구),5879,5769,11648,20201207
20201204,경인선,도원,2489,2549,5038,20201207
20201204,경인선,간석,5101,4923,10024,20201207
20201204,경인선,부개,7524,7178,14702,20201207
20201204,경인선,소사,8650,8196,16846,20201207
20201204,경인선,구일,5603,5723,11326,20201207
20201204,경인선,인천,2680,2022,4702,20201207
20201204,경인선,동인천,12134,11584,23718,20201207
20201204,경인선,제물포,8836,8389,17225,20201207
20201204,경인선,주안,16935,15555,32490,20201207
20201204,경인선,동암,13801,14176,27977,20201207
20201204,경인선,백운,6351,6345,12696,20201207
20201204,경인선,부평,26044,28191,54235,20201207
20201204,경인선,송내,25121,25178,50299,20201207
20201204,경인선,부천,29632,30300,59932,20201207
20201204,경인선,역곡,24887,24802,49689,20201207
20201204,경인선,오류동,10767,10398,21165,20201207
20201204,경인선,개봉,19728,20509,40237,20201207
20201204,경의선,서울역,34,313,347,20201207
20201204,경의선,임진강,8,2,10,20201207
20201204,경의선,문산,4405,4475,8880,20201207
20201204,경의선,파주,1046,766,1812,20201207
20201204,경의선,월롱,2018,1630,3648,20201207
20201204,경의선,금촌,5492,5527,11019,20201207
20201204,경의선,금릉,3788,3699,7487,20201207
20201204,경의선,운정,5246,5043,10289,20201207
20201204,경의선,야당,5234,4940,10174,20201207
20201204,경의선,탄현,6507,6455,12962,20201207
20201204,경의선,일산,7640,7918,15558,20201207
20201204,경의선,풍산,4534,4295,8829,20201207
20201204,경의선,백마,5916,5636,11552,20201207
20201204,경의선,곡산,514,528,1042,20201207
20201204,경의선,능곡,3274,2984,6258,20201207
20201204,경의선,행신,6960,6959,13919,20201207
20201204,경의선,강매,2685,2391,5076,20201207
20201204,경의선,화전,1462,1357,2819,20201207
20201204,경의선,수색,2335,2282,4617,20201207
20201204,경의선,디지털미디어시티,2178,2113,4291,20201207
20201204,경의선,가좌,4631,4385,9016,20201207
20201204,경의선,홍대입구,1260,1472,2732,20201207
20201204,경의선,서강대,1778,1699,3477,20201207
20201204,경의선,공덕,2983,2683,5666,20201207
20201204,경의선,효창공원앞,2587,2940,5527,20201207
20201204,경의선,신촌,702,906,1608,20201207
20201204,경의선,서울역,3609,4336,7945,20201207
20201204,경원선,소요산,2060,1882,3942,20201207
20201204,경원선,동두천,1702,1982,3684,20201207
20201204,경원선,보산,1442,1232,2674,20201207
20201204,경원선,동두천중앙,2694,2638,5332,20201207
20201204,경원선,지행,5601,5543,11144,20201207
20201204,경원선,덕정,4938,4731,9669,20201207
20201204,경원선,덕계,2404,2178,4582,20201207
20201204,경원선,양주,6793,6244,13037,20201207
20201204,경원선,녹양,4115,3955,8070,20201207
20201204,경원선,가능,5699,5483,11182,20201207
20201204,경원선,의정부,16135,16707,32842,20201207
20201204,경원선,회룡,11130,11055,22185,20201207
20201204,경원선,망월사,6429,6575,13004,20201207
20201204,경원선,도봉산,6638,4119,10757,20201207
20201204,경원선,도봉,5520,5238,10758,20201207
20201204,경원선,방학,8551,8432,16983,20201207
20201204,경원선,녹천,4336,3583,7919,20201207
20201204,경원선,월계,5795,5530,11325,20201207
20201204,경원선,광운대,7280,6975,14255,20201207
20201204,경원선,석계,7363,8428,15791,20201207
20201204,경원선,신이문,7790,7336,15126,20201207
20201204,경원선,외대앞,6705,6542,13247,20201207
20201204,경원선,청량리(서울시립대입구),12811,14079,26890,20201207
20201204,경원선,왕십리(성동구청),11747,13583,25330,20201207
20201204,경원선,응봉,1586,1319,2905,20201207
20201204,경원선,옥수,53,30,83,20201207
20201204,경원선,한남,3803,3569,7372,20201207
20201204,경원선,서빙고,1746,1525,3271,20201207
20201204,경원선,이촌(국립중앙박물관),3317,2650,5967,20201207
20201204,경부선,광명,2869,2699,5568,20201207
20201204,경부선,서동탄,1365,1221,2586,20201207
20201204,경부선,당정,5737,5543,11280,20201207
20201204,경부선,천안,4390,4698,9088,20201207
20201204,경부선,두정,4845,4568,9413,20201207
20201204,경부선,직산,691,635,1326,20201207
20201204,경부선,성환,3394,3113,6507,20201207
20201204,경부선,평택,10493,10194,20687,20201207
20201204,경부선,지제,2696,2551,5247,20201207
20201204,경부선,서정리,5839,5057,10896,20201207
20201204,경부선,송탄,3810,3633,7443,20201207
20201204,경부선,진위,1523,1225,2748,20201207
20201204,경부선,오산,8731,8529,17260,20201207
20201204,경부선,오산대,2787,2574,5361,20201207
20201204,경부선,세마,2397,2157,4554,20201207
20201204,경부선,병점,12262,11919,24181,20201207
20201204,경부선,세류,2734,2625,5359,20201207
20201204,경부선,독산,15725,16753,32478,20201207
20201204,경부선,수원,29530,32213,61743,20201207
20201204,경부선,화서,6509,6474,12983,20201207
20201204,경부선,성균관대,12899,12595,25494,20201207
20201204,경부선,의왕,8497,8309,16806,20201207
20201204,경부선,군포,7241,7308,14549,20201207
20201204,경부선,금정,24094,24381,48475,20201207
20201204,경부선,명학,8548,8443,16991,20201207
20201204,경부선,안양,20993,21307,42300,20201207
20201204,경부선,관악,6559,6150,12709,20201207
20201204,경부선,석수,9521,8222,17743,20201207
20201204,경부선,금천구청,10577,10703,21280,20201207
20201204,경부선,가산디지털단지,16294,19183,35477,20201207
20201204,경부선,구로,17652,18065,35717,20201207
20201204,경부선,신길,8607,7106,15713,20201207
20201204,경부선,신도림,3789,3661,7450,20201207
20201204,경부선,영등포,34449,35609,70058,20201207
20201204,경부선,대방,12044,12210,24254,20201207
20201204,경부선,노량진,8012,8170,16182,20201207
20201204,경부선,용산,28144,29025,57169,20201207
20201204,경부선,남영,8474,8743,17217,20201207
20201204,경부선,서울역,4867,1531,6398,20201207
20201204,경강선,여주,1448,1611,3059,20201207
20201204,경강선,세종대왕릉,220,237,457,20201207
20201204,경강선,부발,2163,1489,3652,20201207
20201204,경강선,이천,2216,2254,4470,20201207
20201204,경강선,신둔도예촌,1113,1051,2164,20201207
20201204,경강선,곤지암,2006,1829,3835,20201207
20201204,경강선,초월,2772,2623,5395,20201207
20201204,경강선,경기광주,6059,5933,11992,20201207
20201204,경강선,삼동,2118,1970,4088,20201207
20201204,경강선,이매,896,790,1686,20201207
20201204,경강선,판교,4026,3881,7907,20201207
20201204,9호선2~3단계,중앙보훈병원,8568,7487,16055,20201207
20201204,9호선2~3단계,둔촌오륜,865,752,1617,20201207
20201204,9호선2~3단계,올림픽공원(한국체대),4626,4753,9379,20201207
20201204,9호선2~3단계,한성백제,2246,1958,4204,20201207
20201204,9호선2~3단계,송파나루,3940,4086,8026,20201207
20201204,9호선2~3단계,석촌,6983,6100,13083,20201207
20201204,9호선2~3단계,석촌고분,5120,5111,10231,20201207
20201204,공항철도 1호선,계양,8413,7721,16134,20201207
20201204,분당선,대모산입구,3190,3041,6231,20201207
20201204,분당선,개포동,3233,3315,6548,20201207
20201204,분당선,구룡,1469,1397,2866,20201207
20201204,분당선,도곡,5665,5690,11355,20201207
20201204,우이신설선,화계,2990,2809,5799,20201207
20201204,우이신설선,가오리,3566,3649,7215,20201207
20201204,우이신설선,4.19민주묘지,2473,2390,4863,20201207
20201204,우이신설선,솔밭공원,2059,2035,4094,20201207
20201204,우이신설선,북한산우이,2007,1782,3789,20201207
20201204,안산선,수리산,3861,3074,6935,20201207
20201204,안산선,오이도,7533,7373,14906,20201207
20201204,경춘선,대성리,373,355,728,20201207
20201204,안산선,정왕,8060,8096,16156,20201207
20201204,안산선,신길온천,1517,1419,2936,20201207
20201204,안산선,안산,10960,9988,20948,20201207
20201204,안산선,초지,4409,4805,9214,20201207
20201204,안산선,고잔,7738,7310,15048,20201207
20201204,안산선,중앙,14519,15507,30026,20201207
20201204,안산선,한대앞,7659,7693,15352,20201207
20201204,안산선,상록수,14775,14875,29650,20201207
20201204,안산선,반월,3867,3664,7531,20201207
20201204,안산선,대야미,4564,4021,8585,20201207
20201204,안산선,산본,14283,15515,29798,20201207
20201204,수인선,인천,791,1297,2088,20201207
20201204,수인선,신포,1417,1390,2807,20201207
20201204,수인선,숭의,3519,3326,6845,20201207
20201204,수인선,인하대,4988,4648,9636,20201207
20201204,수인선,송도,2212,2066,4278,20201207
20201204,수인선,연수,3812,3843,7655,20201207
20201204,수인선,원인재,3814,3977,7791,20201207
20201204,수인선,남동인더스파크,2148,2436,4584,20201207
20201204,수인선,호구포,3299,3435,6734,20201207
20201204,수인선,인천논현,4764,5063,9827,20201207
20201204,수인선,소래포구,3968,3852,7820,20201207
20201204,수인선,월곶,2161,2013,4174,20201207
20201204,수인선,달월,76,54,130,20201207
20201204,수인선,사리,3114,2951,6065,20201207
20201204,수인선,야목,158,148,306,20201207
20201204,수인선,어천,538,500,1038,20201207
20201204,수인선,오목천,1958,1804,3762,20201207
20201204,수인선,고색,2887,2720,5607,20201207
20201204,분당선,매교,2362,2521,4883,20201207
20201204,분당선,수원시청,10918,12038,22956,20201207
20201204,분당선,매탄권선,4288,3971,8259,20201207
20201204,분당선,망포,12942,11946,24888,20201207
20201204,분당선,영통,7400,7423,14823,20201207
20201204,분당선,청명,3688,3531,7219,20201207
20201204,분당선,상갈,4680,4540,9220,20201207
20201204,분당선,기흥,8308,8249,16557,20201207
20201204,분당선,신갈,3978,3968,7946,20201207
20201204,분당선,구성,4296,4495,8791,20201207
20201204,분당선,죽전,12132,13031,25163,20201207
20201204,분당선,보정,2067,1781,3848,20201207
20201204,분당선,이매,4648,4425,9073,20201207
20201204,분당선,오리,10842,9280,20122,20201207
20201204,분당선,미금,13703,14706,28409,20201207
20201204,분당선,정자,14459,15341,29800,20201207
20201204,분당선,수내,11865,11909,23774,20201207
20201204,분당선,서현,21678,22163,43841,20201207
20201204,분당선,야탑,22998,24350,47348,20201207
20201204,분당선,모란,20568,20724,41292,20201207
20201204,분당선,태평,12483,12244,24727,20201207
20201204,분당선,가천대,6644,7352,13996,20201207
20201204,분당선,선정릉,7171,7601,14772,20201207
20201204,분당선,강남구청,8720,9801,18521,20201207
20201204,분당선,압구정로데오,16276,17414,33690,20201207
20201204,분당선,서울숲,7572,7508,15080,20201207
20201204,분당선,수원,7320,6100,13420,20201207
20201204,분당선,수서,12245,13481,25726,20201207
20201204,일산선,대곡,1599,1201,2800,20201207
20201204,6호선,망원,12349,13460,25809,20201207
20201204,9호선2~3단계,삼전,5857,5761,11618,20201207
20201204,9호선2~3단계,종합운동장,3772,3689,7461,20201207
20201204,9호선2~3단계,봉은사,14292,14423,28715,20201207
20201204,9호선2~3단계,삼성중앙,6099,6375,12474,20201207
20201204,6호선,마포구청,12786,11495,24281,20201207
20201204,6호선,월드컵경기장(성산),3905,4137,8042,20201207
20201204,6호선,디지털미디어시티,12464,13671,26135,20201207
20201204,6호선,증산(명지대앞),9203,9013,18216,20201207
20201204,6호선,새절(신사),11709,10868,22577,20201207
20201204,6호선,구산,6397,4945,11342,20201207
20201204,6호선,연신내,1,0,1,20201207
20201204,6호선,독바위,2507,2649,5156,20201207
20201204,6호선,불광,4064,4081,8145,20201207
20201204,6호선,역촌,3393,3928,7321,20201207
20201204,6호선,응암,16072,15981,32053,20201207
20201204,5호선,하남풍산,4414,4460,8874,20201207
20201204,5호선,미사,11927,12068,23995,20201207
20201204,5호선,마천,5363,5406,10769,20201207
20201204,5호선,거여,7249,6862,14111,20201207
20201204,5호선,개롱,5645,5960,11605,20201207
20201204,5호선,오금,3348,3231,6579,20201207
20201204,5호선,방이,6149,6297,12446,20201207
20201204,5호선,올림픽공원(한국체대),3585,2973,6558,20201207
20201204,5호선,둔촌동,7568,7715,15283,20201207
20201204,5호선,상일동,14330,12912,27242,20201207
20201204,5호선,고덕,7685,7840,15525,20201207
20201204,5호선,명일,7655,8003,15658,20201207
20201204,5호선,굽은다리(강동구민회관앞),8628,8214,16842,20201207
20201204,5호선,길동,7152,7603,14755,20201207
20201204,5호선,강동,17978,16410,34388,20201207
20201204,5호선,천호(풍납토성),16132,16358,32490,20201207
20201204,5호선,광나루(장신대),11587,10435,22022,20201207
20201204,5호선,아차산(어린이대공원후문),12427,12370,24797,20201207
20201204,2호선,상왕십리,12794,12241,25035,20201207
20201204,2호선,왕십리(성동구청),13363,10891,24254,20201207
20201204,2호선,한양대,5911,6054,11965,20201207
20201204,2호선,뚝섬,18236,19677,37913,20201207
20201204,2호선,성수,30994,33615,64609,20201207
20201204,2호선,건대입구,28181,30214,58395,20201207
20201204,2호선,구의(광진구청),21102,20976,42078,20201207
20201204,2호선,강변(동서울터미널),27467,27776,55243,20201207
20201204,2호선,잠실나루,12573,12031,24604,20201207
20201204,2호선,잠실(송파구청),54085,54406,108491,20201207
20201204,2호선,잠실새내,18002,17878,35880,20201207
20201204,2호선,종합운동장,6073,6617,12690,20201207
20201204,2호선,삼성(무역센터),46124,46429,92553,20201207
20201204,2호선,선릉,51442,45724,97166,20201207
20201204,2호선,역삼,45144,48736,93880,20201207
20201204,2호선,강남,74698,70337,145035,20201207
20201204,2호선,교대(법원.검찰청),31064,34779,65843,20201207
20201204,2호선,서초,19439,19214,38653,20201207
20201204,2호선,방배,14968,15561,30529,20201207
20201204,2호선,사당,32058,34901,66959,20201207
20201204,2호선,낙성대(강감찬),24925,23674,48599,20201207
20201204,2호선,서울대입구(관악구청),42800,41082,83882,20201207
20201204,2호선,봉천,22259,20534,42793,20201207
20201204,5호선,군자(능동),9843,10778,20621,20201207
20201204,5호선,장한평,16751,16680,33431,20201207
20201204,5호선,답십리,14825,13676,28501,20201207
20201204,5호선,마장,5088,4705,9793,20201207
20201204,5호선,왕십리(성동구청),4038,4312,8350,20201207
20201204,5호선,행당,7503,6637,14140,20201207
20201204,5호선,신금호,5487,5635,11122,20201207
20201204,5호선,청구,3667,3424,7091,20201207
20201204,5호선,동대문역사문화공원(DDP),2619,3052,5671,20201207
20201204,5호선,을지로4가,5566,5777,11343,20201207
20201204,5호선,종로3가,9080,9057,18137,20201207
20201204,5호선,광화문(세종문화회관),26937,27965,54902,20201207
20201204,5호선,서대문,16607,17009,33616,20201207
20201204,5호선,충정로(경기대입구),4470,4443,8913,20201207
20201204,5호선,애오개,6003,6034,12037,20201207
20201204,5호선,공덕,12754,13498,26252,20201207
20201204,5호선,마포,13042,13530,26572,20201207
20201204,5호선,여의나루,5995,6114,12109,20201207
20201204,5호선,여의도,23962,24800,48762,20201207
20201204,5호선,신길,3773,3968,7741,20201207
20201204,5호선,영등포시장,8452,8598,17050,20201207
20201204,5호선,영등포구청,3788,3759,7547,20201207
20201204,5호선,양평,6803,6772,13575,20201207
20201204,5호선,오목교(목동운동장앞),20072,21765,41837,20201207
20201204,5호선,목동,15141,16682,31823,20201207
20201204,5호선,신정(은행정),12825,10038,22863,20201207
20201204,5호선,까치산,25813,25016,50829,20201207
20201204,5호선,화곡,25789,24017,49806,20201207
20201204,5호선,우장산,11878,12087,23965,20201207
20201204,5호선,발산,15960,16286,32246,20201207
20201204,5호선,마곡,8241,8124,16365,20201207
20201204,5호선,송정,5980,5598,11578,20201207
20201204,5호선,김포공항,6141,6005,12146,20201207
20201204,5호선,개화산,4570,4365,8935,20201207
20201204,5호선,방화,5869,5506,11375,20201207
20201204,4호선,쌍문,27254,24805,52059,20201207
20201204,4호선,창동,23056,24772,47828,20201207
20201204,4호선,노원,16845,18793,35638,20201207
20201204,4호선,상계,17232,16161,33393,20201207
20201204,4호선,당고개,11198,10197,21395,20201207
20201204,4호선,남태령,953,825,1778,20201207
20201204,4호선,사당,21640,17610,39250,20201207
20201204,4호선,총신대입구(이수),16804,18540,35344,20201207
20201204,4호선,동작(현충원),2132,2262,4394,20201207
20201204,4호선,이촌(국립중앙박물관),6286,6790,13076,20201207
20201204,4호선,신용산,13143,13980,27123,20201207
20201204,4호선,삼각지,4196,4490,8686,20201207
20201204,4호선,숙대입구(갈월),10942,10913,21855,20201207
20201204,2호선,신림,57753,56125,113878,20201207
20201204,2호선,신대방,24265,23549,47814,20201207
20201204,2호선,구로디지털단지,55725,55858,111583,20201207
20201204,2호선,대림(구로구청),22696,23265,45961,20201207
20201204,2호선,문래,18836,19301,38137,20201207
20201204,2호선,영등포구청,21438,21434,42872,20201207
20201204,2호선,당산,16736,19818,36554,20201207
20201204,2호선,합정,25996,27420,53416,20201207
20201204,2호선,홍대입구,40021,42648,82669,20201207
20201204,2호선,신촌,27063,27998,55061,20201207
20201204,2호선,이대,11348,11601,22949,20201207
20201204,2호선,아현,8917,8664,17581,20201207
20201204,2호선,충정로(경기대입구),9212,9694,18906,20201207
20201204,2호선,용답,2350,2281,4631,20201207
20201204,2호선,신답,1420,1620,3040,20201207
20201204,2호선,신설동,3083,2979,6062,20201207
20201204,2호선,도림천,1142,1203,2345,20201207
20201204,2호선,양천구청,5929,6417,12346,20201207
20201204,2호선,신정네거리,8815,9141,17956,20201207
20201204,2호선,용두(동대문구청),2231,2263,4494,20201207
20201204,3호선,지축,2933,2893,5826,20201207
20201204,3호선,구파발,18174,17021,35195,20201207
20201204,3호선,연신내,33827,31931,65758,20201207
20201204,3호선,불광,14719,15952,30671,20201207
20201204,3호선,녹번,13652,12368,26020,20201207
20201204,3호선,홍제,15398,14995,30393,20201207
20201204,3호선,무악재,3503,3683,7186,20201207
20201204,3호선,독립문,6217,6430,12647,20201207
20201204,3호선,경복궁(정부서울청사),16528,15868,32396,20201207
20201204,3호선,안국,15732,16174,31906,20201207
20201204,3호선,종로3가,8625,9719,18344,20201207
20201204,3호선,을지로3가,9393,9629,19022,20201207
20201204,3호선,충무로,3,0,3,20201207
20201204,3호선,동대입구,6261,6617,12878,20201207
20201204,3호선,약수,11772,11301,23073,20201207
20201204,3호선,금호,7315,6901,14216,20201207
20201204,3호선,옥수,8055,8273,16328,20201207
20201204,3호선,압구정,29243,31129,60372,20201207
20201204,3호선,신사,27626,28635,56261,20201207
20201204,3호선,잠원,4277,4181,8458,20201207
20201204,3호선,고속터미널,35847,38767,74614,20201207
20201204,3호선,교대(법원.검찰청),12986,8455,21441,20201207
20201204,3호선,남부터미널(예술의전당),27015,27770,54785,20201207
20201204,3호선,양재(서초구청),36111,37479,73590,20201207
20201204,3호선,매봉,11517,10715,22232,20201207
20201204,3호선,도곡,4625,4659,9284,20201207
20201204,3호선,대치,9998,10051,20049,20201207
20201204,3호선,학여울,1595,1634,3229,20201207
20201204,3호선,대청,8818,8069,16887,20201207
20201204,3호선,일원,8443,8206,16649,20201207
20201204,3호선,수서,15289,15935,31224,20201207
20201204,3호선,가락시장,8431,8427,16858,20201207
20201204,3호선,경찰병원,6857,6889,13746,20201207
20201204,3호선,오금,5690,5076,10766,20201207
20201204,4호선,수유(강북구청),31116,31056,62172,20201207
20201204,4호선,미아(서울사이버대학),13832,13473,27305,20201207
20201204,4호선,미아사거리,25189,24700,49889,20201207
20201204,4호선,길음,18056,17562,35618,20201207
20201204,4호선,성신여대입구(돈암),17241,16807,34048,20201207
20201204,4호선,한성대입구(삼선교),11849,11576,23425,20201207
20201204,4호선,혜화,25800,25518,51318,20201207
20201204,4호선,동대문,18363,18941,37304,20201207
20201204,4호선,동대문역사문화공원(DDP),13490,12611,26101,20201207
20201204,4호선,충무로,24396,25345,49741,20201207
20201204,4호선,명동,15207,15499,30706,20201207
20201204,4호선,회현(남대문시장),20950,21941,42891,20201207
20201204,4호선,서울역,9736,13511,23247,20201207
20201204,6호선,합정,11033,10778,21811,20201207
20201204,6호선,상수,6534,7236,13770,20201207
20201204,6호선,광흥창(서강),7822,7563,15385,20201207
20201204,6호선,대흥(서강대앞),7094,7267,14361,20201207
20201204,6호선,공덕,16367,16016,32383,20201207
20201204,6호선,효창공원앞,6360,5703,12063,20201207
20201204,6호선,삼각지,4815,4438,9253,20201207
20201204,6호선,녹사평(용산구청),3818,3991,7809,20201207
20201204,6호선,이태원,7621,8108,15729,20201207
20201204,6호선,한강진,6200,6910,13110,20201207
20201204,6호선,버티고개,2089,1997,4086,20201207
20201204,6호선,약수,3168,3263,6431,20201207
20201204,6호선,청구,3420,3632,7052,20201207
20201204,6호선,신당,6976,7149,14125,20201207
20201204,6호선,동묘앞,7148,7417,14565,20201207
20201204,6호선,창신,3164,2571,5735,20201207
20201204,6호선,보문,6570,6033,12603,20201207
20201204,6호선,안암(고대병원앞),8649,8497,17146,20201207
20201204,6호선,고려대(종암),6928,6702,13630,20201207
20201204,6호선,월곡(동덕여대),10261,10302,20563,20201207
20201204,6호선,상월곡(한국과학기술연구원),5611,5010,10621,20201207
20201204,6호선,돌곶이,7818,7343,15161,20201207
20201204,6호선,석계,11197,11385,22582,20201207
20201204,6호선,태릉입구,4805,5271,10076,20201207
20201204,6호선,화랑대(서울여대입구),10106,7874,17980,20201207
20201204,6호선,봉화산(서울의료원),8087,7463,15550,20201207
20201204,7호선,장암,2149,877,3026,20201207
20201204,7호선,도봉산,8266,9596,17862,20201207
20201204,7호선,수락산,11434,11416,22850,20201207
20201204,7호선,마들,10763,10526,21289,20201207
20201204,7호선,노원,16936,18196,35132,20201207
20201204,7호선,중계,12932,11691,24623,20201207
20201204,7호선,하계,15494,14763,30257,20201207
20201204,7호선,공릉(서울과학기술대),10340,10116,20456,20201207
20201204,7호선,태릉입구,7328,6848,14176,20201207
20201204,7호선,먹골,9292,9126,18418,20201207
20201204,7호선,중화,10101,9902,20003,20201207
20201204,9호선2~3단계,선정릉,8506,9007,17513,20201207
20201204,9호선2~3단계,언주,9087,8985,18072,20201207
20201204,9호선,신논현,28238,27563,55801,20201207
20201204,9호선,사평,2727,2706,5433,20201207
20201204,9호선,고속터미널,9934,13656,23590,20201207
20201204,9호선,신반포,2589,2633,5222,20201207
20201204,9호선,구반포,2463,2579,5042,20201207
20201204,9호선,동작(현충원),1558,1185,2743,20201207
20201204,9호선,흑석(중앙대입구),6780,7100,13880,20201207
20201204,9호선,노들,4001,3458,7459,20201207
20201204,9호선,노량진,22994,22258,45252,20201207
20201204,9호선,샛강,5091,5201,10292,20201207
20201204,9호선,여의도,21426,20102,41528,20201207
20201204,9호선,국회의사당,15518,15024,30542,20201207
20201204,9호선,당산,16147,15834,31981,20201207
20201204,9호선,선유도,6913,6591,13504,20201207
20201204,9호선,신목동,3413,3102,6515,20201207
20201204,9호선,염창,15411,15131,30542,20201207
20201204,9호선,등촌,9748,9703,19451,20201207
20201204,9호선,증미,6510,6809,13319,20201207
20201204,9호선,가양,17606,17325,34931,20201207
20201204,9호선,양천향교,8587,8838,17425,20201207
20201204,9호선,마곡나루(서울식물원),9567,9435,19002,20201207
20201204,9호선,신방화,6010,5814,11824,20201207
20201204,9호선,공항시장,2588,2779,5367,20201207
20201204,9호선,김포공항,6688,9743,16431,20201207
20201204,9호선,개화,2259,1608,3867,20201207
20201204,8호선,모란,4412,3314,7726,20201207
20201204,8호선,수진,4656,4243,8899,20201207
20201204,8호선,신흥,4108,4464,8572,20201207
20201204,8호선,단대오거리,9495,8903,18398,20201207
20201204,8호선,남한산성입구(성남법원.검찰청),12748,11572,24320,20201207
20201204,8호선,산성,6337,6263,12600,20201207
20201204,8호선,복정,9723,8308,18031,20201207
20201204,8호선,장지,15615,15208,30823,20201207
20201204,8호선,문정,20321,20892,41213,20201207
20201204,8호선,가락시장,7435,8308,15743,20201207
20201204,8호선,송파,7164,7163,14327,20201207
20201204,8호선,석촌,6953,7996,14949,20201207
20201204,8호선,잠실(송파구청),11969,13326,25295,20201207
20201204,8호선,몽촌토성(평화의문),5031,5275,10306,20201207
20201204,8호선,강동구청,9772,10041,19813,20201207
20201204,8호선,천호(풍납토성),14137,16171,30308,20201207
20201204,8호선,암사,17450,15564,33014,20201207
20201204,7호선,부평구청,10667,8899,19566,20201207
20201204,7호선,굴포천,7835,8512,16347,20201207
20201204,7호선,삼산체육관,4318,3912,8230,20201207
20201204,7호선,상동,11248,11813,23061,20201207
20201204,7호선,부천시청,11034,11066,22100,20201207
20201204,7호선,신중동,12961,12826,25787,20201207
20201204,7호선,춘의,9264,9027,18291,20201207
20201204,7호선,부천종합운동장,4069,3560,7629,20201207
20201204,7호선,까치울,6767,6538,13305,20201207
20201204,7호선,온수(성공회대입구),9700,8983,18683,20201207
20201204,7호선,천왕,9961,9425,19386,20201207
20201205,9호선,신목동,1637,1494,3131,20201208
20201205,수인선,어천,364,357,721,20201208
20201205,수인선,오목천,1264,1100,2364,20201208
20201205,수인선,고색,1528,1501,3029,20201208
20201205,분당선,매교,1477,1523,3000,20201208
20201205,분당선,수원시청,8067,8525,16592,20201208
20201205,분당선,매탄권선,2548,2393,4941,20201208
20201205,분당선,망포,6791,6286,13077,20201208
20201205,분당선,영통,5275,5191,10466,20201208
20201205,분당선,청명,2022,1967,3989,20201208
20201205,분당선,상갈,2931,2890,5821,20201208
20201205,분당선,기흥,5038,4913,9951,20201208
20201205,분당선,신갈,1946,2045,3991,20201208
20201205,분당선,구성,2402,2524,4926,20201208
20201205,분당선,죽전,8260,9042,17302,20201208
20201205,분당선,보정,1165,1015,2180,20201208
20201205,분당선,이매,2809,2783,5592,20201208
20201205,분당선,오리,6246,5270,11516,20201208
20201205,분당선,미금,8497,8781,17278,20201208
20201205,분당선,정자,8215,8441,16656,20201208
20201205,분당선,수내,7148,6646,13794,20201208
20201205,분당선,서현,13614,13688,27302,20201208
20201205,분당선,야탑,13447,14175,27622,20201208
20201205,분당선,모란,12727,12472,25199,20201208
20201205,중앙선,오빈,169,188,357,20201208
20201205,중앙선,양평,1543,1701,3244,20201208
20201205,중앙선,원덕,191,240,431,20201208
20201205,중앙선,용문,1736,1840,3576,20201208
20201205,중앙선,지평,37,32,69,20201208
20201205,1호선,서울역,19947,19677,39624,20201208
20201205,1호선,동묘앞,8919,9157,18076,20201208
20201205,1호선,시청,6867,6604,13471,20201208
20201205,1호선,종각,11837,11478,23315,20201208
20201205,1호선,종로3가,14395,13539,27934,20201208
20201205,1호선,종로5가,12335,12321,24656,20201208
20201205,1호선,동대문,8468,7499,15967,20201208
20201205,1호선,신설동,7482,7165,14647,20201208
20201205,1호선,제기동,11874,12256,24130,20201208
20201205,1호선,청량리(서울시립대입구),14213,14409,28622,20201208
20201205,2호선,시청,5504,4918,10422,20201208
20201205,2호선,을지로입구,14916,14692,29608,20201208
20201205,2호선,을지로3가,6430,6288,12718,20201208
20201205,2호선,을지로4가,6005,6097,12102,20201208
20201205,2호선,동대문역사문화공원(DDP),7170,7446,14616,20201208
20201205,2호선,신당,8570,8663,17233,20201208
20201205,2호선,상왕십리,7396,7026,14422,20201208
20201205,2호선,왕십리(성동구청),10181,8493,18674,20201208
20201205,2호선,한양대,11176,10965,22141,20201208
20201205,2호선,뚝섬,7706,8106,15812,20201208
20201205,2호선,성수,10377,11331,21708,20201208
20201205,2호선,건대입구,24722,26509,51231,20201208
20201205,2호선,구의(광진구청),12578,12487,25065,20201208
20201205,2호선,강변(동서울터미널),18341,19194,37535,20201208
20201205,2호선,잠실나루,5525,5463,10988,20201208
20201205,2호선,잠실(송파구청),39006,37511,76517,20201208
20201205,2호선,잠실새내,11550,11937,23487,20201208
20201205,2호선,종합운동장,3626,3988,7614,20201208
20201205,2호선,삼성(무역센터),21035,21355,42390,20201208
20201205,2호선,선릉,19835,17586,37421,20201208
20201205,2호선,역삼,15118,16218,31336,20201208
20201205,2호선,강남,41726,40271,81997,20201208
20201205,2호선,교대(법원.검찰청),13319,14787,28106,20201208
20201205,2호선,서초,9258,8277,17535,20201208
20201205,2호선,방배,8203,8370,16573,20201208
20201205,2호선,사당,20912,23150,44062,20201208
20201205,2호선,낙성대(강감찬),16542,15521,32063,20201208
20201205,2호선,서울대입구(관악구청),27662,27054,54716,20201208
20201205,2호선,봉천,13815,12810,26625,20201208
20201205,2호선,신림,38981,37139,76120,20201208
20201205,2호선,신대방,15601,15477,31078,20201208
20201205,2호선,구로디지털단지,26496,26624,53120,20201208
20201205,2호선,대림(구로구청),14744,15902,30646,20201208
20201205,2호선,신도림,30589,30318,60907,20201208
20201205,2호선,문래,8709,9036,17745,20201208
20201205,2호선,영등포구청,10196,10439,20635,20201208
20201205,2호선,당산,9592,10594,20186,20201208
20201205,2호선,합정,17385,18169,35554,20201208
20201205,2호선,홍대입구,32570,33966,66536,20201208
20201205,2호선,신촌,21681,21630,43311,20201208
20201205,2호선,이대,7419,7459,14878,20201208
20201205,2호선,아현,5683,5566,11249,20201208
20201205,2호선,충정로(경기대입구),4308,4436,8744,20201208
20201205,2호선,용답,1649,1523,3172,20201208
20201205,2호선,신답,707,781,1488,20201208
20201205,2호선,신설동,2434,2538,4972,20201208
20201205,2호선,도림천,647,664,1311,20201208
20201205,2호선,양천구청,3259,3447,6706,20201208
20201205,2호선,신정네거리,5374,5526,10900,20201208
20201205,2호선,용두(동대문구청),1324,1345,2669,20201208
20201205,3호선,지축,1797,1784,3581,20201208
20201205,3호선,구파발,10927,10943,21870,20201208
20201205,3호선,연신내,23809,22247,46056,20201208
20201205,3호선,불광,9966,11193,21159,20201208
20201205,3호선,녹번,7660,6833,14493,20201208
20201205,3호선,홍제,9969,9558,19527,20201208
20201205,3호선,무악재,1996,2130,4126,20201208
20201205,3호선,독립문,4246,4228,8474,20201208
20201205,3호선,경복궁(정부서울청사),8366,8652,17018,20201208
20201205,3호선,안국,7728,8709,16437,20201208
20201205,3호선,종로3가,3252,4426,7678,20201208
20201205,3호선,을지로3가,3230,3615,6845,20201208
20201205,3호선,동대입구,4280,4683,8963,20201208
20201205,3호선,약수,6989,6535,13524,20201208
20201205,3호선,금호,4612,4353,8965,20201208
20201205,3호선,옥수,5225,5343,10568,20201208
20201205,3호선,압구정,19064,19693,38757,20201208
20201205,3호선,신사,17458,17833,35291,20201208
20201205,3호선,잠원,2488,2368,4856,20201208
20201205,3호선,고속터미널,31759,32561,64320,20201208
20201205,3호선,교대(법원.검찰청),4937,3135,8072,20201208
20201205,3호선,남부터미널(예술의전당),14293,14494,28787,20201208
20201205,3호선,양재(서초구청),15644,16985,32629,20201208
20201205,3호선,매봉,4558,4340,8898,20201208
20201205,3호선,도곡,2558,2558,5116,20201208
20201205,3호선,대치,6571,6159,12730,20201208
20201205,3호선,학여울,901,937,1838,20201208
20201205,3호선,대청,4524,4229,8753,20201208
20201205,3호선,일원,3654,3668,7322,20201208
20201205,3호선,수서,8961,9513,18474,20201208
20201205,3호선,가락시장,4998,4842,9840,20201208
20201205,3호선,경찰병원,3112,3060,6172,20201208
20201205,3호선,오금,2950,2721,5671,20201208
20201205,4호선,수유(강북구청),20722,20274,40996,20201208
20201205,4호선,미아(서울사이버대학),8900,8591,17491,20201208
20201205,4호선,미아사거리,17197,16963,34160,20201208
20201205,4호선,길음,11194,10920,22114,20201208
20201205,4호선,성신여대입구(돈암),12786,12168,24954,20201208
20201205,4호선,한성대입구(삼선교),7953,7455,15408,20201208
20201205,4호선,혜화,19790,18804,38594,20201208
20201205,4호선,동대문,10556,10473,21029,20201208
20201205,4호선,동대문역사문화공원(DDP),8096,7053,15149,20201208
20201205,4호선,충무로,9326,9569,18895,20201208
20201205,4호선,명동,9041,10173,19214,20201208
20201205,4호선,회현(남대문시장),12031,12669,24700,20201208
20201205,4호선,서울역,3843,7542,11385,20201208
20201205,4호선,숙대입구(갈월),7090,6758,13848,20201208
20201205,4호선,삼각지,1895,2297,4192,20201208
20201205,4호선,신용산,6208,6787,12995,20201208
20201205,4호선,이촌(국립중앙박물관),3828,4109,7937,20201208
20201205,4호선,동작(현충원),1465,1452,2917,20201208
20201205,4호선,총신대입구(이수),10746,11684,22430,20201208
20201205,4호선,사당,13937,11909,25846,20201208
20201205,4호선,남태령,623,471,1094,20201208
20201205,4호선,당고개,7532,7290,14822,20201208
20201205,4호선,상계,10844,10387,21231,20201208
20201205,4호선,노원,11799,12957,24756,20201208
20201205,4호선,창동,15157,16167,31324,20201208
20201205,4호선,쌍문,16961,15651,32612,20201208
20201205,5호선,방화,3590,3393,6983,20201208
20201205,5호선,개화산,2691,2696,5387,20201208
20201205,5호선,김포공항,4968,5188,10156,20201208
20201205,5호선,송정,3875,3774,7649,20201208
20201205,5호선,마곡,3442,3271,6713,20201208
20201205,5호선,발산,9365,9881,19246,20201208
20201205,5호선,우장산,7004,7125,14129,20201208
20201205,5호선,화곡,14922,14080,29002,20201208
20201205,5호선,까치산,16397,15841,32238,20201208
20201205,5호선,신정(은행정),7016,6058,13074,20201208
20201205,5호선,목동,8441,8718,17159,20201208
20201205,5호선,오목교(목동운동장앞),12314,13065,25379,20201208
20201205,5호선,양평,2816,2720,5536,20201208
20201205,5호선,영등포구청,1511,1487,2998,20201208
20201205,5호선,영등포시장,5240,5650,10890,20201208
20201205,5호선,신길,1915,2049,3964,20201208
20201205,5호선,여의도,6531,6730,13261,20201208
20201205,5호선,여의나루,2868,2837,5705,20201208
20201205,5호선,마포,5267,5265,10532,20201208
20201205,5호선,공덕,5093,5417,10510,20201208
20201205,5호선,애오개,2763,2658,5421,20201208
20201205,5호선,충정로(경기대입구),1541,1456,2997,20201208
20201205,5호선,서대문,5290,5229,10519,20201208
20201205,5호선,광화문(세종문화회관),9370,9378,18748,20201208
20201205,5호선,종로3가,5997,6090,12087,20201208
20201205,5호선,을지로4가,2566,2775,5341,20201208
20201205,5호선,동대문역사문화공원(DDP),770,971,1741,20201208
20201205,5호선,청구,2015,1821,3836,20201208
20201205,5호선,신금호,3037,3165,6202,20201208
20201205,5호선,행당,4223,3749,7972,20201208
20201205,5호선,왕십리(성동구청),2643,2953,5596,20201208
20201205,5호선,마장,2986,2964,5950,20201208
20201205,5호선,답십리,8174,7562,15736,20201208
20201205,5호선,장한평,8258,8191,16449,20201208
20201205,5호선,군자(능동),6136,6640,12776,20201208
20201205,5호선,아차산(어린이대공원후문),9005,8811,17816,20201208
20201205,5호선,광나루(장신대),7096,6891,13987,20201208
20201205,5호선,천호(풍납토성),12459,12160,24619,20201208
20201205,5호선,강동,10559,9956,20515,20201208
20201205,5호선,길동,4508,4774,9282,20201208
20201205,5호선,굽은다리(강동구민회관앞),5383,5012,10395,20201208
20201205,5호선,명일,4402,4444,8846,20201208
20201205,5호선,고덕,4348,4328,8676,20201208
20201205,5호선,상일동,7058,6579,13637,20201208
20201205,5호선,둔촌동,4743,4815,9558,20201208
20201205,5호선,올림픽공원(한국체대),2128,1810,3938,20201208
20201205,5호선,방이,3886,3756,7642,20201208
20201205,5호선,오금,1728,1605,3333,20201208
20201205,5호선,개롱,3609,3646,7255,20201208
20201205,5호선,거여,4236,4117,8353,20201208
20201205,5호선,마천,3434,3504,6938,20201208
20201205,5호선,미사,7038,6932,13970,20201208
20201205,5호선,하남풍산,2519,2731,5250,20201208
20201205,6호선,응암,10008,9825,19833,20201208
20201205,6호선,역촌,2018,2317,4335,20201208
20201205,6호선,불광,3215,3046,6261,20201208
20201205,6호선,독바위,1568,1887,3455,20201208
20201205,6호선,구산,4007,3178,7185,20201208
20201205,6호선,새절(신사),6873,6661,13534,20201208
20201205,6호선,증산(명지대앞),5956,5924,11880,20201208
20201205,6호선,디지털미디어시티,5617,5785,11402,20201208
20201205,6호선,월드컵경기장(성산),3182,3306,6488,20201208
20201205,6호선,마포구청,7144,6397,13541,20201208
20201205,6호선,망원,8741,9386,18127,20201208
20201205,6호선,합정,7902,7472,15374,20201208
20201205,6호선,상수,4654,5381,10035,20201208
20201205,6호선,광흥창(서강),3945,3648,7593,20201208
20201205,6호선,대흥(서강대앞),4618,4637,9255,20201208
20201205,6호선,공덕,7602,7174,14776,20201208
20201205,6호선,효창공원앞,3607,3237,6844,20201208
20201205,6호선,삼각지,3009,2457,5466,20201208
20201205,6호선,녹사평(용산구청),2963,3037,6000,20201208
20201205,6호선,이태원,5940,6452,12392,20201208
20201205,6호선,한강진,3778,4498,8276,20201208
20201205,6호선,버티고개,1163,1269,2432,20201208
20201205,6호선,약수,1931,1975,3906,20201208
20201205,6호선,청구,1910,1974,3884,20201208
20201205,6호선,신당,4692,3576,8268,20201208
20201205,6호선,동묘앞,6531,5797,12328,20201208
20201205,6호선,창신,1698,1399,3097,20201208
20201205,6호선,보문,3948,3496,7444,20201208
20201205,6호선,안암(고대병원앞),4422,4302,8724,20201208
20201205,6호선,고려대(종암),3864,3658,7522,20201208
20201205,6호선,월곡(동덕여대),5651,5595,11246,20201208
20201205,6호선,상월곡(한국과학기술연구원),3248,2885,6133,20201208
20201205,6호선,돌곶이,4504,4338,8842,20201208
20201205,6호선,석계,6880,6829,13709,20201208
20201205,6호선,태릉입구,2998,3191,6189,20201208
20201205,6호선,화랑대(서울여대입구),5428,4604,10032,20201208
20201205,6호선,봉화산(서울의료원),4123,4078,8201,20201208
20201205,7호선,장암,1250,790,2040,20201208
20201205,7호선,도봉산,4850,6987,11837,20201208
20201205,7호선,수락산,7876,7871,15747,20201208
20201205,7호선,마들,6858,6639,13497,20201208
20201205,7호선,노원,12288,12110,24398,20201208
20201205,7호선,중계,7976,7151,15127,20201208
20201205,7호선,하계,9495,9126,18621,20201208
20201205,7호선,공릉(서울과학기술대),6667,6444,13111,20201208
20201205,7호선,태릉입구,4884,4619,9503,20201208
20201205,7호선,먹골,6352,6284,12636,20201208
20201205,7호선,중화,6317,6086,12403,20201208
20201205,7호선,상봉(시외버스터미널),10313,9985,20298,20201208
20201205,7호선,면목,8797,8787,17584,20201208
20201205,7호선,사가정,10088,9861,19949,20201208
20201205,7호선,용마산(용마폭포공원),3439,3427,6866,20201208
20201205,7호선,중곡,5477,5289,10766,20201208
20201205,7호선,군자(능동),8501,6596,15097,20201208
20201205,7호선,어린이대공원(세종대),8885,8377,17262,20201208
20201205,7호선,건대입구,12275,10884,23159,20201208
20201205,7호선,뚝섬유원지,4505,4278,8783,20201208
20201205,7호선,청담,10080,10475,20555,20201208
20201205,7호선,강남구청,8052,8640,16692,20201208
20201205,7호선,학동,9295,9765,19060,20201208
20201205,7호선,논현,9187,9805,18992,20201208
20201205,7호선,반포,3620,3385,7005,20201208
20201205,7호선,고속터미널,9419,8125,17544,20201208
20201205,7호선,내방,6475,6349,12824,20201208
20201205,7호선,이수,9020,8362,17382,20201208
20201205,7호선,남성,6348,5960,12308,20201208
20201205,7호선,숭실대입구(살피재),8913,8472,17385,20201208
20201205,7호선,상도,5879,5624,11503,20201208
20201205,7호선,장승배기,5554,5332,10886,20201208
20201205,7호선,신대방삼거리,9154,8707,17861,20201208
20201205,7호선,보라매,5182,4832,10014,20201208
20201205,7호선,신풍,6457,6289,12746,20201208
20201205,7호선,대림(구로구청),5494,5815,11309,20201208
20201205,7호선,남구로,6941,7546,14487,20201208
20201205,7호선,가산디지털단지,12824,11758,24582,20201208
20201205,7호선,철산,11685,11909,23594,20201208
20201205,7호선,광명사거리,13903,14172,28075,20201208
20201205,7호선,천왕,5352,5096,10448,20201208
20201205,7호선,온수(성공회대입구),4695,4574,9269,20201208
20201205,7호선,까치울,3956,4003,7959,20201208
20201205,7호선,부천종합운동장,2315,2158,4473,20201208
20201205,7호선,춘의,4129,4110,8239,20201208
20201205,7호선,신중동,7355,7049,14404,20201208
20201205,7호선,부천시청,6848,6909,13757,20201208
20201205,7호선,상동,7693,7849,15542,20201208
20201205,7호선,삼산체육관,2439,2303,4742,20201208
20201205,7호선,굴포천,4813,5076,9889,20201208
20201205,7호선,부평구청,5484,4909,10393,20201208
20201205,8호선,암사,9805,9228,19033,20201208
20201205,8호선,천호(풍납토성),9801,11302,21103,20201208
20201205,8호선,강동구청,4699,4805,9504,20201208
20201205,8호선,몽촌토성(평화의문),3010,3117,6127,20201208
20201205,8호선,잠실(송파구청),8587,9269,17856,20201208
20201205,8호선,석촌,4256,4962,9218,20201208
20201205,8호선,송파,3996,4082,8078,20201208
20201205,8호선,가락시장,4674,4725,9399,20201208
20201205,8호선,문정,6809,6870,13679,20201208
20201205,8호선,장지,9518,9276,18794,20201208
20201205,8호선,복정,5194,4659,9853,20201208
20201205,8호선,산성,4169,4248,8417,20201208
20201205,8호선,남한산성입구(성남법원.검찰청),7302,6590,13892,20201208
20201205,8호선,단대오거리,5675,5520,11195,20201208
20201205,8호선,신흥,2923,3082,6005,20201208
20201205,8호선,수진,3180,2954,6134,20201208
20201205,8호선,모란,2402,2172,4574,20201208
20201205,9호선,개화,1081,938,2019,20201208
20201205,9호선,김포공항,5189,8278,13467,20201208
20201205,9호선,공항시장,1700,1884,3584,20201208
20201205,9호선,신방화,3418,3380,6798,20201208
20201205,9호선,마곡나루(서울식물원),5364,5410,10774,20201208
20201205,9호선,양천향교,4410,4262,8672,20201208
20201205,9호선,가양,10616,10277,20893,20201208
20201205,9호선,증미,3254,3085,6339,20201208
20201205,9호선,등촌,5396,5276,10672,20201208
20201205,9호선,염창,8544,8079,16623,20201208
20201205,9호선,선유도,2564,2631,5195,20201208
20201205,9호선,당산,9048,8333,17381,20201208
20201205,9호선,국회의사당,3146,3229,6375,20201208
20201205,9호선,여의도,5806,5581,11387,20201208
20201205,9호선,샛강,1834,1892,3726,20201208
20201205,9호선,노량진,15553,15476,31029,20201208
20201205,9호선,노들,2490,2181,4671,20201208
20201205,9호선,흑석(중앙대입구),4089,4114,8203,20201208
20201205,9호선,동작(현충원),1028,788,1816,20201208
20201205,9호선,구반포,1727,1778,3505,20201208
20201205,9호선,신반포,1666,1587,3253,20201208
20201205,9호선,고속터미널,7605,10519,18124,20201208
20201205,9호선,사평,1390,1315,2705,20201208
20201205,9호선,신논현,16923,16677,33600,20201208
20201205,9호선2~3단계,언주,4787,4834,9621,20201208
20201205,9호선2~3단계,선정릉,3689,4056,7745,20201208
20201205,9호선2~3단계,삼성중앙,2367,2360,4727,20201208
20201205,9호선2~3단계,봉은사,7481,7682,15163,20201208
20201205,9호선2~3단계,종합운동장,2403,2042,4445,20201208
20201205,9호선2~3단계,삼전,3701,3399,7100,20201208
20201205,9호선2~3단계,석촌고분,3007,2918,5925,20201208
20201205,9호선2~3단계,석촌,4485,3787,8272,20201208
20201205,9호선2~3단계,송파나루,2493,2603,5096,20201208
20201205,9호선2~3단계,한성백제,1314,1090,2404,20201208
20201205,9호선2~3단계,올림픽공원(한국체대),2622,2638,5260,20201208
20201205,9호선2~3단계,둔촌오륜,473,428,901,20201208
20201205,9호선2~3단계,중앙보훈병원,3306,3028,6334,20201208
20201205,경강선,판교,2185,1980,4165,20201208
20201205,경강선,이매,589,476,1065,20201208
20201205,경강선,삼동,1110,1038,2148,20201208
20201205,경강선,경기광주,3630,3524,7154,20201208
20201205,경강선,초월,1575,1567,3142,20201208
20201205,경강선,곤지암,1326,1419,2745,20201208
20201205,경강선,신둔도예촌,646,697,1343,20201208
20201205,경강선,이천,1778,1945,3723,20201208
20201205,경강선,부발,1398,1056,2454,20201208
20201205,경강선,세종대왕릉,185,212,397,20201208
20201205,경강선,여주,1294,1506,2800,20201208
20201205,경부선,서울역,3401,904,4305,20201208
20201205,경부선,남영,4578,4579,9157,20201208
20201205,경부선,용산,19124,19885,39009,20201208
20201205,경부선,노량진,6487,6040,12527,20201208
20201205,경부선,대방,6326,6304,12630,20201208
20201205,경부선,영등포,27774,28487,56261,20201208
20201205,경부선,신도림,2124,2153,4277,20201208
20201205,경부선,신길,5006,4201,9207,20201208
20201205,경부선,구로,11065,11383,22448,20201208
20201205,경부선,가산디지털단지,4777,6721,11498,20201208
20201205,경부선,금천구청,6129,6236,12365,20201208
20201205,경부선,석수,5357,5090,10447,20201208
20201205,경부선,관악,4608,4179,8787,20201208
20201205,경부선,안양,13183,13528,26711,20201208
20201205,경부선,명학,4474,4281,8755,20201208
20201205,경부선,금정,14523,14411,28934,20201208
20201205,경부선,군포,3718,3518,7236,20201208
20201205,경부선,의왕,4671,4635,9306,20201208
20201205,경부선,성균관대,7352,7461,14813,20201208
20201205,경부선,화서,3882,3949,7831,20201208
20201205,경부선,수원,25625,28016,53641,20201208
20201205,경부선,독산,6622,6711,13333,20201208
20201205,경부선,세류,1949,1967,3916,20201208
20201205,경부선,병점,8280,8172,16452,20201208
20201205,경부선,세마,1494,1361,2855,20201208
20201205,경부선,오산대,1868,1702,3570,20201208
20201205,경부선,오산,6853,6566,13419,20201208
20201205,경부선,진위,802,683,1485,20201208
20201205,경부선,송탄,3501,3215,6716,20201208
20201205,경부선,서정리,4847,3747,8594,20201208
20201205,경부선,지제,2060,1846,3906,20201208
20201205,경부선,평택,9487,9425,18912,20201208
20201205,경부선,성환,2236,2055,4291,20201208
20201205,경부선,직산,500,481,981,20201208
20201205,경부선,두정,3414,3411,6825,20201208
20201205,경부선,천안,4105,4279,8384,20201208
20201205,경부선,당정,3064,2959,6023,20201208
20201205,경부선,서동탄,769,760,1529,20201208
20201205,경부선,광명,1678,1509,3187,20201208
20201205,경원선,이촌(국립중앙박물관),2176,1673,3849,20201208
20201205,경원선,서빙고,956,882,1838,20201208
20201205,경원선,한남,2247,2047,4294,20201208
20201205,경원선,옥수,17,24,41,20201208
20201205,경원선,응봉,1060,882,1942,20201208
20201205,경원선,왕십리(성동구청),9352,10413,19765,20201208
20201205,경원선,청량리(서울시립대입구),9983,11118,21101,20201208
20201205,경원선,외대앞,4948,4774,9722,20201208
20201205,경원선,신이문,4948,4636,9584,20201208
20201205,경원선,석계,5018,5396,10414,20201208
20201205,경원선,광운대,4393,4340,8733,20201208
20201205,경원선,월계,3848,3620,7468,20201208
20201205,경원선,녹천,2703,2314,5017,20201208
20201205,경원선,방학,5832,5764,11596,20201208
20201205,경원선,도봉,3639,3544,7183,20201208
20201205,경원선,도봉산,6886,4566,11452,20201208
20201205,경원선,망월사,4143,4393,8536,20201208
20201205,경원선,회룡,7105,7205,14310,20201208
20201205,경원선,의정부,12830,13515,26345,20201208
20201205,경원선,가능,3972,3855,7827,20201208
20201205,경원선,녹양,2714,2739,5453,20201208
20201205,경원선,양주,4508,4414,8922,20201208
20201205,경원선,덕계,1614,1417,3031,20201208
20201205,경원선,덕정,3121,2990,6111,20201208
20201205,경원선,지행,4109,4048,8157,20201208
20201205,경원선,동두천중앙,2094,2237,4331,20201208
20201205,경원선,보산,1338,1313,2651,20201208
20201205,경원선,동두천,1111,1436,2547,20201208
20201205,경원선,소요산,2560,2281,4841,20201208
20201205,경의선,서울역,845,974,1819,20201208
20201205,경의선,신촌,230,253,483,20201208
20201205,경의선,효창공원앞,1219,1443,2662,20201208
20201205,경의선,공덕,1962,1406,3368,20201208
20201205,경의선,서강대,1534,1498,3032,20201208
20201205,경의선,홍대입구,1116,1116,2232,20201208
20201205,경의선,가좌,2982,2792,5774,20201208
20201205,경의선,디지털미디어시티,1301,1271,2572,20201208
20201205,경의선,수색,1007,977,1984,20201208
20201205,경의선,화전,1992,1692,3684,20201208
20201205,경의선,강매,1430,1260,2690,20201208
20201205,경의선,행신,3764,3768,7532,20201208
20201205,경의선,능곡,2004,1960,3964,20201208
20201205,경의선,곡산,279,307,586,20201208
20201205,경의선,백마,2968,2972,5940,20201208
20201205,경의선,풍산,2907,2852,5759,20201208
20201205,경의선,일산,4552,4477,9029,20201208
20201205,경의선,탄현,3756,3694,7450,20201208
20201205,경의선,야당,3413,3398,6811,20201208
20201205,경의선,운정,3199,3109,6308,20201208
20201205,경의선,금릉,2589,2544,5133,20201208
20201205,경의선,금촌,3898,3875,7773,20201208
20201205,경의선,월롱,927,934,1861,20201208
20201205,경의선,파주,647,474,1121,20201208
20201205,경의선,문산,3102,3080,6182,20201208
20201205,경의선,임진강,19,22,41,20201208
20201205,경인선,개봉,12949,12970,25919,20201208
20201205,경인선,오류동,7143,6632,13775,20201208
20201205,경인선,역곡,15588,15768,31356,20201208
20201205,경인선,부천,22165,23122,45287,20201208
20201205,경인선,송내,13918,13951,27869,20201208
20201205,경인선,부평,21057,22855,43912,20201208
20201205,경인선,백운,4323,4376,8699,20201208
20201205,경인선,동암,9959,10341,20300,20201208
20201205,경인선,주안,12050,10991,23041,20201208
20201205,경인선,제물포,5567,5416,10983,20201208
20201205,경인선,동인천,8723,8670,17393,20201208
20201205,경인선,인천,2503,2068,4571,20201208
20201205,경인선,구일,3125,3008,6133,20201208
20201205,경인선,소사,6664,6402,13066,20201208
20201205,경인선,부개,4855,4728,9583,20201208
20201205,경인선,간석,3216,3199,6415,20201208
20201205,경인선,도원,1796,1868,3664,20201208
20201205,경인선,온수(성공회대입구),3636,3554,7190,20201208
20201205,경인선,중동,5168,4984,10152,20201208
20201205,경인선,도화,2322,2147,4469,20201208
20201205,경춘선,신내,757,781,1538,20201208
20201205,경춘선,갈매,1413,1222,2635,20201208
20201205,경춘선,별내,1573,1592,3165,20201208
20201205,경춘선,퇴계원,1892,1749,3641,20201208
20201205,경춘선,사릉,1676,1647,3323,20201208
20201205,경춘선,금곡,787,725,1512,20201208
20201205,경춘선,평내호평,3082,3077,6159,20201208
20201205,경춘선,천마산,985,1015,2000,20201208
20201205,경춘선,마석,2180,2280,4460,20201208
20201205,경춘선,대성리,327,326,653,20201208
20201205,경춘선,청평,956,1055,2011,20201208
20201205,경춘선,상천,235,205,440,20201208
20201205,경춘선,가평,970,1100,2070,20201208
20201205,경춘선,굴봉산,76,99,175,20201208
20201205,경춘선,백양리,90,98,188,20201208
20201205,경춘선,강촌,326,363,689,20201208
20201205,경춘선,김유정,201,251,452,20201208
20201205,경춘선,남춘천,1423,1483,2906,20201208
20201205,경춘선,춘천,766,755,1521,20201208
20201205,공항철도 1호선,서울역,4395,4353,8748,20201208
20201205,공항철도 1호선,공덕,1077,1647,2724,20201208
20201205,공항철도 1호선,홍대입구,5750,5662,11412,20201208
20201205,공항철도 1호선,디지털미디어시티,4003,3718,7721,20201208
20201205,공항철도 1호선,마곡나루(서울식물원),1993,2092,4085,20201208
20201205,공항철도 1호선,김포공항,6930,4086,11016,20201208
20201205,공항철도 1호선,계양,4558,4210,8768,20201208
20201205,공항철도 1호선,검암,3468,3475,6943,20201208
20201205,공항철도 1호선,청라국제도시,2731,2700,5431,20201208
20201205,공항철도 1호선,운서,4220,4186,8406,20201208
20201205,공항철도 1호선,공항화물청사,1157,1271,2428,20201208
20201205,공항철도 1호선,인천공항1터미널,2527,2689,5216,20201208
20201205,공항철도 1호선,인천공항2터미널,1431,1318,2749,20201208
20201205,공항철도 1호선,영종,1774,1904,3678,20201208
20201205,과천선,선바위,3754,3470,7224,20201208
20201205,과천선,경마공원,868,849,1717,20201208
20201205,과천선,대공원,1850,2028,3878,20201208
20201205,과천선,과천,2871,2651,5522,20201208
20201205,과천선,정부과천청사,3989,4133,8122,20201208
20201205,과천선,인덕원,11547,11415,22962,20201208
20201205,과천선,평촌,7153,7023,14176,20201208
20201205,과천선,범계,14586,14161,28747,20201208
20201205,분당선,선릉,4562,6543,11105,20201208
20201205,분당선,한티,8658,8810,17468,20201208
20201205,분당선,도곡,3325,3102,6427,20201208
20201205,분당선,구룡,895,861,1756,20201208
20201205,분당선,개포동,1958,1963,3921,20201208
20201205,분당선,대모산입구,2280,2089,4369,20201208
20201205,분당선,수서,7257,7761,15018,20201208
20201205,분당선,수원,5522,4484,10006,20201208
20201205,분당선,서울숲,4017,3995,8012,20201208
20201205,분당선,압구정로데오,12396,13292,25688,20201208
20201205,분당선,강남구청,4048,4938,8986,20201208
20201205,분당선,선정릉,2787,2815,5602,20201208
20201205,분당선,가천대,3889,4501,8390,20201208
20201205,분당선,태평,8582,8325,16907,20201208
20201205,중앙선,아신,406,394,800,20201208
20201205,중앙선,국수,475,481,956,20201208
20201205,중앙선,신원,172,116,288,20201208
20201205,중앙선,양수,1265,1307,2572,20201208
20201205,중앙선,운길산,702,650,1352,20201208
20201205,중앙선,팔당,902,1008,1910,20201208
20201205,중앙선,도심,1189,1057,2246,20201208
20201205,중앙선,덕소,3182,3313,6495,20201208
20201205,중앙선,양정,443,365,808,20201208
20201205,중앙선,도농,5000,4791,9791,20201208
20201205,중앙선,구리,7607,7933,15540,20201208
20201205,중앙선,양원,833,800,1633,20201208
20201205,중앙선,망우,4616,4489,9105,20201208
20201205,중앙선,상봉(시외버스터미널),3678,3620,7298,20201208
20201205,중앙선,중랑,3370,3316,6686,20201208
20201205,중앙선,회기,15232,14569,29801,20201208
20201205,장항선,신창(순천향대),889,876,1765,20201208
20201205,장항선,온양온천,2483,2621,5104,20201208
20201205,장항선,배방,724,675,1399,20201208
20201205,장항선,아산,1878,1870,3748,20201208
20201205,장항선,쌍용(나사렛대),1111,959,2070,20201208
20201205,장항선,봉명,532,472,1004,20201208
20201205,일산선,대화,6748,5983,12731,20201208
20201205,일산선,주엽,4624,4697,9321,20201208
20201205,일산선,정발산,4467,4459,8926,20201208
20201205,일산선,마두,3724,3827,7551,20201208
20201205,일산선,백석,6074,6273,12347,20201208
20201205,일산선,대곡,858,724,1582,20201208
20201205,일산선,화정,9365,9914,19279,20201208
20201205,일산선,원당,6253,6082,12335,20201208
20201205,일산선,삼송,10074,10037,20111,20201208
20201205,일산선,원흥,4977,4795,9772,20201208
20201205,우이신설선,신설동,1194,1129,2323,20201208
20201205,우이신설선,보문,895,926,1821,20201208
20201205,우이신설선,성신여대입구(돈암),2031,2312,4343,20201208
20201205,우이신설선,정릉,2678,2328,5006,20201208
20201205,우이신설선,북한산보국문,3478,3261,6739,20201208
20201205,우이신설선,솔샘,2760,2559,5319,20201208
20201205,우이신설선,삼양사거리,1489,1463,2952,20201208
20201205,우이신설선,삼양,1194,1345,2539,20201208
20201205,우이신설선,화계,1878,1823,3701,20201208
20201205,우이신설선,가오리,2155,2075,4230,20201208
20201205,우이신설선,4.19민주묘지,1696,1567,3263,20201208
20201205,우이신설선,솔밭공원,1334,1258,2592,20201208
20201205,우이신설선,북한산우이,2236,2181,4417,20201208
20201205,안산선,수리산,2258,2043,4301,20201208
20201205,안산선,오이도,5190,5386,10576,20201208
20201205,안산선,정왕,4814,5126,9940,20201208
20201205,안산선,신길온천,1054,1027,2081,20201208
20201205,안산선,안산,8042,8418,16460,20201208
20201205,안산선,초지,2563,2608,5171,20201208
20201205,안산선,고잔,4697,4833,9530,20201208
20201205,안산선,중앙,10786,11354,22140,20201208
20201205,안산선,한대앞,5195,5261,10456,20201208
20201205,안산선,상록수,9870,9828,19698,20201208
20201205,안산선,반월,2681,2502,5183,20201208
20201205,안산선,대야미,2912,2558,5470,20201208
20201205,안산선,산본,9068,9756,18824,20201208
20201205,수인선,인천,705,1235,1940,20201208
20201205,수인선,신포,1038,1072,2110,20201208
20201205,수인선,숭의,2115,2070,4185,20201208
20201205,수인선,인하대,3278,3072,6350,20201208
20201205,수인선,송도,1525,1540,3065,20201208
20201205,수인선,연수,2817,2839,5656,20201208
20201205,수인선,원인재,2845,2927,5772,20201208
20201205,수인선,남동인더스파크,837,780,1617,20201208
20201205,수인선,호구포,2000,1863,3863,20201208
20201205,수인선,인천논현,3396,3573,6969,20201208
20201205,수인선,소래포구,3446,3510,6956,20201208
20201205,수인선,월곶,1497,1518,3015,20201208
20201205,수인선,달월,46,45,91,20201208
20201205,수인선,사리,2081,1899,3980,20201208
20201205,수인선,야목,146,129,275,20201208
20201206,일산선,정발산,3176,3086,6262,20201209
20201206,일산선,마두,2458,2495,4953,20201209
20201206,일산선,백석,4143,4077,8220,20201209
20201206,일산선,대곡,684,557,1241,20201209
20201206,일산선,화정,6702,6985,13687,20201209
20201206,일산선,원당,4514,4475,8989,20201209
20201206,일산선,삼송,7307,7155,14462,20201209
20201206,일산선,원흥,3497,3435,6932,20201209
20201206,우이신설선,신설동,1038,959,1997,20201209
20201206,우이신설선,보문,733,758,1491,20201209
20201206,우이신설선,성신여대입구(돈암),1461,1709,3170,20201209
20201206,우이신설선,정릉,1880,1694,3574,20201209
20201206,우이신설선,북한산보국문,2640,2476,5116,20201209
20201206,우이신설선,솔샘,1977,1807,3784,20201209
20201206,우이신설선,삼양사거리,1165,1126,2291,20201209
20201206,우이신설선,삼양,920,909,1829,20201209
20201206,우이신설선,화계,1475,1472,2947,20201209
20201206,우이신설선,가오리,1746,1653,3399,20201209
20201206,우이신설선,4.19민주묘지,2701,2339,5040,20201209
20201206,우이신설선,솔밭공원,1203,1109,2312,20201209
20201206,우이신설선,북한산우이,2043,2052,4095,20201209
20201206,안산선,수리산,1570,1523,3093,20201209
20201206,안산선,오이도,4049,3925,7974,20201209
20201206,안산선,정왕,4428,4702,9130,20201209
20201206,안산선,신길온천,857,759,1616,20201209
20201206,안산선,안산,7938,7110,15048,20201209
20201206,안산선,초지,1644,1582,3226,20201209
20201206,안산선,고잔,3373,3311,6684,20201209
20201206,안산선,중앙,7908,7855,15763,20201209
20201206,안산선,한대앞,3770,3686,7456,20201209
20201206,안산선,상록수,7188,7002,14190,20201209
20201206,9호선,양천향교,2853,3057,5910,20201209
20201206,9호선,마곡나루(서울식물원),3479,3600,7079,20201209
20201206,9호선,신방화,2426,2396,4822,20201209
20201206,9호선,공항시장,1222,1372,2594,20201209
20201206,9호선,김포공항,5104,6943,12047,20201209
20201206,9호선,개화,790,735,1525,20201209
20201206,8호선,모란,1847,1507,3354,20201209
20201206,8호선,수진,2225,2000,4225,20201209
20201206,8호선,신흥,2063,2183,4246,20201209
20201206,8호선,단대오거리,4017,3938,7955,20201209
20201206,8호선,남한산성입구(성남법원.검찰청),5068,4769,9837,20201209
20201206,8호선,산성,3071,3123,6194,20201209
20201206,8호선,복정,3600,3351,6951,20201209
20201206,8호선,장지,6772,7093,13865,20201209
20201206,8호선,문정,4121,4448,8569,20201209
20201206,8호선,가락시장,2635,3497,6132,20201209
20201206,8호선,송파,2706,2727,5433,20201209
20201206,8호선,석촌,2823,3339,6162,20201209
20201206,8호선,잠실(송파구청),6398,6705,13103,20201209
20201206,8호선,몽촌토성(평화의문),2103,2138,4241,20201209
20201206,8호선,강동구청,3060,3423,6483,20201209
20201206,8호선,천호(풍납토성),6877,7613,14490,20201209
20201206,8호선,암사,6820,6345,13165,20201209
20201206,7호선,부평구청,3740,3347,7087,20201209
20201206,7호선,굴포천,3374,3357,6731,20201209
20201206,7호선,삼산체육관,1765,1653,3418,20201209
20201206,7호선,상동,4878,4745,9623,20201209
20201206,7호선,부천시청,4690,4654,9344,20201209
20201206,7호선,신중동,4837,4625,9462,20201209
20201206,7호선,춘의,2710,2567,5277,20201209
20201206,7호선,부천종합운동장,1682,1504,3186,20201209
20201206,7호선,까치울,2663,2683,5346,20201209
20201206,7호선,온수(성공회대입구),3217,3073,6290,20201209
20201206,7호선,천왕,3424,3411,6835,20201209
20201206,7호선,광명사거리,9432,9337,18769,20201209
20201206,7호선,철산,7464,7539,15003,20201209
20201206,7호선,가산디지털단지,8764,8234,16998,20201209
20201206,7호선,남구로,5423,5221,10644,20201209
20201206,7호선,대림(구로구청),5145,4769,9914,20201209
20201206,7호선,신풍,4421,4137,8558,20201209
20201206,7호선,보라매,3799,3708,7507,20201209
20201206,7호선,신대방삼거리,6142,6144,12286,20201209
20201206,7호선,장승배기,3847,3761,7608,20201209
20201206,7호선,상도,3858,3882,7740,20201209
20201206,7호선,숭실대입구(살피재),4193,4520,8713,20201209
20201206,7호선,남성,4192,4208,8400,20201209
20201206,7호선,이수,5674,5356,11030,20201209
20201206,7호선,내방,3911,4066,7977,20201209
20201206,7호선,고속터미널,8069,5790,13859,20201209
20201206,7호선,반포,2066,2158,4224,20201209
20201206,7호선,논현,4844,5258,10102,20201209
20201206,7호선,학동,4870,5320,10190,20201209
20201206,7호선,강남구청,4214,4697,8911,20201209
20201206,7호선,청담,5298,5671,10969,20201209
20201206,7호선,뚝섬유원지,3327,3148,6475,20201209
20201206,7호선,건대입구,5513,5515,11028,20201209
20201206,7호선,어린이대공원(세종대),4628,4607,9235,20201209
20201206,7호선,군자(능동),5679,4368,10047,20201209
20201206,7호선,중곡,3932,3864,7796,20201209
20201206,7호선,용마산(용마폭포공원),2339,2628,4967,20201209
20201206,7호선,사가정,7097,6967,14064,20201209
20201206,7호선,면목,6250,6193,12443,20201209
20201206,7호선,상봉(시외버스터미널),6938,6602,13540,20201209
20201206,7호선,중화,4326,4382,8708,20201209
20201206,7호선,먹골,4150,3978,8128,20201209
20201206,7호선,태릉입구,3319,3006,6325,20201209
20201206,7호선,공릉(서울과학기술대),4499,4845,9344,20201209
20201206,7호선,하계,6570,6135,12705,20201209
20201206,7호선,중계,5636,5216,10852,20201209
20201206,7호선,노원,8062,7783,15845,20201209
20201206,7호선,마들,4312,4010,8322,20201209
20201206,7호선,수락산,6112,6059,12171,20201209
20201206,7호선,도봉산,3952,5842,9794,20201209
20201206,7호선,장암,938,621,1559,20201209
20201206,6호선,봉화산(서울의료원),2915,2843,5758,20201209
20201206,6호선,화랑대(서울여대입구),3251,2812,6063,20201209
20201206,6호선,태릉입구,2099,2321,4420,20201209
20201206,6호선,석계,4754,4855,9609,20201209
20201206,6호선,돌곶이,3443,3347,6790,20201209
20201206,6호선,상월곡(한국과학기술연구원),2330,2125,4455,20201209
20201206,6호선,월곡(동덕여대),3952,4112,8064,20201209
20201206,6호선,고려대(종암),2772,2800,5572,20201209
20201206,6호선,안암(고대병원앞),3050,3190,6240,20201209
20201206,6호선,보문,2882,2783,5665,20201209
20201206,6호선,창신,1148,1091,2239,20201209
20201206,6호선,동묘앞,4436,4503,8939,20201209
20201206,6호선,신당,2679,3544,6223,20201209
20201206,6호선,청구,1196,1325,2521,20201209
20201206,6호선,약수,1188,1129,2317,20201209
20201206,6호선,버티고개,803,826,1629,20201209
20201206,6호선,한강진,2825,3291,6116,20201209
20201206,6호선,이태원,4850,4634,9484,20201209
20201206,6호선,녹사평(용산구청),2215,2123,4338,20201209
20201206,6호선,삼각지,1934,1564,3498,20201209
20201206,6호선,효창공원앞,2475,2148,4623,20201209
20201206,6호선,공덕,4871,4627,9498,20201209
20201206,6호선,대흥(서강대앞),3647,3730,7377,20201209
20201206,6호선,광흥창(서강),2993,2896,5889,20201209
20201206,6호선,상수,3519,3913,7432,20201209
20201206,6호선,합정,5549,5187,10736,20201209
20201206,6호선,망원,5908,6284,12192,20201209
20201206,6호선,마포구청,5089,4776,9865,20201209
20201206,6호선,월드컵경기장(성산),2668,2618,5286,20201209
20201206,6호선,디지털미디어시티,3850,4026,7876,20201209
20201206,9호선,가양,7305,7298,14603,20201209
20201206,9호선,증미,2159,2189,4348,20201209
20201206,6호선,증산(명지대앞),4098,4253,8351,20201209
20201206,6호선,새절(신사),4838,4678,9516,20201209
20201206,6호선,구산,2774,2119,4893,20201209
20201206,6호선,독바위,1141,1436,2577,20201209
20201206,6호선,불광,2422,2180,4602,20201209
20201206,6호선,역촌,1496,1726,3222,20201209
20201206,6호선,응암,6878,7018,13896,20201209
20201206,5호선,하남풍산,1868,2015,3883,20201209
20201206,5호선,미사,4817,4781,9598,20201209
20201206,5호선,마천,2349,2642,4991,20201209
20201206,5호선,거여,2771,2728,5499,20201209
20201206,5호선,개롱,2085,2319,4404,20201209
20201206,5호선,오금,1212,1148,2360,20201209
20201206,5호선,방이,2956,2834,5790,20201209
20201206,5호선,올림픽공원(한국체대),1442,1276,2718,20201209
20201206,5호선,둔촌동,3224,3306,6530,20201209
20201206,5호선,상일동,4609,4499,9108,20201209
20201206,5호선,고덕,2824,2892,5716,20201209
20201206,5호선,명일,3071,3169,6240,20201209
20201206,5호선,굽은다리(강동구민회관앞),3766,3597,7363,20201209
20201206,5호선,길동,2947,3065,6012,20201209
20201206,5호선,강동,7019,7021,14040,20201209
20201206,5호선,천호(풍납토성),8738,8398,17136,20201209
20201206,5호선,광나루(장신대),5289,5339,10628,20201209
20201206,5호선,아차산(어린이대공원후문),7204,7329,14533,20201209
20201206,5호선,군자(능동),4179,4672,8851,20201209
20201206,5호선,장한평,5080,5187,10267,20201209
20201206,5호선,답십리,5373,5037,10410,20201209
20201206,5호선,마장,2113,2033,4146,20201209
20201206,5호선,왕십리(성동구청),1842,1928,3770,20201209
20201206,5호선,행당,2842,2542,5384,20201209
20201206,5호선,신금호,2125,2308,4433,20201209
20201206,5호선,청구,1214,1114,2328,20201209
20201206,5호선,동대문역사문화공원(DDP),505,604,1109,20201209
20201206,5호선,을지로4가,952,994,1946,20201209
20201206,5호선,종로3가,3852,3684,7536,20201209
20201206,5호선,광화문(세종문화회관),6487,6428,12915,20201209
20201206,5호선,서대문,3557,3587,7144,20201209
20201206,5호선,충정로(경기대입구),1079,1072,2151,20201209
20201206,5호선,애오개,1884,1970,3854,20201209
20201206,5호선,공덕,3139,3247,6386,20201209
20201206,5호선,마포,3428,3444,6872,20201209
20201206,5호선,여의나루,2399,2436,4835,20201209
20201206,5호선,여의도,3906,4100,8006,20201209
20201206,5호선,신길,1249,1365,2614,20201209
20201206,5호선,영등포시장,3169,3409,6578,20201209
20201206,5호선,영등포구청,1030,1005,2035,20201209
20201206,5호선,양평,1933,2062,3995,20201209
20201206,5호선,오목교(목동운동장앞),8209,8845,17054,20201209
20201206,5호선,목동,5464,5575,11039,20201209
20201206,5호선,신정(은행정),4684,4189,8873,20201209
20201206,5호선,까치산,11353,11261,22614,20201209
20201206,5호선,화곡,10003,9593,19596,20201209
20201206,분당선,복정,3,0,3,20201209
20201206,5호선,우장산,4585,4788,9373,20201209
20201206,5호선,발산,5972,6176,12148,20201209
20201206,5호선,마곡,2180,2183,4363,20201209
20201206,5호선,송정,2603,2720,5323,20201209
20201206,9호선,등촌,3520,3527,7047,20201209
20201206,9호선,염창,5867,5993,11860,20201209
20201206,9호선,신목동,1094,1000,2094,20201209
20201206,9호선,선유도,1790,1745,3535,20201209
20201206,9호선,당산,5939,5841,11780,20201209
20201206,9호선,국회의사당,3531,3216,6747,20201209
20201206,9호선,여의도,3746,3561,7307,20201209
20201206,9호선,샛강,1236,1246,2482,20201209
20201206,9호선,노량진,10003,10775,20778,20201209
20201206,9호선,노들,1666,1584,3250,20201209
20201206,9호선,흑석(중앙대입구),2691,2841,5532,20201209
20201206,9호선,동작(현충원),724,565,1289,20201209
20201206,9호선,구반포,850,887,1737,20201209
20201206,9호선,신반포,905,991,1896,20201209
20201206,9호선,고속터미널,6120,7532,13652,20201209
20201206,9호선,사평,739,770,1509,20201209
20201206,9호선,신논현,9632,9180,18812,20201209
20201206,9호선2~3단계,언주,2755,2789,5544,20201209
20201206,9호선2~3단계,선정릉,2313,2631,4944,20201209
20201206,9호선2~3단계,삼성중앙,1406,1426,2832,20201209
20201206,9호선2~3단계,봉은사,5348,5499,10847,20201209
20201206,9호선2~3단계,종합운동장,1290,1245,2535,20201209
20201206,9호선2~3단계,삼전,2427,2466,4893,20201209
20201206,9호선2~3단계,석촌고분,2141,2163,4304,20201209
20201206,9호선2~3단계,석촌,2986,2620,5606,20201209
20201206,9호선2~3단계,송파나루,1595,1791,3386,20201209
20201206,9호선2~3단계,한성백제,921,797,1718,20201209
20201206,9호선2~3단계,올림픽공원(한국체대),1962,1919,3881,20201209
20201206,9호선2~3단계,둔촌오륜,302,338,640,20201209
20201206,9호선2~3단계,중앙보훈병원,2350,2281,4631,20201209
20201206,경강선,판교,1589,1451,3040,20201209
20201206,경강선,이매,492,328,820,20201209
20201206,경강선,삼동,689,719,1408,20201209
20201206,경강선,경기광주,2566,2517,5083,20201209
20201206,경강선,초월,1054,1145,2199,20201209
20201206,5호선,김포공항,4730,4363,9093,20201209
20201206,5호선,개화산,1889,1913,3802,20201209
20201206,5호선,방화,2559,2513,5072,20201209
20201206,4호선,쌍문,11580,10666,22246,20201209
20201206,4호선,창동,10848,11442,22290,20201209
20201206,4호선,노원,8308,8860,17168,20201209
20201206,안산선,반월,1869,1896,3765,20201209
20201206,안산선,대야미,2031,1976,4007,20201209
20201206,안산선,산본,6245,6637,12882,20201209
20201206,수인선,인천,709,988,1697,20201209
20201206,수인선,신포,848,794,1642,20201209
20201206,수인선,숭의,1583,1411,2994,20201209
20201206,수인선,인하대,2339,2256,4595,20201209
20201206,수인선,송도,1164,1130,2294,20201209
20201206,수인선,연수,2184,2129,4313,20201209
20201206,수인선,원인재,2110,2129,4239,20201209
20201206,수인선,남동인더스파크,532,512,1044,20201209
20201206,수인선,호구포,1436,1544,2980,20201209
20201206,수인선,인천논현,2209,2313,4522,20201209
20201206,수인선,소래포구,2976,2877,5853,20201209
20201206,수인선,월곶,1140,1123,2263,20201209
20201206,수인선,달월,34,39,73,20201209
20201206,수인선,사리,1605,1411,3016,20201209
20201206,수인선,야목,110,100,210,20201209
20201206,수인선,어천,293,343,636,20201209
20201206,수인선,오목천,851,905,1756,20201209
20201206,수인선,고색,1070,1087,2157,20201209
20201206,분당선,매교,1045,1078,2123,20201209
20201206,분당선,수원시청,5132,5054,10186,20201209
20201206,분당선,매탄권선,1688,1662,3350,20201209
20201206,분당선,망포,4314,4613,8927,20201209
20201206,분당선,영통,3586,3429,7015,20201209
20201206,분당선,청명,1390,1506,2896,20201209
20201206,분당선,상갈,2069,2109,4178,20201209
20201206,분당선,기흥,3526,3528,7054,20201209
20201206,분당선,신갈,1317,1358,2675,20201209
20201206,분당선,구성,1593,1830,3423,20201209
20201206,분당선,죽전,6364,6732,13096,20201209
20201206,분당선,보정,714,679,1393,20201209
20201206,분당선,이매,2031,2193,4224,20201209
20201206,분당선,오리,4236,3743,7979,20201209
20201206,분당선,미금,5254,5531,10785,20201209
20201206,분당선,정자,5149,5410,10559,20201209
20201206,분당선,수내,4760,4508,9268,20201209
20201206,분당선,서현,9082,9247,18329,20201209
20201206,분당선,야탑,9274,9628,18902,20201209
20201206,분당선,모란,8312,8431,16743,20201209
20201206,분당선,태평,6095,5795,11890,20201209
20201206,분당선,가천대,2626,3323,5949,20201209
20201206,분당선,선정릉,1721,1805,3526,20201209
20201206,분당선,강남구청,2249,2733,4982,20201209
20201206,분당선,압구정로데오,6280,6747,13027,20201209
20201206,분당선,서울숲,2741,2760,5501,20201209
20201206,분당선,수원,4119,3309,7428,20201209
20201206,분당선,수서,6093,5598,11691,20201209
20201206,분당선,대모산입구,1099,1097,2196,20201209
20201206,분당선,개포동,1354,1376,2730,20201209
20201206,분당선,구룡,487,579,1066,20201209
20201206,분당선,도곡,1925,1900,3825,20201209
20201206,분당선,한티,5726,5844,11570,20201209
20201206,분당선,선릉,2358,3435,5793,20201209
20201206,과천선,범계,9939,9570,19509,20201209
20201206,과천선,평촌,4656,4471,9127,20201209
20201206,과천선,인덕원,7844,7890,15734,20201209
20201206,과천선,정부과천청사,2663,2715,5378,20201209
20201206,과천선,과천,1970,1804,3774,20201209
20201206,과천선,대공원,1898,2019,3917,20201209
20201206,과천선,경마공원,755,689,1444,20201209
20201206,과천선,선바위,2500,2433,4933,20201209
20201206,공항철도 1호선,영종,1482,1399,2881,20201209
20201206,공항철도 1호선,인천공항2터미널,1384,1241,2625,20201209
20201206,공항철도 1호선,인천공항1터미널,2527,2548,5075,20201209
20201206,공항철도 1호선,공항화물청사,892,990,1882,20201209
20201206,공항철도 1호선,운서,3502,3796,7298,20201209
20201206,공항철도 1호선,청라국제도시,1935,1850,3785,20201209
20201206,공항철도 1호선,검암,2703,2741,5444,20201209
20201206,공항철도 1호선,계양,3430,3308,6738,20201209
20201206,공항철도 1호선,김포공항,7754,3935,11689,20201209
20201206,공항철도 1호선,마곡나루(서울식물원),1221,1377,2598,20201209
20201206,공항철도 1호선,디지털미디어시티,2634,2622,5256,20201209
20201206,공항철도 1호선,홍대입구,4695,4177,8872,20201209
20201206,공항철도 1호선,공덕,842,1196,2038,20201209
20201206,공항철도 1호선,서울역,4502,3590,8092,20201209
20201206,경춘선,춘천,736,758,1494,20201209
20201206,경춘선,남춘천,1244,1439,2683,20201209
20201206,경춘선,김유정,198,205,403,20201209
20201206,경춘선,강촌,358,288,646,20201209
20201206,경춘선,백양리,189,105,294,20201209
20201206,경춘선,굴봉산,99,111,210,20201209
20201206,경춘선,가평,878,749,1627,20201209
20201206,경춘선,상천,226,197,423,20201209
20201206,경춘선,청평,971,772,1743,20201209
20201206,경춘선,대성리,360,271,631,20201209
20201206,경춘선,마석,1669,1639,3308,20201209
20201206,경춘선,천마산,762,710,1472,20201209
20201206,경춘선,평내호평,2176,2184,4360,20201209
20201206,경춘선,금곡,639,545,1184,20201209
20201206,경춘선,사릉,1289,1253,2542,20201209
20201206,경춘선,퇴계원,1389,1280,2669,20201209
20201206,경춘선,별내,1142,1097,2239,20201209
20201206,경춘선,갈매,1073,926,1999,20201209
20201206,경춘선,신내,544,567,1111,20201209
20201206,경인선,도화,1738,1630,3368,20201209
20201206,경인선,중동,3573,3319,6892,20201209
20201206,경인선,온수(성공회대입구),2779,2676,5455,20201209
20201206,경인선,도원,1416,1378,2794,20201209
20201206,경인선,간석,2361,2259,4620,20201209
20201206,경인선,부개,3419,3233,6652,20201209
20201206,경인선,소사,4624,4295,8919,20201209
20201206,경인선,구일,2296,2281,4577,20201209
20201206,경인선,인천,2164,1829,3993,20201209
20201206,경인선,동인천,6713,6371,13084,20201209
20201206,경인선,제물포,3999,3804,7803,20201209
20201206,경인선,주안,8468,7790,16258,20201209
20201206,경인선,동암,7280,7149,14429,20201209
20201206,경인선,백운,3029,3022,6051,20201209
20201206,경인선,부평,15279,15677,30956,20201209
20201206,경인선,송내,9710,9396,19106,20201209
20201206,경인선,부천,16620,16192,32812,20201209
20201206,경인선,역곡,10511,10456,20967,20201209
20201206,경인선,오류동,5182,4791,9973,20201209
20201206,경인선,개봉,8497,8478,16975,20201209
20201206,경의선,서울역,29,18,47,20201209
20201206,경의선,임진강,30,15,45,20201209
20201206,경의선,문산,2306,2288,4594,20201209
20201206,경의선,파주,468,428,896,20201209
20201206,경의선,월롱,549,998,1547,20201209
20201206,경의선,금촌,2936,3187,6123,20201209
20201206,경의선,금릉,1871,1764,3635,20201209
20201206,경의선,운정,2315,2177,4492,20201209
20201206,경의선,야당,2527,2409,4936,20201209
20201206,경의선,탄현,2910,2712,5622,20201209
20201206,경의선,일산,3145,2982,6127,20201209
20201206,경의선,풍산,2240,2127,4367,20201209
20201206,경의선,백마,2281,2149,4430,20201209
20201206,경의선,곡산,217,208,425,20201209
20201206,경의선,능곡,1603,1509,3112,20201209
20201206,경의선,행신,2912,2757,5669,20201209
20201206,경의선,강매,973,953,1926,20201209
20201206,경의선,화전,547,569,1116,20201209
20201206,경의선,수색,672,723,1395,20201209
20201206,경의선,디지털미디어시티,965,874,1839,20201209
20201206,경강선,세종대왕릉,161,165,326,20201209
20201206,3호선,대치,3993,3763,7756,20201209
20201206,3호선,도곡,1513,1619,3132,20201209
20201206,3호선,매봉,2966,2950,5916,20201209
20201206,3호선,양재(서초구청),10200,11833,22033,20201209
20201206,3호선,남부터미널(예술의전당),9219,9767,18986,20201209
20201206,3호선,교대(법원.검찰청),2790,1808,4598,20201209
20201206,3호선,고속터미널,25639,24154,49793,20201209
20201206,3호선,잠원,1527,1607,3134,20201209
20201206,3호선,신사,8807,8994,17801,20201209
20201206,3호선,압구정,9723,10092,19815,20201209
20201206,3호선,옥수,3449,3774,7223,20201209
20201206,3호선,금호,3165,3086,6251,20201209
20201206,3호선,약수,4669,4515,9184,20201209
20201206,3호선,동대입구,9167,8758,17925,20201209
20201206,3호선,을지로3가,1763,1749,3512,20201209
20201206,3호선,종로3가,1976,2644,4620,20201209
20201206,3호선,안국,5194,5529,10723,20201209
20201206,3호선,경복궁(정부서울청사),5934,6197,12131,20201209
20201206,3호선,독립문,2759,3102,5861,20201209
20201206,3호선,무악재,1367,1435,2802,20201209
20201206,3호선,홍제,6608,6446,13054,20201209
20201206,3호선,녹번,4940,4500,9440,20201209
20201206,3호선,불광,7301,8364,15665,20201209
20201206,3호선,연신내,16252,15234,31486,20201209
20201206,3호선,구파발,7954,8196,16150,20201209
20201206,3호선,지축,1228,1187,2415,20201209
20201206,2호선,용두(동대문구청),832,861,1693,20201209
20201206,2호선,신정네거리,3513,3609,7122,20201209
20201206,2호선,양천구청,2309,2410,4719,20201209
20201206,2호선,도림천,329,339,668,20201209
20201206,2호선,신설동,2183,2196,4379,20201209
20201206,2호선,신답,495,540,1035,20201209
20201206,2호선,용답,1311,1297,2608,20201209
20201206,경강선,여주,1224,1132,2356,20201209
20201206,2호선,충정로(경기대입구),2781,2994,5775,20201209
20201206,2호선,아현,3800,3781,7581,20201209
20201206,2호선,이대,4497,4827,9324,20201209
20201206,2호선,신촌,15536,14938,30474,20201209
20201206,2호선,홍대입구,23681,23402,47083,20201209
20201206,2호선,합정,12012,12420,24432,20201209
20201206,2호선,당산,6299,6702,13001,20201209
20201206,2호선,영등포구청,6246,6475,12721,20201209
20201206,2호선,문래,5396,5625,11021,20201209
20201206,2호선,신도림,20397,20258,40655,20201209
20201206,2호선,대림(구로구청),11583,11646,23229,20201209
20201206,2호선,구로디지털단지,17823,17403,35226,20201209
20201206,2호선,신대방,11390,11267,22657,20201209
20201206,2호선,신림,27094,27147,54241,20201209
20201206,2호선,봉천,9412,9216,18628,20201209
20201206,2호선,서울대입구(관악구청),18800,19552,38352,20201209
20201206,2호선,낙성대(강감찬),11077,11674,22751,20201209
20201206,2호선,사당,14263,15700,29963,20201209
20201206,2호선,방배,4696,5060,9756,20201209
20201206,2호선,서초,7264,6931,14195,20201209
20201206,2호선,교대(법원.검찰청),7328,8237,15565,20201209
20201206,2호선,강남,22274,21421,43695,20201209
20201206,2호선,역삼,8514,9257,17771,20201209
20201206,2호선,선릉,10239,8907,19146,20201209
20201206,2호선,삼성(무역센터),15243,15163,30406,20201209
20201206,2호선,종합운동장,2551,2747,5298,20201209
20201206,2호선,잠실새내,6930,7292,14222,20201209
20201206,2호선,잠실(송파구청),27254,26004,53258,20201209
20201206,2호선,잠실나루,3615,3696,7311,20201209
20201206,2호선,강변(동서울터미널),14426,14519,28945,20201209
20201206,2호선,구의(광진구청),8389,8473,16862,20201209
20201206,2호선,건대입구,15382,16067,31449,20201209
20201206,2호선,성수,6717,7381,14098,20201209
20201206,2호선,뚝섬,5146,5310,10456,20201209
20201206,2호선,한양대,8166,7913,16079,20201209
20201206,2호선,왕십리(성동구청),6832,5662,12494,20201209
20201206,2호선,상왕십리,5033,4947,9980,20201209
20201206,2호선,신당,6015,6419,12434,20201209
20201206,2호선,동대문역사문화공원(DDP),5151,6298,11449,20201209
20201206,2호선,을지로4가,2349,2177,4526,20201209
20201206,2호선,을지로3가,4355,4062,8417,20201209
20201206,2호선,을지로입구,11229,10664,21893,20201209
20201206,2호선,시청,3570,3005,6575,20201209
20201206,1호선,청량리(서울시립대입구),9709,9751,19460,20201209
20201206,1호선,제기동,7154,7580,14734,20201209
20201206,1호선,신설동,5621,5552,11173,20201209
20201206,1호선,동대문,6666,7361,14027,20201209
20201206,1호선,종로5가,5214,5279,10493,20201209
20201206,1호선,종로3가,8991,8025,17016,20201209
20201206,1호선,종각,7680,7276,14956,20201209
20201206,1호선,시청,4707,4494,9201,20201209
20201206,1호선,동묘앞,9612,9505,19117,20201209
20201206,1호선,서울역,16959,14823,31782,20201209
20201206,경부선,서울역,3958,803,4761,20201209
20201206,경의선,가좌,1931,1901,3832,20201209
20201206,경의선,홍대입구,902,971,1873,20201209
20201206,경의선,서강대,1508,1439,2947,20201209
20201206,경의선,공덕,1388,1035,2423,20201209
20201206,경의선,효창공원앞,893,1059,1952,20201209
20201206,경의선,신촌,177,194,371,20201209
20201206,경의선,서울역,588,622,1210,20201209
20201206,경원선,소요산,2838,2347,5185,20201209
20201206,경원선,동두천,980,1220,2200,20201209
20201206,경원선,보산,1209,1176,2385,20201209
20201206,경원선,동두천중앙,1550,1503,3053,20201209
20201206,경원선,지행,3148,3139,6287,20201209
20201206,경원선,덕정,2339,2434,4773,20201209
20201206,경원선,덕계,1056,977,2033,20201209
20201206,경원선,양주,3603,3552,7155,20201209
20201206,경원선,녹양,2079,1991,4070,20201209
20201206,경원선,가능,3171,2959,6130,20201209
20201206,경원선,의정부,9591,9695,19286,20201209
20201206,경원선,회룡,5354,5282,10636,20201209
20201206,경원선,망월사,3305,3491,6796,20201209
20201206,경원선,도봉산,6674,4660,11334,20201209
20201206,경원선,도봉,2763,2461,5224,20201209
20201206,경원선,방학,4518,4362,8880,20201209
20201206,경원선,녹천,1919,1640,3559,20201209
20201206,경원선,월계,3022,2902,5924,20201209
20201206,경원선,광운대,3112,3255,6367,20201209
20201206,경원선,석계,3623,4011,7634,20201209
20201206,경원선,신이문,3627,3360,6987,20201209
20201206,경원선,외대앞,3401,3391,6792,20201209
20201206,경원선,청량리(서울시립대입구),8542,8245,16787,20201209
20201206,경원선,왕십리(성동구청),6481,7369,13850,20201209
20201206,경원선,응봉,727,672,1399,20201209
20201206,경원선,옥수,38,15,53,20201209
20201206,경원선,한남,1519,1501,3020,20201209
20201206,경원선,서빙고,879,891,1770,20201209
20201206,경원선,이촌(국립중앙박물관),1607,1262,2869,20201209
20201206,경부선,광명,1622,1064,2686,20201209
20201206,경부선,서동탄,536,518,1054,20201209
20201206,경부선,당정,2222,2292,4514,20201209
20201206,경부선,천안,3922,4079,8001,20201209
20201206,경부선,두정,2541,3097,5638,20201209
20201206,경부선,직산,372,431,803,20201209
20201206,경부선,성환,1783,2218,4001,20201209
20201206,경부선,평택,8109,8763,16872,20201209
20201206,경부선,지제,1548,1442,2990,20201209
20201206,경부선,서정리,2887,4339,7226,20201209
20201206,경부선,송탄,2697,3007,5704,20201209
20201206,경부선,진위,522,560,1082,20201209
20201206,경부선,오산,5348,5831,11179,20201209
20201206,경부선,오산대,1422,1245,2667,20201209
20201206,경부선,세마,1164,1113,2277,20201209
20201206,경부선,병점,6235,6626,12861,20201209
20201206,경부선,세류,1549,1478,3027,20201209
20201206,경부선,독산,4183,4385,8568,20201209
20201206,경부선,수원,22428,21907,44335,20201209
20201206,경부선,화서,2699,2637,5336,20201209
20201206,경부선,성균관대,5235,5630,10865,20201209
20201206,경부선,의왕,3197,3282,6479,20201209
20201206,경부선,군포,2548,2391,4939,20201209
20201206,경부선,금정,10028,10454,20482,20201209
20201206,경부선,명학,2851,2782,5633,20201209
20201206,경부선,안양,9796,9441,19237,20201209
20201206,경부선,남영,2930,3264,6194,20201209
20201206,경부선,관악,3658,3385,7043,20201209
20201206,경부선,석수,3886,3759,7645,20201209
20201206,경부선,금천구청,4518,4473,8991,20201209
20201206,경부선,가산디지털단지,3489,4698,8187,20201209
20201206,경부선,구로,7521,7638,15159,20201209
20201206,경부선,신길,3611,3184,6795,20201209
20201206,경부선,신도림,1576,1604,3180,20201209
20201206,경부선,영등포,22009,20644,42653,20201209
20201206,경부선,대방,4240,4652,8892,20201209
20201206,중앙선,지평,19,16,35,20201209
20201206,중앙선,용문,1164,967,2131,20201209
20201206,경부선,노량진,4275,4361,8636,20201209
20201206,경부선,용산,17866,15574,33440,20201209
20201206,중앙선,원덕,209,156,365,20201209
20201206,중앙선,양평,1274,1186,2460,20201209
20201206,중앙선,오빈,134,121,255,20201209
20201206,중앙선,아신,333,326,659,20201209
20201206,중앙선,국수,394,370,764,20201209
20201206,중앙선,신원,160,101,261,20201209
20201206,중앙선,양수,1055,1001,2056,20201209
20201206,중앙선,운길산,723,672,1395,20201209
20201206,중앙선,팔당,855,858,1713,20201209
20201206,중앙선,도심,865,790,1655,20201209
20201206,중앙선,덕소,2406,2366,4772,20201209
20201206,중앙선,양정,353,269,622,20201209
20201206,중앙선,도농,3410,3474,6884,20201209
20201206,중앙선,구리,5166,5501,10667,20201209
20201206,중앙선,양원,564,565,1129,20201209
20201206,중앙선,망우,3323,3277,6600,20201209
20201206,중앙선,상봉(시외버스터미널),2882,2671,5553,20201209
20201206,중앙선,중랑,2476,2401,4877,20201209
20201206,중앙선,회기,12495,12175,24670,20201209
20201206,장항선,신창(순천향대),718,1000,1718,20201209
20201206,장항선,온양온천,2425,2406,4831,20201209
20201206,장항선,배방,574,690,1264,20201209
20201206,장항선,아산,1933,1479,3412,20201209
20201206,장항선,쌍용(나사렛대),812,863,1675,20201209
20201206,장항선,봉명,423,420,843,20201209
20201206,경강선,곤지암,1002,1188,2190,20201209
20201206,경강선,신둔도예촌,594,567,1161,20201209
20201206,경강선,이천,1269,1536,2805,20201209
20201206,경강선,부발,826,1427,2253,20201209
20201206,4호선,상계,7870,7516,15386,20201209
20201206,4호선,당고개,5600,5505,11105,20201209
20201206,4호선,남태령,373,339,712,20201209
20201206,4호선,사당,9532,9261,18793,20201209
20201206,4호선,총신대입구(이수),7142,7783,14925,20201209
20201206,4호선,동작(현충원),1113,1147,2260,20201209
20201206,4호선,이촌(국립중앙박물관),2686,3017,5703,20201209
20201206,4호선,신용산,4547,4745,9292,20201209
20201206,4호선,삼각지,1308,1571,2879,20201209
20201206,4호선,숙대입구(갈월),5249,4816,10065,20201209
20201206,4호선,서울역,2911,5947,8858,20201209
20201206,4호선,회현(남대문시장),5968,6096,12064,20201209
20201206,4호선,명동,6665,6950,13615,20201209
20201206,4호선,충무로,7295,6993,14288,20201209
20201206,4호선,동대문역사문화공원(DDP),6301,5896,12197,20201209
20201206,4호선,동대문,4595,5345,9940,20201209
20201206,4호선,혜화,15396,14769,30165,20201209
20201206,4호선,한성대입구(삼선교),5621,5490,11111,20201209
20201206,4호선,성신여대입구(돈암),8843,8547,17390,20201209
20201206,4호선,길음,7333,7202,14535,20201209
20201206,4호선,미아사거리,12074,11740,23814,20201209
20201206,4호선,미아(서울사이버대학),6042,5823,11865,20201209
20201206,4호선,수유(강북구청),14748,13995,28743,20201209
20201206,3호선,오금,2028,1984,4012,20201209
20201206,3호선,경찰병원,1977,2033,4010,20201209
20201206,3호선,가락시장,2805,3106,5911,20201209
20201206,3호선,수서,7294,6754,14048,20201209
20201206,3호선,일원,2441,2651,5092,20201209
20201206,3호선,대청,2982,2878,5860,20201209
20201206,3호선,학여울,572,558,1130,20201209
20201206,일산선,대화,4692,4266,8958,20201209
20201206,일산선,주엽,3123,3052,6175,20201209
20201207,2호선,강남,69232,67727,136959,20201210
20201207,6호선,창신,3174,2607,5781,20201210
20201207,6호선,동묘앞,6813,7138,13951,20201210
20201207,6호선,신당,6686,7115,13801,20201210
20201207,6호선,청구,3372,3676,7048,20201210
20201207,6호선,약수,3147,3128,6275,20201210
20201207,6호선,버티고개,1961,1948,3909,20201210
20201207,6호선,한강진,5325,6032,11357,20201210
20201207,6호선,이태원,6884,6880,13764,20201210
20201207,6호선,녹사평(용산구청),3594,3411,7005,20201210
20201207,6호선,삼각지,4471,4048,8519,20201210
20201207,6호선,효창공원앞,6169,5680,11849,20201210
20201207,6호선,공덕,16137,15654,31791,20201210
20201207,6호선,대흥(서강대앞),6798,6949,13747,20201210
20201207,6호선,광흥창(서강),7768,7628,15396,20201210
20201207,6호선,상수,5859,6298,12157,20201210
20201207,6호선,합정,9767,9559,19326,20201210
20201207,6호선,망원,11305,12161,23466,20201210
20201207,6호선,마포구청,12320,11270,23590,20201210
20201207,6호선,월드컵경기장(성산),3630,3827,7457,20201210
20201207,6호선,디지털미디어시티,12594,13680,26274,20201210
20201207,중앙선,지평,50,34,84,20201210
20201207,중앙선,용문,1214,1173,2387,20201210
20201207,중앙선,원덕,247,229,476,20201210
20201207,중앙선,양평,1898,1765,3663,20201210
20201207,중앙선,오빈,210,227,437,20201210
20201207,중앙선,아신,405,385,790,20201210
20201207,중앙선,국수,521,510,1031,20201210
20201207,중앙선,신원,156,134,290,20201210
20201207,중앙선,양수,1370,1346,2716,20201210
20201207,중앙선,운길산,476,460,936,20201210
20201207,중앙선,팔당,648,637,1285,20201210
20201207,중앙선,도심,2204,1648,3852,20201210
20201207,중앙선,덕소,4950,4852,9802,20201210
20201207,중앙선,양정,689,631,1320,20201210
20201207,중앙선,도농,8984,8123,17107,20201210
20201207,중앙선,구리,11814,11891,23705,20201210
20201207,중앙선,양원,1349,1368,2717,20201210
20201207,중앙선,망우,6521,6449,12970,20201210
20201207,중앙선,상봉(시외버스터미널),5010,4974,9984,20201210
20201207,중앙선,중랑,4862,4759,9621,20201210
20201207,중앙선,회기,22398,21175,43573,20201210
20201207,장항선,신창(순천향대),1011,963,1974,20201210
20201207,장항선,온양온천,2832,2843,5675,20201210
20201207,장항선,배방,789,774,1563,20201210
20201207,장항선,아산,2220,1981,4201,20201210
20201207,장항선,쌍용(나사렛대),1577,1554,3131,20201210
20201207,장항선,봉명,1107,1087,2194,20201210
20201207,일산선,대화,11921,9338,21259,20201210
20201207,일산선,주엽,7753,7815,15568,20201210
20201207,일산선,정발산,5900,5622,11522,20201210
20201207,일산선,마두,6576,6858,13434,20201210
20201207,일산선,백석,8859,8896,17755,20201210
20201207,일산선,대곡,1596,1199,2795,20201210
20201207,일산선,화정,14506,15022,29528,20201210
20201207,일산선,원당,9851,9571,19422,20201210
20201207,일산선,삼송,16046,15769,31815,20201210
20201207,일산선,원흥,8106,7795,15901,20201210
20201207,우이신설선,신설동,1999,1935,3934,20201210
20201207,우이신설선,보문,1322,1355,2677,20201210
20201207,우이신설선,성신여대입구(돈암),2528,2717,5245,20201210
20201207,우이신설선,정릉,3815,3745,7560,20201210
20201207,우이신설선,북한산보국문,4928,4925,9853,20201210
20201207,우이신설선,솔샘,5128,4903,10031,20201210
20201207,우이신설선,삼양사거리,2160,2216,4376,20201210
20201207,우이신설선,삼양,1821,1988,3809,20201210
20201207,우이신설선,화계,2982,2839,5821,20201210
20201207,우이신설선,가오리,3548,3585,7133,20201210
20201207,우이신설선,4.19민주묘지,2373,2422,4795,20201210
20201207,우이신설선,솔밭공원,2109,2115,4224,20201210
20201207,우이신설선,북한산우이,2059,1788,3847,20201210
20201207,안산선,수리산,3829,3205,7034,20201210
20201207,안산선,오이도,7355,6981,14336,20201210
20201207,안산선,정왕,7661,8390,16051,20201210
20201207,안산선,신길온천,1520,1369,2889,20201210
20201207,안산선,안산,11007,9878,20885,20201210
20201207,안산선,초지,4045,4125,8170,20201210
20201207,안산선,고잔,7629,7299,14928,20201210
20201207,안산선,중앙,14168,14413,28581,20201210
20201207,안산선,한대앞,7366,7420,14786,20201210
20201207,안산선,상록수,14679,14784,29463,20201210
20201207,안산선,반월,3898,3745,7643,20201210
20201207,안산선,대야미,4286,3968,8254,20201210
20201207,안산선,산본,13824,14745,28569,20201210
20201207,수인선,인천,810,1282,2092,20201210
20201207,수인선,신포,1394,1410,2804,20201210
20201207,수인선,숭의,3395,3186,6581,20201210
20201207,수인선,인하대,5075,4835,9910,20201210
20201207,수인선,송도,2269,2028,4297,20201210
20201207,수인선,연수,3899,3754,7653,20201210
20201207,수인선,원인재,3772,3937,7709,20201210
20201207,수인선,남동인더스파크,2225,2520,4745,20201210
20201207,수인선,호구포,3333,3460,6793,20201210
20201207,수인선,인천논현,4807,4991,9798,20201210
20201207,수인선,소래포구,3881,3602,7483,20201210
20201207,수인선,월곶,2170,1984,4154,20201210
20201207,수인선,달월,67,39,106,20201210
20201207,수인선,사리,2945,2833,5778,20201210
20201207,수인선,야목,171,137,308,20201210
20201207,수인선,어천,485,495,980,20201210
20201207,수인선,오목천,2199,2125,4324,20201210
20201207,수인선,고색,2757,2733,5490,20201210
20201207,분당선,매교,2482,2558,5040,20201210
20201207,분당선,수원시청,10270,10802,21072,20201210
20201207,분당선,매탄권선,3937,3890,7827,20201210
20201207,분당선,망포,11841,11578,23419,20201210
20201207,분당선,영통,6638,6882,13520,20201210
20201207,분당선,청명,3728,3526,7254,20201210
20201207,분당선,상갈,4551,4472,9023,20201210
20201207,분당선,기흥,7933,7625,15558,20201210
20201207,분당선,신갈,4011,3999,8010,20201210
20201207,분당선,구성,4191,4468,8659,20201210
20201207,분당선,죽전,11140,12062,23202,20201210
20201207,분당선,보정,2099,1816,3915,20201210
20201207,분당선,이매,4738,4448,9186,20201210
20201207,분당선,오리,10403,8878,19281,20201210
20201207,분당선,미금,13327,14124,27451,20201210
20201207,분당선,정자,13588,14472,28060,20201210
20201207,분당선,수내,11207,11221,22428,20201210
20201207,분당선,서현,20323,20730,41053,20201210
20201207,분당선,야탑,22175,23092,45267,20201210
20201207,분당선,모란,17243,17309,34552,20201210
20201207,분당선,태평,11850,11685,23535,20201210
20201207,분당선,가천대,8072,9102,17174,20201210
20201207,1호선,동대문,9582,9204,18786,20201210
20201207,5호선,양평,6813,6892,13705,20201210
20201207,7호선,도봉산,8157,9495,17652,20201210
20201207,6호선,보문,6310,5968,12278,20201210
20201207,6호선,안암(고대병원앞),7980,8044,16024,20201210
20201207,6호선,고려대(종암),6508,6513,13021,20201210
20201207,6호선,월곡(동덕여대),9959,9862,19821,20201210
20201207,6호선,상월곡(한국과학기술연구원),5691,5109,10800,20201210
20201207,6호선,돌곶이,7569,7121,14690,20201210
20201207,6호선,석계,11077,11507,22584,20201210
20201207,6호선,태릉입구,4658,5076,9734,20201210
20201207,6호선,화랑대(서울여대입구),10122,7952,18074,20201210
20201207,6호선,봉화산(서울의료원),8104,7482,15586,20201210
20201207,7호선,장암,2126,743,2869,20201210
20201207,7호선,수락산,11162,11287,22449,20201210
20201207,7호선,마들,10966,10588,21554,20201210
20201207,7호선,노원,16484,17128,33612,20201210
20201207,7호선,중계,12920,12111,25031,20201210
20201207,7호선,하계,15377,14744,30121,20201210
20201207,7호선,공릉(서울과학기술대),11777,11382,23159,20201210
20201207,7호선,태릉입구,7104,6652,13756,20201210
20201207,7호선,먹골,8969,8784,17753,20201210
20201207,7호선,중화,10041,9896,19937,20201210
20201207,7호선,상봉(시외버스터미널),14939,14072,29011,20201210
20201207,7호선,면목,13887,13714,27601,20201210
20201207,7호선,사가정,14776,15049,29825,20201210
20201207,7호선,용마산(용마폭포공원),5320,5080,10400,20201210
20201207,7호선,군자(능동),12906,10476,23382,20201210
20201207,7호선,어린이대공원(세종대),9967,9744,19711,20201210
20201207,7호선,건대입구,9762,9967,19729,20201210
20201207,7호선,뚝섬유원지,6052,6034,12086,20201210
20201207,7호선,청담,17758,19543,37301,20201210
20201207,7호선,강남구청,14055,15234,29289,20201210
20201207,7호선,학동,22621,23700,46321,20201210
20201207,7호선,논현,18449,19916,38365,20201210
20201207,7호선,반포,5059,4985,10044,20201210
20201207,7호선,고속터미널,13153,11360,24513,20201210
20201207,7호선,내방,13048,13329,26377,20201210
20201207,7호선,이수,13061,12962,26023,20201210
20201207,7호선,남성,10054,9419,19473,20201210
20201207,7호선,숭실대입구(살피재),10502,10908,21410,20201210
20201207,7호선,상도,8947,8838,17785,20201210
20201207,7호선,장승배기,8801,8689,17490,20201210
20201207,7호선,신대방삼거리,14840,14528,29368,20201210
20201207,7호선,보라매,8965,9075,18040,20201210
20201207,9호선2~3단계,한성백제,1977,1785,3762,20201210
20201207,9호선2~3단계,올림픽공원(한국체대),4468,4475,8943,20201210
20201207,9호선2~3단계,둔촌오륜,891,828,1719,20201210
20201207,9호선2~3단계,중앙보훈병원,8637,7698,16335,20201210
20201207,경강선,판교,3785,3561,7346,20201210
20201207,경강선,이매,908,820,1728,20201210
20201207,경강선,삼동,2052,1928,3980,20201210
20201207,경강선,경기광주,6014,5850,11864,20201210
20201207,경강선,초월,2616,2587,5203,20201210
20201207,경강선,곤지암,1738,1767,3505,20201210
20201207,경강선,신둔도예촌,987,937,1924,20201210
20201207,경강선,이천,1892,2085,3977,20201210
20201207,경강선,부발,1394,1496,2890,20201210
20201207,경강선,세종대왕릉,219,197,416,20201210
20201207,경강선,여주,1469,1430,2899,20201210
20201207,경부선,서울역,3731,1210,4941,20201210
20201207,경부선,남영,8438,8731,17169,20201210
20201207,경부선,용산,24864,25358,50222,20201210
20201207,경부선,노량진,7139,7539,14678,20201210
20201207,경부선,대방,11697,12094,23791,20201210
20201207,경부선,영등포,29920,30882,60802,20201210
20201207,경부선,신도림,3683,3643,7326,20201210
20201207,경부선,신길,8599,7205,15804,20201210
20201207,6호선,증산(명지대앞),9103,8978,18081,20201210
20201207,6호선,새절(신사),11413,10715,22128,20201210
20201207,6호선,구산,6475,5167,11642,20201210
20201207,6호선,연신내,1,0,1,20201210
20201207,6호선,독바위,2491,2703,5194,20201210
20201207,6호선,불광,3704,3785,7489,20201210
20201207,6호선,역촌,3378,3926,7304,20201210
20201207,분당선,선정릉,7252,7677,14929,20201210
20201207,분당선,강남구청,8218,9319,17537,20201210
20201207,분당선,압구정로데오,13739,14817,28556,20201210
20201207,분당선,서울숲,7072,7047,14119,20201210
20201207,분당선,수원,6804,5483,12287,20201210
20201207,분당선,수서,11248,11529,22777,20201210
20201207,분당선,대모산입구,3194,2991,6185,20201210
20201207,분당선,개포동,3141,3214,6355,20201210
20201207,분당선,구룡,1725,1673,3398,20201210
20201207,분당선,도곡,5816,6021,11837,20201210
20201207,분당선,한티,12303,13337,25640,20201210
20201207,분당선,선릉,12839,18799,31638,20201210
20201207,과천선,범계,21662,21196,42858,20201210
20201207,과천선,평촌,16217,16144,32361,20201210
20201207,과천선,인덕원,21063,22117,43180,20201210
20201207,과천선,정부과천청사,8343,8261,16604,20201210
20201207,과천선,과천,4399,4144,8543,20201210
20201207,과천선,대공원,1309,1360,2669,20201210
20201207,과천선,경마공원,827,830,1657,20201210
20201207,과천선,선바위,7400,6522,13922,20201210
20201207,공항철도 1호선,영종,2395,2386,4781,20201210
20201207,공항철도 1호선,인천공항2터미널,1606,1492,3098,20201210
20201207,공항철도 1호선,인천공항1터미널,2699,2789,5488,20201210
20201207,공항철도 1호선,공항화물청사,2094,2339,4433,20201210
20201207,공항철도 1호선,운서,4878,4980,9858,20201210
20201207,공항철도 1호선,청라국제도시,5778,5238,11016,20201210
20201207,공항철도 1호선,검암,6151,5998,12149,20201210
20201207,공항철도 1호선,계양,8306,7753,16059,20201210
20201207,공항철도 1호선,김포공항,8604,5586,14190,20201210
20201207,공항철도 1호선,마곡나루(서울식물원),6492,6142,12634,20201210
20201207,공항철도 1호선,디지털미디어시티,12043,10752,22795,20201210
20201207,공항철도 1호선,홍대입구,5736,5960,11696,20201210
20201207,공항철도 1호선,공덕,1796,2240,4036,20201210
20201207,공항철도 1호선,서울역,5303,4905,10208,20201210
20201207,경춘선,춘천,846,827,1673,20201210
20201207,경춘선,남춘천,1971,2127,4098,20201210
20201207,경춘선,김유정,199,186,385,20201210
20201207,경춘선,강촌,269,286,555,20201210
20201207,경춘선,백양리,117,85,202,20201210
20201207,경춘선,굴봉산,68,77,145,20201210
20201207,경춘선,가평,1097,1011,2108,20201210
20201207,경춘선,상천,187,192,379,20201210
20201207,경춘선,청평,1173,1106,2279,20201210
20201207,경춘선,대성리,390,324,714,20201210
20201207,경춘선,마석,3311,3239,6550,20201210
20201207,경춘선,천마산,1440,1309,2749,20201210
20201207,경춘선,평내호평,5168,5089,10257,20201210
20201207,경춘선,금곡,1333,1280,2613,20201210
20201207,경춘선,사릉,3127,2935,6062,20201210
20201207,경춘선,퇴계원,3279,3002,6281,20201210
20201207,경춘선,별내,2390,2337,4727,20201210
20201207,경춘선,갈매,2696,2334,5030,20201210
20201207,경춘선,신내,1388,1374,2762,20201210
20201207,경인선,도화,3538,3215,6753,20201210
20201207,경인선,중동,8348,7902,16250,20201210
20201207,경인선,온수(성공회대입구),5706,5653,11359,20201210
20201207,경인선,도원,2777,2863,5640,20201210
20201207,경인선,간석,5181,4969,10150,20201210
20201207,경인선,부개,7620,7159,14779,20201210
20201207,경인선,소사,8437,8151,16588,20201210
20201207,경인선,구일,5364,5632,10996,20201210
20201207,경인선,인천,2611,1858,4469,20201210
20201207,경인선,동인천,11856,11296,23152,20201210
20201207,경인선,제물포,9713,9194,18907,20201210
20201207,경인선,주안,16647,15248,31895,20201210
20201207,경인선,동암,13791,13707,27498,20201210
20201207,경인선,백운,6470,6535,13005,20201210
20201207,경인선,부평,24901,26204,51105,20201210
20201207,경인선,송내,24720,24863,49583,20201210
20201207,경인선,부천,28795,28771,57566,20201210
20201207,경인선,역곡,24275,24060,48335,20201210
20201207,경인선,오류동,10412,9989,20401,20201210
20201207,경인선,개봉,19002,19830,38832,20201210
20201207,경의선,임진강,6,10,16,20201210
20201207,경의선,문산,4173,4126,8299,20201210
20201207,경의선,파주,1245,1004,2249,20201210
20201207,경의선,월롱,1739,1713,3452,20201210
20201207,경의선,금촌,5412,5397,10809,20201210
20201207,경의선,금릉,3816,3683,7499,20201210
20201207,경의선,운정,5504,5187,10691,20201210
20201207,경의선,야당,5242,4925,10167,20201210
20201207,경의선,탄현,6596,6374,12970,20201210
20201207,경의선,일산,8010,7921,15931,20201210
20201207,경의선,풍산,4541,4305,8846,20201210
20201207,경의선,백마,5864,5759,11623,20201210
20201207,경의선,곡산,487,498,985,20201210
20201207,경의선,능곡,3257,2851,6108,20201210
20201207,경의선,행신,6705,6851,13556,20201210
20201207,경의선,강매,2765,2377,5142,20201210
20201207,경의선,화전,1341,1229,2570,20201210
20201207,경의선,수색,2294,2378,4672,20201210
20201207,경의선,디지털미디어시티,2036,1984,4020,20201210
20201207,경의선,가좌,4816,4359,9175,20201210
20201207,경의선,홍대입구,1165,1289,2454,20201210
20201207,경의선,서강대,1798,1668,3466,20201210
20201207,경의선,공덕,2811,2655,5466,20201210
20201207,경의선,효창공원앞,2564,2877,5441,20201210
20201207,경의선,신촌,1079,1170,2249,20201210
20201207,경의선,서울역,3727,4681,8408,20201210
20201207,경원선,소요산,2169,1881,4050,20201210
20201207,경원선,동두천,1869,2191,4060,20201210
20201207,경원선,보산,1349,1248,2597,20201210
20201207,경원선,동두천중앙,2841,2759,5600,20201210
20201207,경원선,지행,5457,5268,10725,20201210
20201207,경원선,덕정,5212,5111,10323,20201210
20201207,경원선,덕계,2464,2211,4675,20201210
20201207,경원선,양주,6531,6101,12632,20201210
20201207,경원선,녹양,4063,3856,7919,20201210
20201207,경원선,가능,5648,5544,11192,20201210
20201207,경원선,의정부,15201,15393,30594,20201210
20201207,경원선,회룡,11003,10833,21836,20201210
20201207,경원선,망월사,6178,6360,12538,20201210
20201207,경원선,도봉산,6638,4057,10695,20201210
20201207,경원선,도봉,5248,5138,10386,20201210
20201207,경원선,방학,8321,8266,16587,20201210
20201207,경원선,녹천,4185,3557,7742,20201210
20201207,경원선,월계,5626,5405,11031,20201210
20201207,경원선,광운대,7816,7480,15296,20201210
20201207,경원선,석계,7190,8298,15488,20201210
20201207,경원선,신이문,7728,7171,14899,20201210
20201207,경원선,외대앞,6037,6081,12118,20201210
20201207,경원선,청량리(서울시립대입구),11324,12273,23597,20201210
20201207,경원선,왕십리(성동구청),10933,12361,23294,20201210
20201207,경원선,응봉,1563,1363,2926,20201210
20201207,경원선,옥수,45,34,79,20201210
20201207,경원선,한남,3747,3536,7283,20201210
20201207,경원선,서빙고,1612,1456,3068,20201210
20201207,경원선,이촌(국립중앙박물관),3200,2571,5771,20201210
20201207,경부선,광명,2585,2221,4806,20201210
20201207,경부선,서동탄,1426,1106,2532,20201210
20201207,경부선,당정,5679,5359,11038,20201210
20201207,경부선,천안,3714,3910,7624,20201210
20201207,경부선,두정,4035,4317,8352,20201210
20201207,경부선,직산,616,626,1242,20201210
20201207,경부선,성환,3157,3437,6594,20201210
20201207,경부선,평택,9546,9480,19026,20201210
20201207,경부선,지제,2299,2254,4553,20201210
20201207,경부선,서정리,5637,5726,11363,20201210
20201207,경부선,송탄,3539,3354,6893,20201210
20201207,경부선,진위,1405,1234,2639,20201210
20201207,경부선,오산,7983,8264,16247,20201210
20201207,경부선,오산대,2715,2509,5224,20201210
20201207,경부선,세마,2217,1962,4179,20201210
20201207,경부선,병점,11531,11577,23108,20201210
20201207,경부선,세류,2689,2490,5179,20201210
20201207,경부선,독산,15593,16584,32177,20201210
20201207,경부선,수원,27326,28576,55902,20201210
20201207,경부선,화서,6438,6200,12638,20201210
20201207,경부선,성균관대,12342,12291,24633,20201210
20201207,경부선,의왕,8045,8036,16081,20201210
20201207,경부선,군포,7162,7344,14506,20201210
20201207,경부선,금정,23081,23968,47049,20201210
20201207,경부선,명학,8594,8557,17151,20201210
20201207,경부선,안양,21128,21178,42306,20201210
20201207,경부선,관악,6448,5979,12427,20201210
20201207,경부선,석수,9084,8043,17127,20201210
20201207,경부선,금천구청,10412,10221,20633,20201210
20201207,경부선,가산디지털단지,16336,19264,35600,20201210
20201207,경부선,구로,17218,17299,34517,20201210
20201207,경원선,창동,1,0,1,20201210
20201207,7호선,중곡,9296,8601,17897,20201210
20201207,1호선,서울역,34687,32904,67591,20201210
20201207,1호선,동묘앞,6587,6677,13264,20201210
20201207,1호선,시청,18347,18325,36672,20201210
20201207,1호선,종각,30008,28865,58873,20201210
20201207,1호선,종로3가,20106,18544,38650,20201210
20201207,1호선,종로5가,18945,18907,37852,20201210
20201207,1호선,신설동,12760,12652,25412,20201210
20201207,1호선,제기동,15154,15545,30699,20201210
20201207,1호선,청량리(서울시립대입구),17489,17469,34958,20201210
20201207,2호선,시청,20827,20108,40935,20201210
20201207,2호선,을지로입구,33608,34139,67747,20201210
20201207,2호선,을지로3가,18339,17818,36157,20201210
20201207,2호선,을지로4가,11986,11763,23749,20201210
20201207,2호선,동대문역사문화공원(DDP),9861,10898,20759,20201210
20201207,2호선,신당,11943,12291,24234,20201210
20201207,2호선,상왕십리,12310,12074,24384,20201210
20201207,2호선,왕십리(성동구청),12544,10051,22595,20201210
20201207,2호선,한양대,6477,6972,13449,20201210
20201207,2호선,뚝섬,17326,18798,36124,20201210
20201207,2호선,성수,30212,32647,62859,20201210
20201207,2호선,건대입구,25323,27101,52424,20201210
20201207,2호선,구의(광진구청),20523,20640,41163,20201210
20201207,2호선,강변(동서울터미널),25329,25207,50536,20201210
20201207,2호선,잠실나루,12547,12430,24977,20201210
20201207,2호선,잠실(송파구청),50726,51200,101926,20201210
20201207,2호선,잠실새내,17074,16890,33964,20201210
20201207,2호선,종합운동장,5738,6342,12080,20201210
20201207,2호선,삼성(무역센터),42840,42956,85796,20201210
20201207,2호선,선릉,51558,45885,97443,20201210
20201207,2호선,역삼,45685,49435,95120,20201210
20201207,2호선,교대(법원.검찰청),30063,33313,63376,20201210
20201207,2호선,서초,19214,19199,38413,20201210
20201207,2호선,방배,14482,15209,29691,20201210
20201207,2호선,사당,29155,32411,61566,20201210
20201207,2호선,낙성대(강감찬),23375,23340,46715,20201210
20201207,2호선,서울대입구(관악구청),39887,39232,79119,20201210
20201207,2호선,봉천,21726,20554,42280,20201210
20201207,2호선,신림,54996,53867,108863,20201210
20201207,2호선,신대방,23502,22952,46454,20201210
20201207,2호선,구로디지털단지,54494,55101,109595,20201210
20201207,2호선,대림(구로구청),23083,23306,46389,20201210
20201207,2호선,신도림,41445,39992,81437,20201210
20201207,2호선,문래,18690,19123,37813,20201210
20201207,2호선,영등포구청,20930,21109,42039,20201210
20201207,2호선,당산,16493,19186,35679,20201210
20201207,2호선,합정,23468,24100,47568,20201210
20201207,2호선,홍대입구,35148,35686,70834,20201210
20201207,2호선,신촌,31327,31899,63226,20201210
20201207,2호선,이대,10269,10467,20736,20201210
20201207,2호선,충정로(경기대입구),9312,9753,19065,20201210
20201207,2호선,용답,2282,2257,4539,20201210
20201207,2호선,신답,1447,1687,3134,20201210
20201207,2호선,신설동,2822,2780,5602,20201210
20201207,2호선,도림천,1182,1297,2479,20201210
20201207,2호선,양천구청,5963,6423,12386,20201210
20201207,2호선,신정네거리,8834,9233,18067,20201210
20201207,2호선,용두(동대문구청),2065,2172,4237,20201210
20201207,3호선,지축,2996,3000,5996,20201210
20201207,3호선,구파발,18038,16796,34834,20201210
20201207,3호선,연신내,33092,31322,64414,20201210
20201207,3호선,불광,14396,15333,29729,20201210
20201207,3호선,녹번,13335,12419,25754,20201210
20201207,3호선,홍제,15391,14851,30242,20201210
20201207,3호선,무악재,3419,3511,6930,20201210
20201207,3호선,독립문,6209,6384,12593,20201210
20201207,3호선,경복궁(정부서울청사),14855,14567,29422,20201210
20201207,3호선,안국,15031,15308,30339,20201210
20201207,3호선,종로3가,8273,9246,17519,20201210
20201207,3호선,을지로3가,9027,9213,18240,20201210
20201207,3호선,충무로,1,0,1,20201210
20201207,3호선,동대입구,6141,6346,12487,20201210
20201207,3호선,약수,11418,11113,22531,20201210
20201207,3호선,금호,7017,6737,13754,20201210
20201207,3호선,옥수,7601,8080,15681,20201210
20201207,3호선,압구정,26639,28245,54884,20201210
20201207,3호선,신사,24841,25918,50759,20201210
20201207,3호선,잠원,4047,4020,8067,20201210
20201207,3호선,고속터미널,30274,28783,59057,20201210
20201207,3호선,교대(법원.검찰청),12306,8385,20691,20201210
20201207,3호선,남부터미널(예술의전당),25158,25742,50900,20201210
20201207,4호선,서울역,9206,11739,20945,20201210
20201207,4호선,숙대입구(갈월),10672,10446,21118,20201210
20201207,4호선,삼각지,4013,4242,8255,20201210
20201207,4호선,신용산,12505,12909,25414,20201210
20201207,4호선,이촌(국립중앙박물관),5895,6437,12332,20201210
20201207,4호선,동작(현충원),1974,2183,4157,20201210
20201207,4호선,총신대입구(이수),16104,17516,33620,20201210
20201207,4호선,사당,20013,16424,36437,20201210
20201207,4호선,남태령,938,849,1787,20201210
20201207,4호선,당고개,11161,10108,21269,20201210
20201207,4호선,상계,17124,16208,33332,20201210
20201207,4호선,노원,16098,17730,33828,20201210
20201207,4호선,창동,22340,23736,46076,20201210
20201207,4호선,쌍문,26590,25099,51689,20201210
20201207,5호선,방화,5863,5679,11542,20201210
20201207,5호선,개화산,4527,4315,8842,20201210
20201207,5호선,김포공항,5591,5131,10722,20201210
20201207,5호선,송정,5776,5375,11151,20201210
20201207,5호선,마곡,8235,7933,16168,20201210
20201207,5호선,발산,16051,16342,32393,20201210
20201207,5호선,우장산,12047,12266,24313,20201210
20201207,5호선,화곡,25610,24096,49706,20201210
20201207,5호선,까치산,25528,24985,50513,20201210
20201207,5호선,신정(은행정),12620,10038,22658,20201210
20201207,5호선,목동,15133,16847,31980,20201210
20201207,5호선,오목교(목동운동장앞),18833,20388,39221,20201210
20201207,5호선,영등포구청,3579,3722,7301,20201210
20201207,5호선,영등포시장,8177,8399,16576,20201210
20201207,5호선,신길,3509,3927,7436,20201210
20201207,5호선,여의도,24107,24787,48894,20201210
20201207,5호선,여의나루,6121,6326,12447,20201210
20201207,5호선,마포,12595,12938,25533,20201210
20201207,5호선,공덕,12419,13170,25589,20201210
20201207,5호선,애오개,5885,5979,11864,20201210
20201207,5호선,충정로(경기대입구),4679,4665,9344,20201210
20201207,5호선,서대문,16884,17194,34078,20201210
20201207,5호선,광화문(세종문화회관),26251,26823,53074,20201210
20201207,5호선,종로3가,8295,8327,16622,20201210
20201207,5호선,을지로4가,5637,5594,11231,20201210
20201207,5호선,동대문역사문화공원(DDP),2749,3038,5787,20201210
20201207,5호선,청구,3617,3364,6981,20201210
20201207,5호선,신금호,5257,5703,10960,20201210
20201207,5호선,행당,7252,6629,13881,20201210
20201207,5호선,왕십리(성동구청),3795,4019,7814,20201210
20201207,5호선,마장,4927,4662,9589,20201210
20201207,5호선,답십리,14390,13245,27635,20201210
20201207,5호선,장한평,16369,16266,32635,20201210
20201207,5호선,군자(능동),9411,10063,19474,20201210
20201207,5호선,아차산(어린이대공원후문),12034,12024,24058,20201210
20201207,5호선,광나루(장신대),11095,10194,21289,20201210
20201207,5호선,천호(풍납토성),14601,14910,29511,20201210
20201207,5호선,강동,17378,16313,33691,20201210
20201207,5호선,길동,6899,7280,14179,20201210
20201207,5호선,굽은다리(강동구민회관앞),8246,7941,16187,20201210
20201207,5호선,명일,7488,7903,15391,20201210
20201207,5호선,고덕,7742,7742,15484,20201210
20201207,5호선,상일동,14214,13025,27239,20201210
20201207,5호선,둔촌동,7326,7316,14642,20201210
20201207,5호선,올림픽공원(한국체대),3525,2997,6522,20201210
20201207,5호선,방이,5994,6292,12286,20201210
20201207,5호선,오금,3422,3374,6796,20201210
20201207,5호선,개롱,5414,5802,11216,20201210
20201207,5호선,거여,7125,6724,13849,20201210
20201207,5호선,마천,5269,5274,10543,20201210
20201207,5호선,미사,11616,11515,23131,20201210
20201207,5호선,하남풍산,4414,4279,8693,20201210
20201207,6호선,응암,15624,15694,31318,20201210
20201207,4호선,회현(남대문시장),19856,20860,40716,20201210
20201207,4호선,명동,14751,14957,29708,20201210
20201207,4호선,충무로,23533,24401,47934,20201210
20201207,2호선,아현,8713,8524,17237,20201210
20201207,7호선,신풍,10379,10044,20423,20201210
20201207,7호선,대림(구로구청),7132,7108,14240,20201210
20201207,7호선,남구로,15439,16351,31790,20201210
20201207,7호선,가산디지털단지,43886,44040,87926,20201210
20201207,7호선,철산,19263,19528,38791,20201210
20201207,7호선,광명사거리,20491,20350,40841,20201210
20201207,7호선,천왕,9995,9494,19489,20201210
20201207,7호선,온수(성공회대입구),9849,8971,18820,20201210
20201207,7호선,까치울,6718,6555,13273,20201210
20201207,7호선,부천종합운동장,4052,3447,7499,20201210
20201207,7호선,춘의,9118,9000,18118,20201210
20201207,7호선,신중동,12695,12309,25004,20201210
20201207,7호선,부천시청,10752,10630,21382,20201210
20201207,7호선,상동,10709,11227,21936,20201210
20201207,7호선,삼산체육관,4261,3866,8127,20201210
20201207,7호선,굴포천,7804,8306,16110,20201210
20201207,7호선,부평구청,10610,8793,19403,20201210
20201207,8호선,암사,17028,15369,32397,20201210
20201207,8호선,천호(풍납토성),13357,14898,28255,20201210
20201207,8호선,강동구청,9387,10032,19419,20201210
20201207,8호선,몽촌토성(평화의문),4894,4992,9886,20201210
20201207,8호선,잠실(송파구청),11203,12624,23827,20201210
20201207,8호선,석촌,6597,7408,14005,20201210
20201207,8호선,송파,7075,7131,14206,20201210
20201207,8호선,가락시장,7018,7829,14847,20201210
20201207,8호선,문정,20195,20972,41167,20201210
20201207,8호선,장지,15055,14678,29733,20201210
20201207,8호선,복정,9355,8082,17437,20201210
20201207,8호선,산성,6149,6200,12349,20201210
20201207,8호선,남한산성입구(성남법원.검찰청),12948,12136,25084,20201210
20201207,8호선,단대오거리,9224,9021,18245,20201210
20201207,8호선,신흥,3983,4371,8354,20201210
20201207,8호선,수진,4612,4282,8894,20201210
20201207,8호선,모란,3677,2708,6385,20201210
20201207,9호선,개화,2221,1557,3778,20201210
20201207,9호선,김포공항,5872,7425,13297,20201210
20201207,9호선,공항시장,2471,2785,5256,20201210
20201207,9호선,신방화,6042,6002,12044,20201210
20201207,9호선,마곡나루(서울식물원),8961,9056,18017,20201210
20201207,9호선,양천향교,8466,8675,17141,20201210
20201207,9호선,가양,17659,17460,35119,20201210
20201207,9호선,증미,6368,6527,12895,20201210
20201207,9호선,등촌,9573,9625,19198,20201210
20201207,9호선,염창,15000,15095,30095,20201210
20201207,9호선,신목동,3346,3063,6409,20201210
20201207,9호선,선유도,6752,6541,13293,20201210
20201207,9호선,당산,15206,15156,30362,20201210
20201207,9호선,국회의사당,14572,14606,29178,20201210
20201207,9호선,여의도,20744,19941,40685,20201210
20201207,9호선,샛강,4897,5144,10041,20201210
20201207,9호선,노량진,21512,21386,42898,20201210
20201207,9호선,노들,3833,3489,7322,20201210
20201207,9호선,흑석(중앙대입구),6449,6825,13274,20201210
20201207,9호선,동작(현충원),1488,1237,2725,20201210
20201207,9호선,구반포,2245,2374,4619,20201210
20201207,9호선,신반포,2596,2575,5171,20201210
20201207,9호선,고속터미널,9062,11229,20291,20201210
20201207,9호선,사평,2605,2682,5287,20201210
20201207,9호선,신논현,25492,24828,50320,20201210
20201207,9호선2~3단계,언주,8617,8772,17389,20201210
20201207,9호선2~3단계,선정릉,8166,8809,16975,20201210
20201207,9호선2~3단계,삼성중앙,5996,6238,12234,20201210
20201207,9호선2~3단계,봉은사,12498,12508,25006,20201210
20201207,9호선2~3단계,종합운동장,3513,3416,6929,20201210
20201207,9호선2~3단계,삼전,5663,5608,11271,20201210
20201207,9호선2~3단계,석촌고분,4758,4935,9693,20201210
20201207,9호선2~3단계,석촌,6492,5842,12334,20201210
20201207,9호선2~3단계,송파나루,3601,3770,7371,20201210
20201207,4호선,동대문역사문화공원(DDP),13016,12031,25047,20201210
20201207,4호선,동대문,17817,18207,36024,20201210
20201207,4호선,혜화,23743,23487,47230,20201210
20201207,4호선,한성대입구(삼선교),11350,11286,22636,20201210
20201207,4호선,성신여대입구(돈암),16372,15758,32130,20201210
20201207,4호선,길음,17371,17360,34731,20201210
20201207,4호선,미아사거리,24456,23988,48444,20201210
20201207,4호선,미아(서울사이버대학),13314,12968,26282,20201210
20201207,4호선,수유(강북구청),30018,29989,60007,20201210
20201207,3호선,오금,5679,4979,10658,20201210
20201207,3호선,경찰병원,7002,7072,14074,20201210
20201207,3호선,가락시장,7882,7710,15592,20201210
20201207,3호선,수서,14156,14322,28478,20201210
20201207,3호선,일원,8477,8395,16872,20201210
20201207,3호선,대청,8706,8021,16727,20201210
20201207,3호선,학여울,1555,1602,3157,20201210
20201207,3호선,대치,9567,9600,19167,20201210
20201207,3호선,도곡,4775,4724,9499,20201210
20201207,3호선,매봉,11089,10483,21572,20201210
20201207,3호선,양재(서초구청),33610,36795,70405,20201210
20201208,2호선,신당,11547,11767,23314,20201211
20201208,2호선,상왕십리,11644,11575,23219,20201211
20201208,2호선,왕십리(성동구청),12161,9701,21862,20201211
20201208,2호선,한양대,6056,6228,12284,20201211
20201208,2호선,뚝섬,17240,18566,35806,20201211
20201208,2호선,성수,29446,32067,61513,20201211
20201208,2호선,건대입구,24652,26557,51209,20201211
20201208,2호선,구의(광진구청),20123,19918,40041,20201211
20201208,2호선,강변(동서울터미널),22931,22801,45732,20201211
20201208,2호선,잠실나루,12180,11795,23975,20201211
20201208,2호선,잠실(송파구청),49683,49792,99475,20201211
20201208,2호선,잠실새내,16200,16053,32253,20201211
20201208,2호선,종합운동장,5770,6081,11851,20201211
20201208,2호선,삼성(무역센터),41575,41828,83403,20201211
20201208,2호선,선릉,49940,44565,94505,20201211
20201208,2호선,역삼,43936,47181,91117,20201211
20201208,2호선,강남,64241,62727,126968,20201211
20201208,2호선,교대(법원.검찰청),29192,32307,61499,20201211
20201208,2호선,서초,18382,18257,36639,20201211
20201208,2호선,방배,13990,14668,28658,20201211
20201208,2호선,사당,28731,31563,60294,20201211
20201208,2호선,낙성대(강감찬),23304,22750,46054,20201211
20201208,2호선,서울대입구(관악구청),39463,38248,77711,20201211
20201208,2호선,봉천,21132,19656,40788,20201211
20201208,2호선,신림,53794,52327,106121,20201211
20201208,2호선,신대방,22636,22423,45059,20201211
20201208,2호선,구로디지털단지,53059,53821,106880,20201211
20201208,2호선,대림(구로구청),22200,22541,44741,20201211
20201208,2호선,신도림,39145,37852,76997,20201211
20201208,2호선,문래,18300,18587,36887,20201211
20201208,2호선,영등포구청,20343,20371,40714,20201211
20201208,2호선,당산,15845,18445,34290,20201211
20201208,2호선,합정,23018,23784,46802,20201211
20201208,2호선,홍대입구,34876,35785,70661,20201211
20201208,2호선,신촌,29741,29870,59611,20201211
20201208,2호선,이대,9793,9948,19741,20201211
20201208,2호선,아현,8624,8426,17050,20201211
20201208,2호선,충정로(경기대입구),8929,9262,18191,20201211
20201208,2호선,용답,2205,2158,4363,20201211
20201208,2호선,신답,1347,1595,2942,20201211
20201208,2호선,신설동,2558,2495,5053,20201211
20201208,2호선,도림천,1178,1315,2493,20201211
20201208,2호선,양천구청,5715,6125,11840,20201211
20201208,2호선,신정네거리,8509,8877,17386,20201211
20201208,2호선,용두(동대문구청),1950,2110,4060,20201211
20201208,3호선,지축,2809,2873,5682,20201211
20201208,3호선,구파발,17410,16328,33738,20201211
20201208,3호선,연신내,31993,29909,61902,20201211
20201208,3호선,불광,13789,14792,28581,20201211
20201208,3호선,녹번,12954,12192,25146,20201211
20201208,3호선,홍제,14947,14359,29306,20201211
20201208,3호선,무악재,3318,3379,6697,20201211
20201208,3호선,독립문,6056,6380,12436,20201211
20201208,3호선,경복궁(정부서울청사),14932,14319,29251,20201211
20201208,3호선,안국,15174,15364,30538,20201211
20201208,3호선,종로3가,8292,9270,17562,20201211
20201208,3호선,을지로3가,8935,9207,18142,20201211
20201208,3호선,동대입구,6241,6575,12816,20201211
20201208,3호선,약수,10961,10691,21652,20201211
20201208,3호선,금호,6751,6464,13215,20201211
20201208,3호선,옥수,7256,7754,15010,20201211
20201208,3호선,압구정,26147,27631,53778,20201211
20201208,3호선,신사,24508,25560,50068,20201211
20201208,3호선,잠원,3873,3815,7688,20201211
20201208,3호선,고속터미널,28382,27837,56219,20201211
20201208,3호선,교대(법원.검찰청),11934,7983,19917,20201211
20201208,3호선,남부터미널(예술의전당),23799,24726,48525,20201211
20201208,3호선,양재(서초구청),33536,35913,69449,20201211
20201208,3호선,매봉,10839,10320,21159,20201211
20201208,3호선,도곡,4539,4538,9077,20201211
20201208,3호선,대치,8727,8794,17521,20201211
20201208,3호선,학여울,1417,1444,2861,20201211
20201208,3호선,대청,8777,8074,16851,20201211
20201208,3호선,일원,8235,8185,16420,20201211
20201208,3호선,수서,13270,13341,26611,20201211
20201208,3호선,가락시장,7595,7469,15064,20201211
20201208,3호선,경찰병원,6711,6751,13462,20201211
20201208,3호선,오금,5439,4900,10339,20201211
20201208,4호선,수유(강북구청),28948,28938,57886,20201211
20201208,4호선,미아(서울사이버대학),13075,12883,25958,20201211
20201208,4호선,미아사거리,23606,23117,46723,20201211
20201208,4호선,길음,17055,16619,33674,20201211
20201208,4호선,성신여대입구(돈암),15909,15208,31117,20201211
20201208,4호선,한성대입구(삼선교),11100,11054,22154,20201211
20201208,4호선,혜화,23544,23346,46890,20201211
20201208,4호선,동대문,17265,17756,35021,20201211
20201208,4호선,동대문역사문화공원(DDP),12453,11538,23991,20201211
20201208,4호선,충무로,23490,24142,47632,20201211
20201208,4호선,명동,14029,14424,28453,20201211
20201208,4호선,회현(남대문시장),19366,20015,39381,20201211
20201208,4호선,서울역,9071,11502,20573,20201211
20201208,4호선,숙대입구(갈월),10318,10158,20476,20201211
20201208,4호선,삼각지,3816,4193,8009,20201211
20201208,4호선,신용산,12084,12484,24568,20201211
20201208,4호선,이촌(국립중앙박물관),5582,6091,11673,20201211
20201208,4호선,동작(현충원),1999,2138,4137,20201211
20201208,4호선,총신대입구(이수),15609,16999,32608,20201211
20201208,4호선,사당,19293,16047,35340,20201211
20201208,4호선,남태령,985,830,1815,20201211
20201208,4호선,당고개,10665,9930,20595,20201211
20201208,4호선,상계,16680,15510,32190,20201211
20201208,4호선,노원,15093,16937,32030,20201211
20201208,4호선,창동,21804,22964,44768,20201211
20201208,4호선,쌍문,25729,23944,49673,20201211
20201208,5호선,방화,5706,5464,11170,20201211
20201208,5호선,개화산,4462,4225,8687,20201211
20201208,5호선,김포공항,4993,4916,9909,20201211
20201208,경춘선,천마산,1352,1237,2589,20201211
20201208,경춘선,마석,3284,3240,6524,20201211
20201208,경춘선,대성리,390,344,734,20201211
20201208,5호선,송정,5454,5153,10607,20201211
20201208,5호선,마곡,8053,7782,15835,20201211
20201208,5호선,발산,15873,15989,31862,20201211
20201208,5호선,우장산,11561,11591,23152,20201211
20201208,5호선,화곡,24392,23079,47471,20201211
20201208,5호선,까치산,24799,24129,48928,20201211
20201208,5호선,신정(은행정),12408,9899,22307,20201211
20201208,5호선,목동,14527,16181,30708,20201211
20201208,5호선,오목교(목동운동장앞),18182,19668,37850,20201211
20201208,5호선,양평,6756,6854,13610,20201211
20201208,5호선,영등포구청,3548,3592,7140,20201211
20201208,5호선,영등포시장,7816,8091,15907,20201211
20201208,5호선,신길,3367,3800,7167,20201211
20201208,5호선,여의도,23016,23863,46879,20201211
20201208,5호선,여의나루,5943,6122,12065,20201211
20201208,5호선,마포,12144,12456,24600,20201211
20201208,5호선,공덕,12002,12807,24809,20201211
20201208,5호선,애오개,5745,5865,11610,20201211
20201208,5호선,충정로(경기대입구),4314,4409,8723,20201211
20201208,5호선,서대문,16363,16795,33158,20201211
20201208,5호선,광화문(세종문화회관),25628,26512,52140,20201211
20201208,5호선,종로3가,8025,7864,15889,20201211
20201208,5호선,을지로4가,5530,5598,11128,20201211
20201208,5호선,동대문역사문화공원(DDP),2698,2926,5624,20201211
20201208,5호선,청구,3503,3326,6829,20201211
20201208,5호선,신금호,5252,5515,10767,20201211
20201208,5호선,행당,7029,6316,13345,20201211
20201208,5호선,왕십리(성동구청),3670,3926,7596,20201211
20201208,5호선,마장,4824,4678,9502,20201211
20201208,5호선,답십리,13887,12841,26728,20201211
20201208,5호선,장한평,16148,15937,32085,20201211
20201208,5호선,군자(능동),9298,9949,19247,20201211
20201208,5호선,아차산(어린이대공원후문),11945,11710,23655,20201211
20201208,5호선,광나루(장신대),10899,9968,20867,20201211
20201208,5호선,천호(풍납토성),14535,14785,29320,20201211
20201208,5호선,강동,17130,16042,33172,20201211
20201208,5호선,길동,6607,6910,13517,20201211
20201208,5호선,굽은다리(강동구민회관앞),7938,7598,15536,20201211
20201208,5호선,명일,7035,7274,14309,20201211
20201208,5호선,고덕,7120,7155,14275,20201211
20201208,5호선,상일동,13603,12478,26081,20201211
20201208,5호선,둔촌동,7208,7159,14367,20201211
20201208,5호선,올림픽공원(한국체대),3529,2937,6466,20201211
20201208,5호선,방이,5657,5895,11552,20201211
20201208,5호선,오금,3286,3176,6462,20201211
20201208,5호선,개롱,5258,5595,10853,20201211
20201208,5호선,거여,6880,6637,13517,20201211
20201208,5호선,마천,5078,5207,10285,20201211
20201208,5호선,미사,11183,11177,22360,20201211
20201208,5호선,하남풍산,4235,4133,8368,20201211
20201208,6호선,응암,15114,15146,30260,20201211
20201208,6호선,역촌,3208,3748,6956,20201211
20201208,6호선,불광,3707,3822,7529,20201211
20201208,6호선,독바위,2443,2614,5057,20201211
20201208,6호선,구산,6172,4956,11128,20201211
20201208,6호선,새절(신사),11074,10433,21507,20201211
20201208,6호선,증산(명지대앞),8643,8584,17227,20201211
20201208,6호선,디지털미디어시티,12176,13368,25544,20201211
20201208,6호선,월드컵경기장(성산),3602,3723,7325,20201211
20201208,6호선,마포구청,11881,10817,22698,20201211
20201208,6호선,망원,11035,11970,23005,20201211
20201208,6호선,합정,9894,9636,19530,20201211
20201208,6호선,상수,6232,6531,12763,20201211
20201208,6호선,광흥창(서강),7431,7299,14730,20201211
20201208,6호선,대흥(서강대앞),6581,6827,13408,20201211
20201208,6호선,공덕,15407,15059,30466,20201211
20201208,6호선,효창공원앞,6159,5569,11728,20201211
20201208,6호선,삼각지,4623,4128,8751,20201211
20201208,6호선,녹사평(용산구청),3466,3417,6883,20201211
20201208,6호선,이태원,6549,6816,13365,20201211
20201208,6호선,한강진,5408,6130,11538,20201211
20201208,6호선,버티고개,1882,1881,3763,20201211
20201208,6호선,약수,2981,3017,5998,20201211
20201208,6호선,청구,3399,3613,7012,20201211
20201208,6호선,신당,6625,7044,13669,20201211
20201208,6호선,동묘앞,6735,6892,13627,20201211
20201208,6호선,창신,3076,2474,5550,20201211
20201208,6호선,보문,6175,5771,11946,20201211
20201208,6호선,안암(고대병원앞),7925,7854,15779,20201211
20201208,6호선,고려대(종암),6336,6246,12582,20201211
20201208,6호선,월곡(동덕여대),9562,9566,19128,20201211
20201208,6호선,상월곡(한국과학기술연구원),5340,4807,10147,20201211
20201208,6호선,돌곶이,7354,6962,14316,20201211
20201208,6호선,석계,10861,11320,22181,20201211
20201208,6호선,태릉입구,4420,4856,9276,20201211
20201208,6호선,화랑대(서울여대입구),9806,7840,17646,20201211
20201208,6호선,봉화산(서울의료원),7805,7254,15059,20201211
20201208,7호선,장암,2071,778,2849,20201211
20201208,7호선,도봉산,7978,9371,17349,20201211
20201208,7호선,수락산,10799,10943,21742,20201211
20201208,7호선,마들,10503,10271,20774,20201211
20201208,7호선,노원,15519,16132,31651,20201211
20201208,7호선,중계,12373,11514,23887,20201211
20201208,7호선,하계,15005,14477,29482,20201211
20201208,7호선,공릉(서울과학기술대),11012,10771,21783,20201211
20201208,7호선,태릉입구,6981,6368,13349,20201211
20201208,7호선,먹골,8618,8457,17075,20201211
20201208,7호선,중화,9625,9519,19144,20201211
20201208,7호선,상봉(시외버스터미널),14412,13481,27893,20201211
20201208,7호선,면목,13568,13473,27041,20201211
20201208,7호선,사가정,14395,14478,28873,20201211
20201208,7호선,용마산(용마폭포공원),5225,5087,10312,20201211
20201208,7호선,중곡,8960,8525,17485,20201211
20201208,7호선,군자(능동),12346,9876,22222,20201211
20201208,7호선,어린이대공원(세종대),9659,9449,19108,20201211
20201208,7호선,건대입구,9606,9807,19413,20201211
20201208,7호선,뚝섬유원지,5917,5905,11822,20201211
20201208,7호선,청담,17343,19052,36395,20201211
20201208,7호선,강남구청,13979,15207,29186,20201211
20201208,7호선,학동,22003,23188,45191,20201211
20201208,7호선,논현,17521,18887,36408,20201211
20201208,7호선,반포,4765,4585,9350,20201211
20201208,7호선,고속터미널,12056,10759,22815,20201211
20201208,7호선,내방,12886,12972,25858,20201211
20201208,7호선,이수,12862,12689,25551,20201211
20201208,7호선,남성,9829,9161,18990,20201211
20201208,7호선,숭실대입구(살피재),10226,10574,20800,20201211
20201208,7호선,상도,8668,8548,17216,20201211
20201208,7호선,장승배기,8381,8348,16729,20201211
20201208,7호선,신대방삼거리,14277,13981,28258,20201211
20201208,7호선,보라매,8676,8478,17154,20201211
20201208,7호선,신풍,10137,9836,19973,20201211
20201208,7호선,대림(구로구청),6790,6799,13589,20201211
20201208,7호선,남구로,15120,15998,31118,20201211
20201208,7호선,가산디지털단지,43115,43099,86214,20201211
20201208,7호선,철산,18319,18588,36907,20201211
20201208,7호선,광명사거리,19670,19643,39313,20201211
20201208,7호선,천왕,9476,9120,18596,20201211
20201208,7호선,온수(성공회대입구),9422,8679,18101,20201211
20201208,7호선,까치울,6590,6380,12970,20201211
20201208,7호선,부천종합운동장,3901,3437,7338,20201211
20201208,7호선,춘의,8830,8815,17645,20201211
20201208,7호선,신중동,12185,11892,24077,20201211
20201208,7호선,부천시청,10323,10432,20755,20201211
20201208,7호선,상동,10472,10749,21221,20201211
20201208,7호선,삼산체육관,4119,3810,7929,20201211
20201208,7호선,굴포천,7442,7839,15281,20201211
20201208,7호선,부평구청,10436,8708,19144,20201211
20201208,8호선,암사,16470,14911,31381,20201211
20201208,8호선,천호(풍납토성),13163,14507,27670,20201211
20201208,8호선,강동구청,8997,9673,18670,20201211
20201208,8호선,몽촌토성(평화의문),4716,4890,9606,20201211
20201208,8호선,잠실(송파구청),11049,12266,23315,20201211
20201208,8호선,석촌,6323,7283,13606,20201211
20201208,8호선,송파,6708,6701,13409,20201211
20201208,8호선,가락시장,6814,7584,14398,20201211
20201208,8호선,문정,19617,20573,40190,20201211
20201208,8호선,장지,14775,14428,29203,20201211
20201208,8호선,복정,8925,7905,16830,20201211
20201208,8호선,산성,5784,5885,11669,20201211
20201208,8호선,남한산성입구(성남법원.검찰청),12739,11991,24730,20201211
20201208,8호선,단대오거리,8785,8389,17174,20201211
20201208,8호선,신흥,3881,4036,7917,20201211
20201208,8호선,수진,4335,3934,8269,20201211
20201208,8호선,모란,3441,2527,5968,20201211
20201208,9호선,개화,2185,1558,3743,20201211
20201208,9호선,김포공항,5420,6692,12112,20201211
20201208,9호선,공항시장,2415,2697,5112,20201211
20201208,9호선,신방화,5827,5739,11566,20201211
20201208,9호선,마곡나루(서울식물원),8751,8726,17477,20201211
20201208,9호선,양천향교,8204,8553,16757,20201211
20201208,9호선,가양,16911,16848,33759,20201211
20201208,9호선,증미,6372,6228,12600,20201211
20201208,9호선,등촌,9128,9144,18272,20201211
20201208,9호선,염창,14243,14316,28559,20201211
20201208,9호선,신목동,3249,3034,6283,20201211
20201208,9호선,선유도,6557,6258,12815,20201211
20201208,9호선,당산,14769,14733,29502,20201211
20201208,9호선,국회의사당,14554,14518,29072,20201211
20201208,9호선,여의도,20034,19274,39308,20201211
20201208,9호선,샛강,4806,4994,9800,20201211
20201208,9호선,노량진,19525,18719,38244,20201211
20201208,9호선,노들,3705,3348,7053,20201211
20201208,9호선,흑석(중앙대입구),6130,6430,12560,20201211
20201208,9호선,동작(현충원),1399,1118,2517,20201211
20201208,9호선,구반포,2183,2260,4443,20201211
20201208,9호선,신반포,2380,2374,4754,20201211
20201208,9호선,고속터미널,8263,10452,18715,20201211
20201208,9호선,사평,2562,2561,5123,20201211
20201208,9호선,신논현,24188,23832,48020,20201211
20201208,9호선2~3단계,언주,8411,8474,16885,20201211
20201208,9호선2~3단계,선정릉,7947,8641,16588,20201211
20201208,9호선2~3단계,삼성중앙,5823,5979,11802,20201211
20201208,9호선2~3단계,봉은사,12828,12673,25501,20201211
20201208,9호선2~3단계,종합운동장,3391,3368,6759,20201211
20201208,9호선2~3단계,삼전,5496,5401,10897,20201211
20201208,9호선2~3단계,석촌고분,4721,4761,9482,20201211
20201208,9호선2~3단계,석촌,6203,5676,11879,20201211
20201208,9호선2~3단계,송파나루,3613,3725,7338,20201211
20201208,9호선2~3단계,한성백제,1935,1758,3693,20201211
20201208,9호선2~3단계,올림픽공원(한국체대),4431,4354,8785,20201211
20201208,9호선2~3단계,둔촌오륜,878,783,1661,20201211
20201208,9호선2~3단계,중앙보훈병원,8598,7714,16312,20201211
20201208,경강선,판교,3608,3451,7059,20201211
20201208,경강선,이매,848,790,1638,20201211
20201208,경강선,삼동,1901,1831,3732,20201211
20201208,경강선,경기광주,5661,5454,11115,20201211
20201208,경강선,초월,2487,2475,4962,20201211
20201208,경강선,곤지암,1653,1624,3277,20201211
20201208,경강선,신둔도예촌,909,842,1751,20201211
20201208,경강선,이천,1713,1795,3508,20201211
20201208,경강선,부발,1314,1294,2608,20201211
20201208,경강선,세종대왕릉,206,210,416,20201211
20201208,경강선,여주,1236,1244,2480,20201211
20201208,경부선,서울역,3147,1125,4272,20201211
20201208,경부선,남영,8153,8657,16810,20201211
20201208,경부선,용산,23353,23994,47347,20201211
20201208,경부선,노량진,6428,6812,13240,20201211
20201208,경부선,대방,10961,11377,22338,20201211
20201208,경부선,영등포,29161,29838,58999,20201211
20201208,경부선,신도림,3522,3343,6865,20201211
20201208,경부선,신길,8256,6911,15167,20201211
20201208,경부선,구로,16720,16887,33607,20201211
20201208,경부선,가산디지털단지,15881,18737,34618,20201211
20201208,경부선,금천구청,10114,10270,20384,20201211
20201208,경부선,석수,8851,7851,16702,20201211
20201208,경부선,관악,6247,5745,11992,20201211
20201208,경부선,안양,20382,20606,40988,20201211
20201208,경부선,명학,8404,8298,16702,20201211
20201208,경부선,금정,22746,23217,45963,20201211
20201208,경부선,군포,7027,7117,14144,20201211
20201208,경부선,의왕,7608,7601,15209,20201211
20201208,경부선,성균관대,12028,11917,23945,20201211
20201208,경부선,화서,6293,6097,12390,20201211
20201208,경부선,수원,25026,26617,51643,20201211
20201208,경부선,독산,15131,16072,31203,20201211
20201208,경부선,세류,2491,2323,4814,20201211
20201208,경부선,병점,10958,10897,21855,20201211
20201208,경부선,세마,2147,1915,4062,20201211
20201208,경부선,오산대,2656,2379,5035,20201211
20201208,경부선,오산,7909,7962,15871,20201211
20201208,경부선,진위,1331,1169,2500,20201211
20201208,경부선,송탄,3321,3175,6496,20201211
20201208,경부선,서정리,5411,5223,10634,20201211
20201208,경부선,지제,2140,2071,4211,20201211
20201208,경부선,평택,8854,8764,17618,20201211
20201208,경부선,성환,3066,3120,6186,20201211
20201208,경부선,직산,587,594,1181,20201211
20201208,경부선,두정,4021,4104,8125,20201211
20201208,경부선,천안,3610,3725,7335,20201211
20201208,경부선,당정,5308,5127,10435,20201211
20201208,경부선,서동탄,1315,1043,2358,20201211
20201208,경부선,광명,2383,2103,4486,20201211
20201208,경원선,이촌(국립중앙박물관),3073,2413,5486,20201211
20201208,경원선,서빙고,1575,1460,3035,20201211
20201208,경원선,한남,3546,3291,6837,20201211
20201208,경원선,옥수,41,27,68,20201211
20201208,경원선,응봉,1494,1267,2761,20201211
20201208,경원선,왕십리(성동구청),10291,11905,22196,20201211
20201208,경원선,청량리(서울시립대입구),10774,11709,22483,20201211
20201208,경원선,외대앞,5712,5685,11397,20201211
20201208,경원선,신이문,7352,6914,14266,20201211
20201208,경원선,석계,6973,8052,15025,20201211
20201208,경원선,광운대,7362,7173,14535,20201211
20201208,경원선,월계,5448,5140,10588,20201211
20201208,경원선,녹천,4102,3549,7651,20201211
20201208,경원선,방학,8147,8091,16238,20201211
20201208,경춘선,청평,1028,1053,2081,20201211
20201208,경춘선,상천,178,177,355,20201211
20201208,경춘선,가평,1004,1031,2035,20201211
20201208,경춘선,굴봉산,77,71,148,20201211
20201208,경춘선,백양리,82,103,185,20201211
20201208,경춘선,강촌,295,298,593,20201211
20201208,경춘선,김유정,173,181,354,20201211
20201208,경춘선,남춘천,1708,1750,3458,20201211
20201208,경춘선,춘천,786,770,1556,20201211
20201208,공항철도 1호선,서울역,4846,4338,9184,20201211
20201208,공항철도 1호선,공덕,1790,2218,4008,20201211
20201208,공항철도 1호선,홍대입구,5616,5787,11403,20201211
20201208,공항철도 1호선,디지털미디어시티,11845,10719,22564,20201211
20201208,공항철도 1호선,마곡나루(서울식물원),6343,6132,12475,20201211
20201208,공항철도 1호선,김포공항,7537,5207,12744,20201211
20201208,공항철도 1호선,계양,7829,7366,15195,20201211
20201208,공항철도 1호선,검암,6112,5839,11951,20201211
20201208,공항철도 1호선,청라국제도시,5552,5196,10748,20201211
20201208,공항철도 1호선,운서,4823,4818,9641,20201211
20201208,공항철도 1호선,공항화물청사,2181,2368,4549,20201211
20201208,공항철도 1호선,인천공항1터미널,2863,3020,5883,20201211
20201208,공항철도 1호선,인천공항2터미널,1652,1607,3259,20201211
20201208,공항철도 1호선,영종,2092,2133,4225,20201211
20201208,과천선,선바위,7301,6476,13777,20201211
20201208,과천선,경마공원,875,870,1745,20201211
20201208,과천선,대공원,1424,1562,2986,20201211
20201208,과천선,과천,4353,4096,8449,20201211
20201208,과천선,정부과천청사,8155,7986,16141,20201211
20201208,과천선,인덕원,20391,21157,41548,20201211
20201208,과천선,평촌,15694,15809,31503,20201211
20201208,과천선,범계,20811,20301,41112,20201211
20201208,분당선,선릉,12246,17785,30031,20201211
20201208,분당선,한티,11443,12348,23791,20201211
20201208,분당선,도곡,5595,5546,11141,20201211
20201208,분당선,구룡,1404,1360,2764,20201211
20201208,분당선,개포동,3000,3075,6075,20201211
20201208,분당선,대모산입구,3089,2921,6010,20201211
20201208,분당선,수서,10381,10803,21184,20201211
20201208,분당선,수원,6315,5083,11398,20201211
20201208,분당선,서울숲,7052,7022,14074,20201211
20201208,분당선,압구정로데오,13956,15084,29040,20201211
20201208,분당선,강남구청,8074,9223,17297,20201211
20201208,분당선,선정릉,7140,7503,14643,20201211
20201208,분당선,가천대,7649,8414,16063,20201211
20201208,분당선,태평,11411,11095,22506,20201211
20201208,분당선,모란,16553,16575,33128,20201211
20201208,분당선,야탑,21123,21988,43111,20201211
20201208,분당선,서현,19101,19286,38387,20201211
20201208,분당선,수내,10498,10572,21070,20201211
20201208,분당선,정자,13196,14012,27208,20201211
20201208,분당선,미금,12782,13283,26065,20201211
20201208,분당선,오리,9937,8457,18394,20201211
20201208,분당선,이매,4470,4227,8697,20201211
20201208,수인선,고색,2655,2617,5272,20201211
20201208,수인선,오목천,1972,1860,3832,20201211
20201208,수인선,어천,408,434,842,20201211
20201208,수인선,야목,150,113,263,20201211
20201208,경원선,도봉,5148,4979,10127,20201211
20201208,분당선,보정,1956,1755,3711,20201211
20201208,분당선,죽전,10633,11638,22271,20201211
20201208,분당선,구성,4050,4248,8298,20201211
20201208,분당선,신갈,3770,3721,7491,20201211
20201208,분당선,기흥,7606,7368,14974,20201211
20201208,분당선,상갈,4295,4306,8601,20201211
20201208,분당선,청명,3516,3404,6920,20201211
20201208,분당선,영통,6227,6427,12654,20201211
20201208,분당선,망포,11699,11156,22855,20201211
20201208,분당선,매탄권선,3790,3768,7558,20201211
20201208,분당선,수원시청,9642,10148,19790,20201211
20201208,분당선,매교,2285,2424,4709,20201211
20201208,경원선,도봉산,6478,3867,10345,20201211
20201208,경원선,망월사,6080,6187,12267,20201211
20201208,경원선,회룡,10593,10407,21000,20201211
20201208,경원선,의정부,14553,14516,29069,20201211
20201208,경원선,가능,5433,5413,10846,20201211
20201208,경원선,녹양,3964,3913,7877,20201211
20201208,경원선,양주,6196,6061,12257,20201211
20201208,경원선,덕계,2317,2159,4476,20201211
20201208,경원선,덕정,5059,4986,10045,20201211
20201208,경원선,지행,5185,5137,10322,20201211
20201208,경원선,동두천중앙,2716,2656,5372,20201211
20201208,경원선,보산,1252,1140,2392,20201211
20201208,경원선,동두천,1863,2143,4006,20201211
20201208,경원선,소요산,2063,1825,3888,20201211
20201208,경의선,서울역,3699,4369,8068,20201211
20201208,경의선,신촌,1012,1135,2147,20201211
20201208,경의선,효창공원앞,2457,2757,5214,20201211
20201208,경의선,공덕,2889,2562,5451,20201211
20201208,경의선,서강대,1551,1533,3084,20201211
20201208,경의선,홍대입구,1161,1308,2469,20201211
20201208,경의선,가좌,4512,4237,8749,20201211
20201208,경의선,디지털미디어시티,2041,1940,3981,20201211
20201208,경의선,수색,2236,2258,4494,20201211
20201208,경의선,화전,1283,1193,2476,20201211
20201208,경의선,강매,2612,2239,4851,20201211
20201208,경의선,행신,6317,6407,12724,20201211
20201208,경의선,능곡,3148,2849,5997,20201211
20201208,경의선,곡산,480,512,992,20201211
20201208,경의선,백마,5671,5510,11181,20201211
20201208,경의선,풍산,4458,4233,8691,20201211
20201208,경의선,일산,8068,8191,16259,20201211
20201208,경의선,탄현,6167,6086,12253,20201211
20201208,경의선,야당,4961,4828,9789,20201211
20201208,경의선,운정,5141,4940,10081,20201211
20201208,경의선,금릉,3604,3524,7128,20201211
20201208,경의선,금촌,5111,5162,10273,20201211
20201208,경의선,월롱,1682,1616,3298,20201211
20201208,경의선,파주,1289,994,2283,20201211
20201208,경의선,문산,3887,3905,7792,20201211
20201208,경의선,임진강,7,7,14,20201211
20201208,경인선,개봉,18693,19247,37940,20201211
20201208,경인선,오류동,10059,9515,19574,20201211
20201208,경인선,역곡,23381,23495,46876,20201211
20201208,경인선,부천,27021,27377,54398,20201211
20201208,경인선,송내,23944,24014,47958,20201211
20201208,경인선,부평,23311,24385,47696,20201211
20201208,경인선,백운,6088,6075,12163,20201211
20201208,경인선,동암,13099,13311,26410,20201211
20201208,경인선,주안,15616,14546,30162,20201211
20201208,경인선,제물포,8749,8420,17169,20201211
20201208,경인선,동인천,11378,10852,22230,20201211
20201208,경인선,인천,2635,1911,4546,20201211
20201208,경인선,구일,5135,5387,10522,20201211
20201208,경인선,소사,8202,7944,16146,20201211
20201208,경인선,부개,7261,6972,14233,20201211
20201208,경인선,간석,4902,4771,9673,20201211
20201208,경인선,도원,2686,2708,5394,20201211
20201208,경인선,온수(성공회대입구),5676,5575,11251,20201211
20201208,경인선,중동,7872,7535,15407,20201211
20201208,경인선,도화,3410,3139,6549,20201211
20201208,경춘선,신내,1391,1424,2815,20201211
20201208,경춘선,갈매,2674,2329,5003,20201211
20201208,경춘선,별내,2325,2262,4587,20201211
20201208,경춘선,퇴계원,3086,2872,5958,20201211
20201208,경춘선,사릉,2978,2911,5889,20201211
20201208,경춘선,금곡,1308,1227,2535,20201211
20201208,경춘선,평내호평,4916,4914,9830,20201211
20201208,중앙선,지평,31,21,52,20201211
20201208,중앙선,용문,1100,1078,2178,20201211
20201208,중앙선,원덕,214,230,444,20201211
20201208,중앙선,양평,1946,1927,3873,20201211
20201208,중앙선,오빈,213,216,429,20201211
20201208,중앙선,아신,362,364,726,20201211
20201208,중앙선,국수,459,434,893,20201211
20201208,중앙선,신원,170,135,305,20201211
20201208,중앙선,양수,1291,1305,2596,20201211
20201208,중앙선,운길산,514,492,1006,20201211
20201208,중앙선,팔당,654,671,1325,20201211
20201208,중앙선,도심,2098,1539,3637,20201211
20201208,중앙선,덕소,4635,4730,9365,20201211
20201208,중앙선,양정,664,574,1238,20201211
20201208,중앙선,도농,8365,7580,15945,20201211
20201208,중앙선,구리,11423,11479,22902,20201211
20201208,중앙선,양원,1445,1489,2934,20201211
20201208,중앙선,망우,6234,6207,12441,20201211
20201208,중앙선,상봉(시외버스터미널),4929,4824,9753,20201211
20201208,중앙선,중랑,4680,4515,9195,20201211
20201208,중앙선,회기,18973,18512,37485,20201211
20201208,장항선,신창(순천향대),828,765,1593,20201211
20201208,장항선,온양온천,2509,2651,5160,20201211
20201208,장항선,배방,751,718,1469,20201211
20201208,장항선,아산,1957,1777,3734,20201211
20201208,장항선,쌍용(나사렛대),1746,1629,3375,20201211
20201208,장항선,봉명,1007,1013,2020,20201211
20201208,일산선,대화,11241,9020,20261,20201211
20201208,일산선,주엽,7212,7362,14574,20201211
20201208,일산선,정발산,5614,5367,10981,20201211
20201208,일산선,마두,6102,6365,12467,20201211
20201208,일산선,백석,8668,8659,17327,20201211
20201208,일산선,대곡,1563,1151,2714,20201211
20201208,일산선,화정,13930,14445,28375,20201211
20201208,일산선,원당,9528,9083,18611,20201211
20201208,일산선,삼송,15256,15211,30467,20201211
20201208,일산선,원흥,7848,7569,15417,20201211
20201208,우이신설선,신설동,1963,1868,3831,20201211
20201208,우이신설선,보문,1250,1308,2558,20201211
20201208,우이신설선,성신여대입구(돈암),2348,2508,4856,20201211
20201208,우이신설선,정릉,3643,3594,7237,20201211
20201208,우이신설선,북한산보국문,4814,4777,9591,20201211
20201208,우이신설선,솔샘,4896,4705,9601,20201211
20201208,우이신설선,삼양사거리,2031,2091,4122,20201211
20201208,우이신설선,삼양,1737,1972,3709,20201211
20201208,우이신설선,화계,2873,2801,5674,20201211
20201208,우이신설선,가오리,3370,3496,6866,20201211
20201208,우이신설선,4.19민주묘지,2382,2332,4714,20201211
20201208,우이신설선,솔밭공원,2003,2059,4062,20201211
20201208,우이신설선,북한산우이,2027,1814,3841,20201211
20201208,안산선,수리산,3783,3185,6968,20201211
20201208,안산선,오이도,6942,6660,13602,20201211
20201208,안산선,정왕,8274,8679,16953,20201211
20201208,안산선,신길온천,1415,1293,2708,20201211
20201208,안산선,안산,10590,9377,19967,20201211
20201208,안산선,초지,3876,4052,7928,20201211
20201208,안산선,고잔,7520,7214,14734,20201211
20201208,안산선,중앙,13158,13545,26703,20201211
20201208,안산선,한대앞,7275,7448,14723,20201211
20201208,안산선,상록수,13992,14237,28229,20201211
20201208,안산선,반월,3715,3578,7293,20201211
20201208,안산선,대야미,4144,3784,7928,20201211
20201208,안산선,산본,13299,14142,27441,20201211
20201208,수인선,인천,749,1245,1994,20201211
20201208,수인선,신포,1403,1401,2804,20201211
20201208,수인선,숭의,3371,3203,6574,20201211
20201208,수인선,인하대,4921,4541,9462,20201211
20201208,수인선,송도,2122,1936,4058,20201211
20201208,수인선,연수,3596,3580,7176,20201211
20201208,수인선,원인재,3612,3753,7365,20201211
20201208,수인선,남동인더스파크,2179,2471,4650,20201211
20201208,수인선,호구포,3165,3260,6425,20201211
20201208,수인선,인천논현,4534,4751,9285,20201211
20201208,수인선,소래포구,3616,3487,7103,20201211
20201208,수인선,월곶,2047,1925,3972,20201211
20201208,수인선,달월,83,53,136,20201211
20201208,수인선,사리,2850,2698,5548,20201211
20201208,1호선,서울역,32683,30758,63441,20201211
20201208,1호선,동묘앞,6490,6856,13346,20201211
20201208,1호선,시청,18387,18236,36623,20201211
20201208,1호선,종각,28215,27372,55587,20201211
20201208,1호선,종로3가,18210,16598,34808,20201211
20201208,1호선,종로5가,18157,17936,36093,20201211
20201208,1호선,동대문,9256,8784,18040,20201211
20201208,1호선,신설동,11880,11810,23690,20201211
20201208,1호선,제기동,14173,14427,28600,20201211
20201208,1호선,청량리(서울시립대입구),16776,16678,33454,20201211
20201208,2호선,시청,20306,19795,40101,20201211
20201208,2호선,을지로입구,32892,33410,66302,20201211
20201208,2호선,을지로3가,17951,17515,35466,20201211
20201208,2호선,을지로4가,11552,11442,22994,20201211
20201208,2호선,동대문역사문화공원(DDP),9473,10378,19851,20201211
20201209,7호선,온수(성공회대입구),9419,8632,18051,20201212
20201209,중앙선,지평,31,20,51,20201212
20201209,중앙선,용문,1037,1078,2115,20201212
20201209,중앙선,원덕,228,231,459,20201212
20201209,중앙선,양평,1693,1648,3341,20201212
20201209,중앙선,오빈,220,216,436,20201212
20201209,중앙선,아신,358,367,725,20201212
20201209,중앙선,국수,463,484,947,20201212
20201209,중앙선,신원,136,134,270,20201212
20201209,중앙선,양수,1290,1290,2580,20201212
20201209,중앙선,운길산,490,463,953,20201212
20201209,중앙선,팔당,647,633,1280,20201212
20201209,중앙선,도심,2094,1594,3688,20201212
20201209,중앙선,덕소,4583,4667,9250,20201212
20201209,중앙선,양정,673,589,1262,20201212
20201209,중앙선,도농,8218,7562,15780,20201212
20201209,중앙선,구리,11163,11325,22488,20201212
20201209,중앙선,양원,1452,1460,2912,20201212
20201209,중앙선,망우,6224,6105,12329,20201212
20201209,중앙선,상봉(시외버스터미널),4913,4705,9618,20201212
20201209,중앙선,중랑,4667,4484,9151,20201212
20201209,중앙선,회기,18698,18299,36997,20201212
20201209,장항선,신창(순천향대),780,733,1513,20201212
20201209,장항선,온양온천,3104,3175,6279,20201212
20201209,장항선,배방,755,685,1440,20201212
20201209,장항선,아산,1959,1809,3768,20201212
20201209,장항선,쌍용(나사렛대),1775,1654,3429,20201212
20201209,장항선,봉명,1134,1121,2255,20201212
20201209,일산선,대화,10976,8775,19751,20201212
20201209,일산선,주엽,7195,7278,14473,20201212
20201209,일산선,정발산,5679,5510,11189,20201212
20201209,일산선,마두,6171,6374,12545,20201212
20201209,일산선,백석,8239,8349,16588,20201212
20201209,일산선,대곡,1472,1132,2604,20201212
20201209,일산선,화정,13643,14131,27774,20201212
20201209,일산선,원당,9399,9014,18413,20201212
20201209,일산선,삼송,15029,14987,30016,20201212
20201209,일산선,원흥,7846,7518,15364,20201212
20201209,우이신설선,신설동,1988,1948,3936,20201212
20201209,우이신설선,화계,2927,2766,5693,20201212
20201209,분당선,수원시청,9603,10230,19833,20201212
20201209,분당선,매탄권선,3877,3655,7532,20201212
20201209,분당선,망포,11420,10970,22390,20201212
20201209,분당선,영통,6207,6385,12592,20201212
20201209,분당선,청명,3412,3256,6668,20201212
20201209,분당선,상갈,4432,4238,8670,20201212
20201209,분당선,기흥,7587,7431,15018,20201212
20201209,분당선,신갈,3750,3719,7469,20201212
20201209,분당선,구성,3970,4277,8247,20201212
20201209,분당선,죽전,10721,11696,22417,20201212
20201209,분당선,보정,2015,1728,3743,20201212
20201209,분당선,이매,4427,4210,8637,20201212
20201209,분당선,오리,9876,8370,18246,20201212
20201209,분당선,미금,12892,13571,26463,20201212
20201209,분당선,정자,12987,13667,26654,20201212
20201209,분당선,수내,10529,10588,21117,20201212
20201209,분당선,서현,19219,19567,38786,20201212
20201209,분당선,야탑,21431,22369,43800,20201212
20201209,분당선,모란,19654,20038,39692,20201212
20201209,분당선,태평,11542,11341,22883,20201212
20201209,분당선,가천대,7452,8320,15772,20201212
20201209,분당선,선정릉,7151,7455,14606,20201212
20201209,분당선,강남구청,8019,9091,17110,20201212
20201209,분당선,압구정로데오,13864,14813,28677,20201212
20201209,분당선,서울숲,6939,6939,13878,20201212
20201209,공항철도 1호선,계양,8002,7525,15527,20201212
20201209,공항철도 1호선,김포공항,7256,5202,12458,20201212
20201209,공항철도 1호선,마곡나루(서울식물원),6324,6024,12348,20201212
20201209,공항철도 1호선,디지털미디어시티,11582,10467,22049,20201212
20201209,공항철도 1호선,홍대입구,5630,5768,11398,20201212
20201209,공항철도 1호선,공덕,1758,2183,3941,20201212
20201209,공항철도 1호선,서울역,4854,4423,9277,20201212
20201209,경춘선,춘천,818,755,1573,20201212
20201209,경춘선,남춘천,1662,1687,3349,20201212
20201209,경춘선,김유정,156,156,312,20201212
20201209,경춘선,강촌,231,250,481,20201212
20201209,경춘선,백양리,96,93,189,20201212
20201209,경춘선,굴봉산,68,75,143,20201212
20201209,경춘선,가평,949,983,1932,20201212
20201209,경춘선,상천,189,175,364,20201212
20201209,경춘선,청평,1041,1038,2079,20201212
20201209,경춘선,대성리,317,317,634,20201212
20201209,경춘선,마석,3128,3019,6147,20201212
20201209,경춘선,천마산,1329,1248,2577,20201212
20201209,경춘선,평내호평,4837,4749,9586,20201212
20201209,경춘선,금곡,1292,1232,2524,20201212
20201209,경춘선,사릉,2976,2934,5910,20201212
20201209,경춘선,퇴계원,3092,2884,5976,20201212
20201209,경춘선,별내,2241,2192,4433,20201212
20201209,경춘선,갈매,2650,2259,4909,20201212
20201209,경춘선,신내,1385,1385,2770,20201212
20201209,경인선,도화,3435,3189,6624,20201212
20201209,경인선,중동,7847,7559,15406,20201212
20201209,경인선,온수(성공회대입구),5522,5485,11007,20201212
20201209,경인선,도원,2800,2859,5659,20201212
20201209,경인선,간석,4950,4755,9705,20201212
20201209,경인선,부개,7307,6938,14245,20201212
20201209,경인선,소사,8207,8083,16290,20201212
20201209,경인선,구일,5178,5417,10595,20201212
20201209,경인선,인천,2633,1914,4547,20201212
20201209,경인선,동인천,11419,10867,22286,20201212
20201209,경인선,제물포,8645,8205,16850,20201212
20201209,경인선,주안,15681,14550,30231,20201212
20201209,경인선,동암,13377,13442,26819,20201212
20201209,경인선,백운,6145,6071,12216,20201212
20201209,경인선,부평,23288,24869,48157,20201212
20201209,경인선,송내,23762,23889,47651,20201212
20201209,경인선,부천,27498,27644,55142,20201212
20201209,경인선,역곡,23380,23411,46791,20201212
20201209,경인선,오류동,10116,9655,19771,20201212
20201209,경인선,개봉,18497,19306,37803,20201212
20201209,경의선,임진강,12,14,26,20201212
20201209,경의선,문산,3986,3959,7945,20201212
20201209,경의선,파주,1243,943,2186,20201212
20201209,경의선,월롱,1719,1668,3387,20201212
20201209,경의선,금촌,5018,5047,10065,20201212
20201209,경의선,금릉,3703,3495,7198,20201212
20201209,경의선,운정,5037,4803,9840,20201212
20201209,경의선,야당,5034,4761,9795,20201212
20201209,경의선,탄현,6127,6118,12245,20201212
20201209,경의선,일산,7463,7521,14984,20201212
20201209,경의선,풍산,4232,4015,8247,20201212
20201209,경의선,백마,5447,5288,10735,20201212
20201209,경의선,곡산,478,487,965,20201212
20201209,경의선,능곡,3102,2903,6005,20201212
20201209,경의선,행신,6227,6260,12487,20201212
20201209,경의선,강매,2665,2248,4913,20201212
20201209,경의선,화전,1318,1199,2517,20201212
20201209,경의선,수색,2225,2234,4459,20201212
20201209,경의선,디지털미디어시티,1991,2003,3994,20201212
20201209,경의선,가좌,4416,4059,8475,20201212
20201209,경의선,홍대입구,1252,1404,2656,20201212
20201209,경의선,서강대,1575,1495,3070,20201212
20201209,경의선,공덕,2735,2488,5223,20201212
20201209,경의선,효창공원앞,2440,2772,5212,20201212
20201209,경의선,신촌,653,797,1450,20201212
20201209,경의선,서울역,3496,4173,7669,20201212
20201209,경원선,소요산,2039,1779,3818,20201212
20201209,경원선,동두천,1847,2034,3881,20201212
20201209,경원선,보산,1215,1129,2344,20201212
20201209,경원선,동두천중앙,2663,2699,5362,20201212
20201209,경원선,지행,5246,5092,10338,20201212
20201209,경원선,덕정,4731,4592,9323,20201212
20201209,경원선,덕계,2321,2080,4401,20201212
20201209,경원선,양주,6161,5877,12038,20201212
20201209,경원선,녹양,3971,3927,7898,20201212
20201209,경원선,가능,5438,5284,10722,20201212
20201209,경원선,의정부,14516,14757,29273,20201212
20201209,경원선,회룡,10584,10508,21092,20201212
20201209,경원선,망월사,6099,6288,12387,20201212
20201209,경원선,도봉산,6650,4003,10653,20201212
20201209,경원선,도봉,5222,5110,10332,20201212
20201209,경원선,방학,8102,7991,16093,20201212
20201209,경원선,녹천,4271,3558,7829,20201212
20201209,경원선,월계,5334,5095,10429,20201212
20201209,경원선,광운대,7728,7457,15185,20201212
20201209,경원선,석계,6960,7862,14822,20201212
20201209,경원선,신이문,7418,6964,14382,20201212
20201209,경원선,외대앞,5746,5802,11548,20201212
20201209,경원선,청량리(서울시립대입구),10502,11577,22079,20201212
20201209,경원선,왕십리(성동구청),10355,12013,22368,20201212
20201209,경원선,응봉,1517,1312,2829,20201212
20201209,경원선,옥수,36,18,54,20201212
20201209,경원선,한남,3526,3267,6793,20201212
20201209,경원선,서빙고,1586,1405,2991,20201212
20201209,경원선,이촌(국립중앙박물관),3031,2356,5387,20201212
20201209,경부선,광명,2335,2075,4410,20201212
20201209,경부선,서동탄,1313,1092,2405,20201212
20201209,경부선,당정,5327,5053,10380,20201212
20201209,경부선,천안,3543,3735,7278,20201212
20201209,경부선,두정,4081,4052,8133,20201212
20201209,경부선,직산,594,596,1190,20201212
20201209,경부선,성환,3021,3015,6036,20201212
20201209,경부선,평택,8666,8738,17404,20201212
20201209,경부선,지제,2234,2136,4370,20201212
20201209,경부선,서정리,5284,4956,10240,20201212
20201209,경부선,송탄,3301,3170,6471,20201212
20201209,경부선,진위,1352,1160,2512,20201212
20201209,경부선,오산,7640,7565,15205,20201212
20201209,경부선,오산대,2530,2408,4938,20201212
20201209,경부선,세마,2081,1905,3986,20201212
20201209,경부선,병점,10926,10798,21724,20201212
20201209,경부선,세류,2462,2319,4781,20201212
20201209,경부선,독산,15181,16172,31353,20201212
20201209,경부선,수원,25084,26513,51597,20201212
20201209,경부선,화서,6170,6052,12222,20201212
20201209,경부선,성균관대,11882,11693,23575,20201212
20201209,경부선,의왕,7691,7719,15410,20201212
20201209,경부선,군포,7087,7182,14269,20201212
20201209,경부선,금정,22539,23097,45636,20201212
20201209,경부선,명학,8397,8215,16612,20201212
20201209,경부선,안양,20105,20408,40513,20201212
20201209,경부선,관악,6384,5813,12197,20201212
20201209,경부선,석수,9093,7918,17011,20201212
20201209,경부선,금천구청,10126,10127,20253,20201212
20201209,경부선,가산디지털단지,15789,18671,34460,20201212
20201209,경부선,구로,16687,16974,33661,20201212
20201209,경부선,신길,8334,6978,15312,20201212
20201209,경부선,신도림,3610,3488,7098,20201212
20201209,경부선,영등포,29226,29949,59175,20201212
20201209,경부선,대방,10896,11347,22243,20201212
20201209,경부선,노량진,6481,6942,13423,20201212
20201209,경부선,용산,23303,23729,47032,20201212
20201209,경부선,남영,8057,8391,16448,20201212
20201209,경부선,서울역,2948,1036,3984,20201212
20201209,경강선,여주,1307,1319,2626,20201212
20201209,경강선,세종대왕릉,209,213,422,20201212
20201209,경강선,부발,1423,1375,2798,20201212
20201209,경강선,이천,1749,1875,3624,20201212
20201209,경강선,신둔도예촌,941,875,1816,20201212
20201209,경강선,곤지암,1716,1657,3373,20201212
20201209,경강선,초월,2457,2388,4845,20201212
20201209,경강선,경기광주,5636,5557,11193,20201212
20201209,경강선,삼동,1967,1825,3792,20201212
20201209,경강선,이매,841,717,1558,20201212
20201209,경강선,판교,3628,3414,7042,20201212
20201209,9호선2~3단계,중앙보훈병원,8636,7660,16296,20201212
20201209,9호선2~3단계,둔촌오륜,922,801,1723,20201212
20201209,9호선2~3단계,올림픽공원(한국체대),4381,4393,8774,20201212
20201209,9호선2~3단계,한성백제,1937,1769,3706,20201212
20201209,9호선2~3단계,송파나루,3487,3687,7174,20201212
20201209,9호선2~3단계,석촌,6295,5544,11839,20201212
20201209,9호선2~3단계,석촌고분,4688,4680,9368,20201212
20201209,9호선2~3단계,삼전,5391,5307,10698,20201212
20201209,9호선2~3단계,종합운동장,3220,3224,6444,20201212
20201209,9호선2~3단계,봉은사,12825,12857,25682,20201212
20201209,9호선2~3단계,삼성중앙,5766,5872,11638,20201212
20201209,9호선2~3단계,선정릉,7968,8489,16457,20201212
20201209,9호선2~3단계,언주,8329,8536,16865,20201212
20201209,9호선,신논현,23475,23041,46516,20201212
20201209,9호선,사평,2537,2493,5030,20201212
20201209,9호선,고속터미널,8288,10561,18849,20201212
20201209,9호선,신반포,2529,2464,4993,20201212
20201209,9호선,구반포,2162,2269,4431,20201212
20201209,9호선,동작(현충원),1406,1159,2565,20201212
20201209,9호선,흑석(중앙대입구),6084,6353,12437,20201212
20201209,9호선,노들,3672,3279,6951,20201212
20201209,9호선,노량진,19392,18821,38213,20201212
20201209,9호선,샛강,4685,4831,9516,20201212
20201209,9호선,여의도,19689,19105,38794,20201212
20201209,9호선,국회의사당,14023,14196,28219,20201212
20201209,9호선,당산,14662,14511,29173,20201212
20201209,9호선,선유도,6509,6211,12720,20201212
20201209,9호선,신목동,3161,2958,6119,20201212
20201209,9호선,염창,14147,14350,28497,20201212
20201209,9호선,등촌,9074,9120,18194,20201212
20201209,9호선,증미,6108,6226,12334,20201212
20201209,9호선,가양,16902,16746,33648,20201212
20201209,9호선,양천향교,7932,8192,16124,20201212
20201209,9호선,마곡나루(서울식물원),8811,8721,17532,20201212
20201209,9호선,신방화,5810,5625,11435,20201212
20201209,9호선,공항시장,2478,2714,5192,20201212
20201209,9호선,김포공항,5111,6664,11775,20201212
20201209,9호선,개화,2131,1539,3670,20201212
20201209,8호선,모란,4458,3416,7874,20201212
20201209,8호선,수진,4518,4146,8664,20201212
20201209,8호선,신흥,3909,4215,8124,20201212
20201209,8호선,단대오거리,9028,8693,17721,20201212
20201209,8호선,남한산성입구(성남법원.검찰청),12231,11240,23471,20201212
20201209,8호선,산성,6019,6052,12071,20201212
20201209,8호선,복정,9252,7938,17190,20201212
20201209,8호선,장지,14802,14519,29321,20201212
20201209,8호선,문정,19649,20667,40316,20201212
20201209,8호선,가락시장,6799,7530,14329,20201212
20201209,8호선,송파,6883,6830,13713,20201212
20201209,8호선,석촌,6357,7345,13702,20201212
20201209,8호선,잠실(송파구청),11058,12416,23474,20201212
20201209,8호선,몽촌토성(평화의문),4693,4836,9529,20201212
20201209,8호선,강동구청,9130,9593,18723,20201212
20201209,8호선,천호(풍납토성),12987,14578,27565,20201212
20201209,8호선,암사,16509,14624,31133,20201212
20201209,7호선,부평구청,10194,8542,18736,20201212
20201209,7호선,굴포천,7393,7860,15253,20201212
20201209,7호선,삼산체육관,4082,3784,7866,20201212
20201209,7호선,상동,10438,10819,21257,20201212
20201209,7호선,부천시청,10437,10430,20867,20201212
20201209,7호선,신중동,12257,11940,24197,20201212
20201209,7호선,춘의,8887,8836,17723,20201212
20201209,7호선,부천종합운동장,3926,3413,7339,20201212
20201209,7호선,까치울,6659,6492,13151,20201212
20201209,7호선,천왕,9632,9096,18728,20201212
20201209,7호선,광명사거리,19848,19771,39619,20201212
20201209,7호선,철산,18384,18632,37016,20201212
20201209,7호선,가산디지털단지,42761,42839,85600,20201212
20201209,7호선,남구로,14914,15980,30894,20201212
20201209,7호선,대림(구로구청),6690,6555,13245,20201212
20201209,7호선,신풍,9937,9600,19537,20201212
20201209,7호선,보라매,8569,8581,17150,20201212
20201209,7호선,신대방삼거리,14247,13883,28130,20201212
20201209,7호선,장승배기,8429,8248,16677,20201212
20201209,7호선,상도,8797,8607,17404,20201212
20201209,7호선,숭실대입구(살피재),9975,10220,20195,20201212
20201209,7호선,남성,9530,9005,18535,20201212
20201209,7호선,이수,12909,12607,25516,20201212
20201209,7호선,내방,12641,12776,25417,20201212
20201209,7호선,고속터미널,11909,10743,22652,20201212
20201209,7호선,반포,4771,4676,9447,20201212
20201209,7호선,논현,17323,18468,35791,20201212
20201209,7호선,학동,21599,22803,44402,20201212
20201209,7호선,강남구청,13976,15122,29098,20201212
20201209,7호선,청담,17250,19094,36344,20201212
20201209,7호선,뚝섬유원지,5927,5841,11768,20201212
20201209,7호선,건대입구,9675,9785,19460,20201212
20201209,7호선,어린이대공원(세종대),9631,9377,19008,20201212
20201209,7호선,군자(능동),12360,9942,22302,20201212
20201209,7호선,중곡,8917,8429,17346,20201212
20201209,7호선,용마산(용마폭포공원),5201,5002,10203,20201212
20201209,7호선,사가정,14294,14391,28685,20201212
20201209,7호선,면목,13507,13579,27086,20201212
20201209,7호선,상봉(시외버스터미널),14414,13606,28020,20201212
20201209,7호선,중화,9721,9603,19324,20201212
20201209,7호선,먹골,8675,8548,17223,20201212
20201209,7호선,태릉입구,6950,6534,13484,20201212
20201209,7호선,공릉(서울과학기술대),9581,9647,19228,20201212
20201209,7호선,하계,15332,14614,29946,20201212
20201209,7호선,중계,12509,11543,24052,20201212
20201209,7호선,노원,15390,16102,31492,20201212
20201209,7호선,마들,10507,10216,20723,20201212
20201209,7호선,수락산,10778,10990,21768,20201212
20201209,7호선,도봉산,7923,9337,17260,20201212
20201209,7호선,장암,2003,727,2730,20201212
20201209,6호선,태릉입구,4267,4860,9127,20201212
20201209,6호선,석계,10794,10936,21730,20201212
20201209,6호선,돌곶이,7374,7053,14427,20201212
20201209,6호선,상월곡(한국과학기술연구원),5366,4881,10247,20201212
20201209,6호선,월곡(동덕여대),9550,9521,19071,20201212
20201209,6호선,고려대(종암),6392,6250,12642,20201212
20201209,6호선,안암(고대병원앞),7669,7552,15221,20201212
20201209,6호선,보문,6122,5686,11808,20201212
20201209,6호선,창신,3087,2553,5640,20201212
20201209,6호선,동묘앞,6630,6641,13271,20201212
20201209,6호선,신당,6639,7002,13641,20201212
20201209,6호선,청구,3376,3623,6999,20201212
20201209,6호선,약수,2957,3026,5983,20201212
20201209,6호선,버티고개,1911,1883,3794,20201212
20201209,6호선,한강진,5424,6128,11552,20201212
20201209,6호선,이태원,6535,6719,13254,20201212
20201209,6호선,녹사평(용산구청),3445,3494,6939,20201212
20201209,6호선,삼각지,4479,3983,8462,20201212
20201209,6호선,효창공원앞,6023,5492,11515,20201212
20201209,6호선,공덕,15321,14950,30271,20201212
20201209,6호선,대흥(서강대앞),6534,6792,13326,20201212
20201209,6호선,광흥창(서강),7493,7282,14775,20201212
20201209,6호선,상수,6130,6485,12615,20201212
20201209,6호선,합정,9748,9611,19359,20201212
20201209,6호선,망원,11119,12230,23349,20201212
20201209,6호선,마포구청,12027,10816,22843,20201212
20201209,6호선,월드컵경기장(성산),3670,3826,7496,20201212
20201209,6호선,디지털미디어시티,12177,13221,25398,20201212
20201209,6호선,증산(명지대앞),8649,8618,17267,20201212
20201209,6호선,새절(신사),11146,10531,21677,20201212
20201209,6호선,구산,6304,4802,11106,20201212
20201209,6호선,독바위,2409,2644,5053,20201212
20201209,6호선,불광,3808,3850,7658,20201212
20201209,6호선,역촌,3223,3701,6924,20201212
20201209,6호선,응암,15233,15259,30492,20201212
20201209,5호선,하남풍산,4122,4053,8175,20201212
20201209,5호선,미사,11180,11144,22324,20201212
20201209,5호선,마천,5165,5191,10356,20201212
20201209,5호선,거여,6919,6624,13543,20201212
20201209,5호선,개롱,5335,5595,10930,20201212
20201209,5호선,오금,3255,3296,6551,20201212
20201209,5호선,방이,5581,5727,11308,20201212
20201209,5호선,올림픽공원(한국체대),3420,2899,6319,20201212
20201209,5호선,둔촌동,6987,7202,14189,20201212
20201209,5호선,상일동,13527,12236,25763,20201212
20201209,5호선,고덕,7498,7486,14984,20201212
20201209,5호선,명일,6917,7322,14239,20201212
20201209,5호선,굽은다리(강동구민회관앞),7925,7585,15510,20201212
20201209,5호선,길동,6640,6897,13537,20201212
20201209,5호선,강동,16976,15952,32928,20201212
20201209,5호선,천호(풍납토성),14699,14757,29456,20201212
20201209,5호선,광나루(장신대),10942,9934,20876,20201212
20201209,5호선,아차산(어린이대공원후문),12141,12023,24164,20201212
20201209,5호선,군자(능동),9334,9938,19272,20201212
20201209,5호선,장한평,16106,15936,32042,20201212
20201209,5호선,답십리,13855,12681,26536,20201212
20201209,5호선,마장,4798,4563,9361,20201212
20201209,5호선,왕십리(성동구청),3646,3925,7571,20201212
20201209,5호선,행당,6986,6281,13267,20201212
20201209,5호선,신금호,5205,5482,10687,20201212
20201209,5호선,청구,3476,3194,6670,20201212
20201209,5호선,동대문역사문화공원(DDP),2568,2861,5429,20201212
20201209,5호선,을지로4가,5371,5431,10802,20201212
20201209,5호선,종로3가,7974,7886,15860,20201212
20201209,5호선,광화문(세종문화회관),25361,26241,51602,20201212
20201209,5호선,서대문,16480,16862,33342,20201212
20201209,5호선,충정로(경기대입구),4297,4403,8700,20201212
20201209,5호선,애오개,5753,5724,11477,20201212
20201209,5호선,공덕,11803,12616,24419,20201212
20201209,5호선,마포,12181,12441,24622,20201212
20201209,5호선,여의나루,6003,6241,12244,20201212
20201209,5호선,여의도,22410,23231,45641,20201212
20201209,5호선,신길,3368,3778,7146,20201212
20201209,5호선,영등포시장,7931,8233,16164,20201212
20201209,5호선,영등포구청,3598,3626,7224,20201212
20201209,5호선,양평,6767,6663,13430,20201212
20201209,5호선,오목교(목동운동장앞),17843,19194,37037,20201212
20201209,5호선,목동,14488,16036,30524,20201212
20201209,5호선,신정(은행정),12440,9792,22232,20201212
20201209,5호선,까치산,24766,24096,48862,20201212
20201209,5호선,화곡,24469,22978,47447,20201212
20201209,5호선,우장산,11713,11689,23402,20201212
20201209,5호선,발산,15673,15896,31569,20201212
20201209,5호선,마곡,7928,7720,15648,20201212
20201209,5호선,송정,5628,5350,10978,20201212
20201209,5호선,김포공항,5063,4976,10039,20201212
20201209,5호선,개화산,4388,4318,8706,20201212
20201209,5호선,방화,5661,5373,11034,20201212
20201209,4호선,쌍문,25859,23756,49615,20201212
20201209,4호선,창동,21629,22926,44555,20201212
20201209,4호선,노원,15002,16700,31702,20201212
20201209,4호선,상계,16451,15350,31801,20201212
20201209,4호선,당고개,10663,9764,20427,20201212
20201209,4호선,남태령,959,850,1809,20201212
20201209,4호선,사당,19266,15942,35208,20201212
20201209,4호선,총신대입구(이수),15718,17010,32728,20201212
20201209,4호선,동작(현충원),2087,2169,4256,20201212
20201209,4호선,이촌(국립중앙박물관),5544,6205,11749,20201212
20201209,4호선,신용산,12123,12598,24721,20201212
20201209,4호선,삼각지,3808,4113,7921,20201212
20201209,4호선,숙대입구(갈월),10211,10048,20259,20201212
20201209,4호선,서울역,9009,11306,20315,20201212
20201209,4호선,회현(남대문시장),18648,19501,38149,20201212
20201209,4호선,명동,14046,14354,28400,20201212
20201209,4호선,충무로,23430,24014,47444,20201212
20201209,4호선,동대문역사문화공원(DDP),12455,11755,24210,20201212
20201209,4호선,동대문,17472,17786,35258,20201212
20201209,4호선,혜화,23171,23083,46254,20201212
20201209,4호선,한성대입구(삼선교),10938,10746,21684,20201212
20201209,4호선,성신여대입구(돈암),15679,15071,30750,20201212
20201209,4호선,길음,16903,16651,33554,20201212
20201209,4호선,미아사거리,23584,23180,46764,20201212
20201209,4호선,미아(서울사이버대학),13098,12823,25921,20201212
20201209,4호선,수유(강북구청),28900,28888,57788,20201212
20201209,3호선,오금,5325,4764,10089,20201212
20201209,3호선,경찰병원,6686,6657,13343,20201212
20201209,3호선,가락시장,7733,7554,15287,20201212
20201209,3호선,수서,13173,13374,26547,20201212
20201209,3호선,일원,8200,7964,16164,20201212
20201209,3호선,대청,8553,7871,16424,20201212
20201209,3호선,학여울,1434,1444,2878,20201212
20201209,3호선,대치,8557,8605,17162,20201212
20201209,3호선,도곡,4625,4584,9209,20201212
20201209,3호선,매봉,10843,10318,21161,20201212
20201209,3호선,양재(서초구청),32844,35283,68127,20201212
20201209,3호선,남부터미널(예술의전당),23598,24297,47895,20201212
20201209,3호선,교대(법원.검찰청),11778,7964,19742,20201212
20201209,3호선,고속터미널,28589,27677,56266,20201212
20201209,3호선,잠원,3792,3726,7518,20201212
20201209,3호선,신사,23494,24679,48173,20201212
20201209,3호선,압구정,25199,26909,52108,20201212
20201209,3호선,옥수,7212,7621,14833,20201212
20201209,3호선,금호,6699,6427,13126,20201212
20201209,3호선,약수,10773,10535,21308,20201212
20201209,3호선,동대입구,6008,6350,12358,20201212
20201209,3호선,을지로3가,8824,9060,17884,20201212
20201209,3호선,종로3가,8218,9118,17336,20201212
20201209,3호선,안국,14696,15043,29739,20201212
20201209,3호선,경복궁(정부서울청사),14995,14429,29424,20201212
20201209,3호선,독립문,5887,6193,12080,20201212
20201209,3호선,무악재,3331,3378,6709,20201212
20201209,3호선,홍제,15006,14482,29488,20201212
20201209,3호선,녹번,12792,11959,24751,20201212
20201209,3호선,불광,13941,14874,28815,20201212
20201209,3호선,연신내,31944,30032,61976,20201212
20201209,3호선,구파발,17445,16415,33860,20201212
20201209,3호선,지축,2801,2761,5562,20201212
20201209,2호선,용두(동대문구청),1977,2039,4016,20201212
20201209,2호선,신정네거리,8274,8725,16999,20201212
20201209,2호선,양천구청,5519,5987,11506,20201212
20201209,2호선,도림천,1143,1236,2379,20201212
20201209,2호선,신설동,2762,2714,5476,20201212
20201209,2호선,신답,1369,1610,2979,20201212
20201209,2호선,용답,2252,2251,4503,20201212
20201209,2호선,충정로(경기대입구),8847,9319,18166,20201212
20201209,2호선,아현,8528,8327,16855,20201212
20201209,2호선,이대,9175,9393,18568,20201212
20201209,2호선,신촌,22993,23886,46879,20201212
20201209,2호선,홍대입구,34398,35715,70113,20201212
20201209,2호선,합정,23229,23989,47218,20201212
20201209,2호선,당산,15767,18444,34211,20201212
20201209,2호선,영등포구청,20248,20395,40643,20201212
20201209,2호선,문래,18000,18342,36342,20201212
20201209,2호선,신도림,40118,38780,78898,20201212
20201209,2호선,대림(구로구청),22088,22476,44564,20201212
20201209,2호선,구로디지털단지,52482,53145,105627,20201212
20201209,2호선,신대방,23073,22471,45544,20201212
20201209,2호선,신림,53711,52280,105991,20201212
20201209,2호선,봉천,21080,19794,40874,20201212
20201209,2호선,서울대입구(관악구청),38285,37225,75510,20201212
20201209,2호선,낙성대(강감찬),22925,22291,45216,20201212
20201209,2호선,사당,28601,31587,60188,20201212
20201209,2호선,방배,14033,14413,28446,20201212
20201209,2호선,서초,18297,18316,36613,20201212
20201209,2호선,교대(법원.검찰청),28611,31837,60448,20201212
20201209,2호선,강남,62603,61012,123615,20201212
20201209,2호선,역삼,42704,46339,89043,20201212
20201209,2호선,선릉,49214,43930,93144,20201212
20201209,2호선,삼성(무역센터),41763,41966,83729,20201212
20201209,2호선,종합운동장,5522,5918,11440,20201212
20201209,2호선,잠실새내,15969,15882,31851,20201212
20201209,2호선,잠실(송파구청),49557,49672,99229,20201212
20201209,2호선,잠실나루,12357,11982,24339,20201212
20201209,2호선,강변(동서울터미널),23620,23366,46986,20201212
20201209,2호선,구의(광진구청),19982,19757,39739,20201212
20201209,2호선,건대입구,25051,26595,51646,20201212
20201209,2호선,성수,29495,32258,61753,20201212
20201209,2호선,뚝섬,17248,18675,35923,20201212
20201209,2호선,한양대,5848,6104,11952,20201212
20201209,2호선,왕십리(성동구청),11932,9633,21565,20201212
20201209,2호선,상왕십리,11728,11376,23104,20201212
20201209,2호선,신당,11544,11872,23416,20201212
20201209,2호선,동대문역사문화공원(DDP),9735,10585,20320,20201212
20201209,2호선,을지로4가,11581,11273,22854,20201212
20201209,2호선,을지로3가,17273,17141,34414,20201212
20201209,2호선,을지로입구,32428,32986,65414,20201212
20201209,2호선,시청,20058,19655,39713,20201212
20201209,1호선,청량리(서울시립대입구),16994,16835,33829,20201212
20201209,1호선,제기동,14443,14755,29198,20201212
20201209,1호선,신설동,12272,12187,24459,20201212
20201209,1호선,동대문,9176,8928,18104,20201212
20201209,1호선,종로5가,18286,18072,36358,20201212
20201209,1호선,종로3가,18398,16795,35193,20201212
20201209,1호선,종각,27727,26935,54662,20201212
20201209,1호선,시청,17951,17718,35669,20201212
20201209,1호선,동묘앞,6765,6917,13682,20201212
20201209,1호선,서울역,32241,30033,62274,20201212
20201209,과천선,인덕원,20406,21361,41767,20201212
20201209,과천선,평촌,15518,15476,30994,20201212
20201209,과천선,범계,20634,20187,40821,20201212
20201209,분당선,선릉,11991,17446,29437,20201212
20201209,분당선,한티,11390,12243,23633,20201212
20201209,분당선,도곡,5398,5450,10848,20201212
20201209,분당선,구룡,1395,1365,2760,20201212
20201209,분당선,개포동,2960,3028,5988,20201212
20201209,분당선,대모산입구,3080,2919,5999,20201212
20201209,분당선,수서,10188,10784,20972,20201212
20201209,분당선,수원,6194,4967,11161,20201212
20201209,공항철도 1호선,검암,6011,5795,11806,20201212
20201209,공항철도 1호선,청라국제도시,5444,5046,10490,20201212
20201209,공항철도 1호선,운서,4828,4902,9730,20201212
20201209,공항철도 1호선,공항화물청사,2109,2365,4474,20201212
20201209,공항철도 1호선,인천공항1터미널,2919,2997,5916,20201212
20201209,공항철도 1호선,인천공항2터미널,1643,1595,3238,20201212
20201209,공항철도 1호선,영종,2168,2219,4387,20201212
20201209,과천선,선바위,7317,6534,13851,20201212
20201209,과천선,경마공원,1090,1110,2200,20201212
20201209,과천선,대공원,1454,1582,3036,20201212
20201209,과천선,과천,4336,3938,8274,20201212
20201209,과천선,정부과천청사,7957,7830,15787,20201212
20201209,분당선,매교,2342,2439,4781,20201212
20201209,수인선,고색,2707,2619,5326,20201212
20201209,수인선,오목천,1933,1841,3774,20201212
20201209,수인선,어천,414,441,855,20201212
20201209,수인선,야목,142,121,263,20201212
20201209,수인선,사리,2817,2706,5523,20201212
20201209,수인선,달월,67,42,109,20201212
20201209,수인선,월곶,2021,1939,3960,20201212
20201209,수인선,소래포구,3752,3571,7323,20201212
20201209,수인선,인천논현,4546,4785,9331,20201212
20201209,수인선,호구포,3296,3367,6663,20201212
20201209,수인선,남동인더스파크,2259,2499,4758,20201212
20201209,수인선,원인재,3663,3781,7444,20201212
20201209,수인선,연수,3665,3684,7349,20201212
20201209,수인선,송도,2050,1949,3999,20201212
20201209,수인선,인하대,4849,4595,9444,20201212
20201209,수인선,숭의,3400,3199,6599,20201212
20201209,수인선,신포,1462,1452,2914,20201212
20201209,수인선,인천,792,1265,2057,20201212
20201209,안산선,산본,13079,14055,27134,20201212
20201209,안산선,대야미,4151,3789,7940,20201212
20201209,안산선,반월,3658,3501,7159,20201212
20201209,안산선,상록수,13965,14151,28116,20201212
20201209,안산선,한대앞,7168,7218,14386,20201212
20201209,안산선,중앙,13211,13634,26845,20201212
20201209,안산선,고잔,7376,7158,14534,20201212
20201209,안산선,초지,3802,4049,7851,20201212
20201209,안산선,안산,10462,9381,19843,20201212
20201209,안산선,신길온천,1404,1293,2697,20201212
20201209,안산선,정왕,7776,8152,15928,20201212
20201209,안산선,오이도,7027,6748,13775,20201212
20201209,안산선,수리산,3751,3106,6857,20201212
20201209,우이신설선,북한산우이,2005,1832,3837,20201212
20201209,우이신설선,솔밭공원,2060,2006,4066,20201212
20201209,우이신설선,4.19민주묘지,2301,2315,4616,20201212
20201209,우이신설선,가오리,3431,3493,6924,20201212
20201209,우이신설선,삼양,1716,1889,3605,20201212
20201209,우이신설선,삼양사거리,2038,2076,4114,20201212
20201209,우이신설선,솔샘,4886,4714,9600,20201212
20201209,우이신설선,북한산보국문,4846,4797,9643,20201212
20201209,우이신설선,정릉,3651,3561,7212,20201212
20201209,우이신설선,성신여대입구(돈암),2490,2640,5130,20201212
20201209,우이신설선,보문,1234,1303,2537,20201212
20201209,6호선,봉화산(서울의료원),7768,7227,14995,20201212
20201209,6호선,화랑대(서울여대입구),9979,7910,17889,20201212
20201210,분당선,복정,1,0,1,20201213
20201210,중앙선,양평,1705,1697,3402,20201213
20201210,중앙선,오빈,216,227,443,20201213
20201210,중앙선,아신,364,362,726,20201213
20201210,중앙선,국수,468,495,963,20201213
20201210,중앙선,신원,148,133,281,20201213
20201210,중앙선,양수,1317,1291,2608,20201213
20201210,중앙선,운길산,502,477,979,20201213
20201210,중앙선,팔당,702,659,1361,20201213
20201210,중앙선,도심,2092,1578,3670,20201213
20201210,중앙선,덕소,4787,4832,9619,20201213
20201210,중앙선,양정,693,595,1288,20201213
20201210,중앙선,도농,8356,7666,16022,20201213
20201210,중앙선,구리,11275,11549,22824,20201213
20201210,중앙선,양원,1490,1502,2992,20201213
20201210,중앙선,망우,6447,6275,12722,20201213
20201210,중앙선,상봉(시외버스터미널),4925,4857,9782,20201213
20201210,중앙선,중랑,4644,4453,9097,20201213
20201210,중앙선,회기,18867,18374,37241,20201213
20201210,장항선,신창(순천향대),855,767,1622,20201213
20201210,장항선,온양온천,2541,2544,5085,20201213
20201210,장항선,배방,733,715,1448,20201213
20201210,장항선,아산,1907,1845,3752,20201213
20201210,장항선,쌍용(나사렛대),1741,1576,3317,20201213
20201210,장항선,봉명,1009,992,2001,20201213
20201210,일산선,대화,10870,8499,19369,20201213
20201210,일산선,주엽,7124,7251,14375,20201213
20201210,일산선,정발산,5511,5381,10892,20201213
20201210,일산선,마두,6100,6323,12423,20201213
20201210,일산선,백석,8520,8583,17103,20201213
20201210,일산선,대곡,1438,1087,2525,20201213
20201210,일산선,화정,13755,14114,27869,20201213
20201210,일산선,원당,9447,9057,18504,20201213
20201210,일산선,삼송,15186,15149,30335,20201213
20201210,일산선,원흥,7795,7627,15422,20201213
20201210,우이신설선,신설동,2004,1905,3909,20201213
20201210,우이신설선,보문,1280,1404,2684,20201213
20201210,우이신설선,성신여대입구(돈암),2408,2575,4983,20201213
20201210,우이신설선,정릉,3665,3648,7313,20201213
20201210,우이신설선,북한산보국문,4762,4738,9500,20201213
20201210,우이신설선,솔샘,4717,4542,9259,20201213
20201210,우이신설선,삼양사거리,2015,2121,4136,20201213
20201210,우이신설선,삼양,1781,1911,3692,20201213
20201210,우이신설선,화계,2882,2708,5590,20201213
20201210,우이신설선,가오리,3460,3449,6909,20201213
20201210,우이신설선,4.19민주묘지,2200,2218,4418,20201213
20201210,우이신설선,솔밭공원,2030,2014,4044,20201213
20201210,우이신설선,북한산우이,2039,1839,3878,20201213
20201210,안산선,수리산,3744,3024,6768,20201213
20201210,안산선,오이도,6952,6776,13728,20201213
20201210,안산선,정왕,7397,7896,15293,20201213
20201210,안산선,신길온천,1431,1309,2740,20201213
20201210,안산선,안산,10440,9368,19808,20201213
20201210,안산선,초지,3859,3957,7816,20201213
20201210,안산선,고잔,7311,7054,14365,20201213
20201210,안산선,중앙,13097,13538,26635,20201213
20201210,안산선,한대앞,6952,7082,14034,20201213
20201210,안산선,상록수,14123,14242,28365,20201213
20201210,안산선,반월,3668,3597,7265,20201213
20201210,안산선,대야미,4134,3800,7934,20201213
20201210,안산선,산본,13128,13971,27099,20201213
20201210,수인선,인천,804,1316,2120,20201213
20201210,수인선,신포,1452,1479,2931,20201213
20201210,수인선,숭의,3381,3273,6654,20201213
20201210,수인선,인하대,4850,4548,9398,20201213
20201210,수인선,송도,2054,1858,3912,20201213
20201210,수인선,연수,3616,3556,7172,20201213
20201210,수인선,원인재,3642,3769,7411,20201213
20201210,수인선,남동인더스파크,2148,2384,4532,20201213
20201210,수인선,호구포,3255,3342,6597,20201213
20201210,수인선,인천논현,4582,4825,9407,20201213
20201210,수인선,소래포구,3807,3679,7486,20201213
20201210,수인선,월곶,1982,1917,3899,20201213
20201210,수인선,달월,80,57,137,20201213
20201210,수인선,사리,2853,2643,5496,20201213
20201210,수인선,야목,158,152,310,20201213
20201210,수인선,어천,436,424,860,20201213
20201210,수인선,오목천,1983,1888,3871,20201213
20201210,수인선,고색,2733,2677,5410,20201213
20201210,분당선,매교,2341,2479,4820,20201213
20201210,분당선,수원시청,9754,10203,19957,20201213
20201210,분당선,매탄권선,3792,3796,7588,20201213
20201210,분당선,망포,11418,10893,22311,20201213
20201210,분당선,영통,6137,6506,12643,20201213
20201210,분당선,청명,3486,3264,6750,20201213
20201210,분당선,상갈,4310,4166,8476,20201213
20201210,분당선,기흥,7619,7303,14922,20201213
20201210,분당선,신갈,3714,3705,7419,20201213
20201210,분당선,구성,4042,4199,8241,20201213
20201210,분당선,죽전,10670,11644,22314,20201213
20201210,분당선,보정,1952,1661,3613,20201213
20201210,분당선,이매,4319,4071,8390,20201213
20201210,분당선,오리,9890,8497,18387,20201213
20201210,분당선,미금,12429,13208,25637,20201213
20201210,분당선,정자,12983,13716,26699,20201213
20201210,분당선,수내,10466,10496,20962,20201213
20201210,분당선,서현,19074,19390,38464,20201213
20201210,분당선,야탑,20904,21907,42811,20201213
20201210,분당선,모란,16765,17082,33847,20201213
20201210,분당선,태평,11399,11044,22443,20201213
20201210,분당선,가천대,7163,7948,15111,20201213
20201210,분당선,선정릉,6891,7401,14292,20201213
20201210,분당선,강남구청,8006,9063,17069,20201213
20201210,분당선,압구정로데오,13884,15145,29029,20201213
20201210,분당선,서울숲,6958,7037,13995,20201213
20201210,분당선,수원,6268,4924,11192,20201213
20201210,분당선,수서,10342,10794,21136,20201213
20201210,분당선,대모산입구,3148,2993,6141,20201213
20201210,분당선,개포동,2873,2988,5861,20201213
20201210,분당선,구룡,1385,1379,2764,20201213
20201210,분당선,도곡,5548,5396,10944,20201213
20201210,분당선,한티,11342,12133,23475,20201213
20201210,분당선,선릉,11900,17541,29441,20201213
20201210,과천선,범계,20856,20217,41073,20201213
20201210,과천선,평촌,15595,15618,31213,20201213
20201210,과천선,인덕원,20192,21008,41200,20201213
20201210,과천선,정부과천청사,8037,7999,16036,20201213
20201210,과천선,과천,4243,3976,8219,20201213
20201210,과천선,대공원,1495,1579,3074,20201213
20201210,과천선,경마공원,1122,1121,2243,20201213
20201210,과천선,선바위,7218,6430,13648,20201213
20201210,공항철도 1호선,영종,2282,2267,4549,20201213
20201210,공항철도 1호선,인천공항2터미널,1700,1611,3311,20201213
20201210,공항철도 1호선,인천공항1터미널,3004,3180,6184,20201213
20201210,공항철도 1호선,공항화물청사,2204,2438,4642,20201213
20201210,공항철도 1호선,운서,4932,4925,9857,20201213
20201210,공항철도 1호선,청라국제도시,5574,5188,10762,20201213
20201210,공항철도 1호선,검암,6099,5976,12075,20201213
20201210,공항철도 1호선,계양,7921,7370,15291,20201213
20201210,공항철도 1호선,김포공항,7676,5477,13153,20201213
20201210,공항철도 1호선,마곡나루(서울식물원),6191,5892,12083,20201213
20201210,공항철도 1호선,디지털미디어시티,11612,10438,22050,20201213
20201210,공항철도 1호선,홍대입구,5849,5966,11815,20201213
20201210,공항철도 1호선,공덕,1785,2201,3986,20201213
20201210,공항철도 1호선,서울역,5098,4576,9674,20201213
20201210,경춘선,춘천,819,769,1588,20201213
20201210,경춘선,남춘천,1993,1860,3853,20201213
20201210,경춘선,김유정,208,216,424,20201213
20201210,경춘선,강촌,268,274,542,20201213
20201210,경춘선,백양리,99,90,189,20201213
20201210,경춘선,굴봉산,64,69,133,20201213
20201210,경춘선,가평,1040,1033,2073,20201213
20201210,경춘선,상천,194,178,372,20201213
20201210,경춘선,청평,1072,1128,2200,20201213
20201210,경춘선,대성리,401,326,727,20201213
20201210,경춘선,마석,3167,3141,6308,20201213
20201210,경춘선,천마산,1345,1271,2616,20201213
20201210,경춘선,평내호평,4810,4874,9684,20201213
20201210,경춘선,금곡,1276,1257,2533,20201213
20201210,경춘선,사릉,3002,2934,5936,20201213
20201210,경춘선,퇴계원,3021,2815,5836,20201213
20201210,경춘선,별내,2388,2292,4680,20201213
20201210,경춘선,갈매,2626,2258,4884,20201213
20201210,경춘선,신내,1388,1362,2750,20201213
20201210,경인선,도화,3389,3126,6515,20201213
20201210,경인선,중동,7925,7495,15420,20201213
20201210,경인선,온수(성공회대입구),5620,5530,11150,20201213
20201210,경인선,도원,2647,2658,5305,20201213
20201210,경인선,간석,4964,4739,9703,20201213
20201210,경인선,부개,7238,6928,14166,20201213
20201210,경인선,소사,8195,7693,15888,20201213
20201210,경인선,구일,5143,5358,10501,20201213
20201210,경인선,인천,2750,1933,4683,20201213
20201210,경인선,동인천,11598,10948,22546,20201213
20201210,경인선,제물포,8590,8406,16996,20201213
20201210,경인선,주안,15896,14639,30535,20201213
20201210,경인선,동암,13154,13242,26396,20201213
20201210,경인선,백운,6242,6111,12353,20201213
20201210,경인선,부평,23783,25237,49020,20201213
20201210,경인선,송내,23880,23913,47793,20201213
20201210,경인선,부천,27401,27758,55159,20201213
20201210,경인선,역곡,23007,22839,45846,20201213
20201210,경인선,오류동,10017,9532,19549,20201213
20201210,경인선,개봉,18544,19134,37678,20201213
20201210,경의선,임진강,18,7,25,20201213
20201210,경의선,문산,3875,3857,7732,20201213
20201210,경의선,파주,1189,908,2097,20201213
20201210,경의선,월롱,1733,1602,3335,20201213
20201210,경의선,금촌,5060,5148,10208,20201213
20201210,경의선,금릉,3664,3554,7218,20201213
20201210,경의선,운정,5098,4902,10000,20201213
20201210,경의선,야당,5006,4831,9837,20201213
20201210,경의선,탄현,6146,6013,12159,20201213
20201210,경의선,일산,7584,7607,15191,20201213
20201210,경의선,풍산,4333,4103,8436,20201213
20201210,경의선,백마,5466,5266,10732,20201213
20201210,경의선,곡산,481,497,978,20201213
20201210,경의선,능곡,3164,2854,6018,20201213
20201210,경의선,행신,6342,6460,12802,20201213
20201210,경의선,강매,2643,2297,4940,20201213
20201210,경의선,화전,1277,1160,2437,20201213
20201210,경의선,수색,2233,2304,4537,20201213
20201210,경의선,디지털미디어시티,1985,1919,3904,20201213
20201210,경의선,가좌,4530,4114,8644,20201213
20201210,경의선,홍대입구,1216,1314,2530,20201213
20201210,경의선,서강대,1507,1473,2980,20201213
20201210,경의선,공덕,2693,2500,5193,20201213
20201210,경의선,효창공원앞,2434,2759,5193,20201213
20201210,경의선,신촌,672,870,1542,20201213
20201210,경의선,서울역,3465,4289,7754,20201213
20201210,경원선,소요산,2081,1751,3832,20201213
20201210,경원선,동두천,1774,2004,3778,20201213
20201210,경원선,보산,1239,1155,2394,20201213
20201210,경원선,동두천중앙,2768,2637,5405,20201213
20201210,경원선,지행,5061,5064,10125,20201213
20201210,경원선,덕정,4756,4760,9516,20201213
20201210,경원선,덕계,2326,2097,4423,20201213
20201210,경원선,양주,6159,5765,11924,20201213
20201210,경원선,녹양,3953,3786,7739,20201213
20201210,경원선,가능,5473,5330,10803,20201213
20201210,경원선,의정부,14554,14723,29277,20201213
20201210,경원선,회룡,10547,10528,21075,20201213
20201210,경원선,망월사,6019,6197,12216,20201213
20201210,경원선,도봉산,6529,3906,10435,20201213
20201210,경원선,도봉,5256,4991,10247,20201213
20201210,경원선,방학,8102,7950,16052,20201213
20201210,경원선,녹천,4191,3503,7694,20201213
20201210,경원선,월계,5455,5220,10675,20201213
20201210,경원선,광운대,7917,7484,15401,20201213
20201210,경원선,석계,6982,8019,15001,20201213
20201210,경원선,신이문,7307,6930,14237,20201213
20201210,경원선,외대앞,5705,5667,11372,20201213
20201210,경원선,청량리(서울시립대입구),10909,11821,22730,20201213
20201210,경원선,왕십리(성동구청),10507,11906,22413,20201213
20201210,경원선,응봉,1570,1283,2853,20201213
20201210,경원선,옥수,33,25,58,20201213
20201210,경원선,한남,3762,3466,7228,20201213
20201210,경원선,서빙고,1578,1463,3041,20201213
20201210,경원선,이촌(국립중앙박물관),3079,2391,5470,20201213
20201210,경부선,광명,2469,2295,4764,20201213
20201210,경부선,서동탄,1257,1040,2297,20201213
20201210,경부선,당정,5358,5129,10487,20201213
20201210,경부선,천안,3599,3644,7243,20201213
20201210,경부선,두정,4087,4033,8120,20201213
20201210,경부선,직산,576,628,1204,20201213
20201210,경부선,성환,3391,3348,6739,20201213
20201210,경부선,평택,8930,8750,17680,20201213
20201210,경부선,지제,2187,2089,4276,20201213
20201210,경부선,서정리,5123,4862,9985,20201213
20201210,경부선,송탄,3331,3193,6524,20201213
20201210,경부선,진위,1271,1168,2439,20201213
20201210,경부선,오산,7595,7510,15105,20201213
20201210,경부선,오산대,2555,2375,4930,20201213
20201210,경부선,세마,2113,1915,4028,20201213
20201210,경부선,병점,10627,10644,21271,20201213
20201210,경부선,세류,2592,2383,4975,20201213
20201210,경부선,독산,15160,16152,31312,20201213
20201210,경부선,수원,25208,26722,51930,20201213
20201210,경부선,화서,6235,6082,12317,20201213
20201210,경부선,성균관대,11709,11707,23416,20201213
20201210,경부선,의왕,7718,7591,15309,20201213
20201210,경부선,군포,7050,7063,14113,20201213
20201210,경부선,금정,22338,23043,45381,20201213
20201210,경부선,명학,8291,8340,16631,20201213
20201210,경부선,안양,20067,20306,40373,20201213
20201210,경부선,관악,6268,5784,12052,20201213
20201210,경부선,석수,9067,7849,16916,20201213
20201210,경부선,금천구청,10143,10122,20265,20201213
20201210,경부선,가산디지털단지,15853,18691,34544,20201213
20201210,경부선,구로,16548,16755,33303,20201213
20201210,경부선,신길,8270,6834,15104,20201213
20201210,경부선,신도림,3555,3515,7070,20201213
20201210,경부선,영등포,29358,30632,59990,20201213
20201210,경부선,대방,11173,11352,22525,20201213
20201210,경부선,노량진,6553,6915,13468,20201213
20201210,경부선,용산,24109,24509,48618,20201213
20201210,경부선,남영,8044,8398,16442,20201213
20201210,경부선,서울역,3249,1101,4350,20201213
20201210,경강선,여주,1284,1288,2572,20201213
20201210,경강선,세종대왕릉,216,190,406,20201213
20201210,경강선,부발,1432,1382,2814,20201213
20201210,경강선,이천,1775,1848,3623,20201213
20201210,경강선,신둔도예촌,912,858,1770,20201213
20201210,경강선,곤지암,1694,1709,3403,20201213
20201210,경강선,초월,2460,2422,4882,20201213
20201210,경강선,경기광주,5650,5468,11118,20201213
20201210,경강선,삼동,1903,1768,3671,20201213
20201210,경강선,이매,831,743,1574,20201213
20201210,경강선,판교,3618,3433,7051,20201213
20201210,9호선2~3단계,중앙보훈병원,8485,7434,15919,20201213
20201210,9호선2~3단계,둔촌오륜,909,791,1700,20201213
20201210,9호선2~3단계,올림픽공원(한국체대),4203,4259,8462,20201213
20201210,9호선2~3단계,한성백제,1928,1774,3702,20201213
20201210,9호선2~3단계,송파나루,3554,3595,7149,20201213
20201210,9호선2~3단계,석촌,6139,5473,11612,20201213
20201210,9호선2~3단계,석촌고분,4789,4806,9595,20201213
20201210,9호선2~3단계,삼전,5432,5298,10730,20201213
20201210,9호선2~3단계,종합운동장,3308,3205,6513,20201213
20201210,9호선2~3단계,봉은사,12845,13009,25854,20201213
20201210,9호선2~3단계,삼성중앙,5606,5880,11486,20201213
20201210,9호선2~3단계,선정릉,7964,8618,16582,20201213
20201210,9호선2~3단계,언주,8324,8478,16802,20201213
20201210,9호선,신논현,23774,23256,47030,20201213
20201210,9호선,사평,2536,2539,5075,20201213
20201210,9호선,고속터미널,8314,10446,18760,20201213
20201210,9호선,신반포,2461,2417,4878,20201213
20201210,9호선,구반포,2157,2236,4393,20201213
20201210,9호선,동작(현충원),1376,1101,2477,20201213
20201210,9호선,흑석(중앙대입구),6252,6386,12638,20201213
20201210,9호선,노들,3660,3241,6901,20201213
20201210,9호선,노량진,19179,18510,37689,20201213
20201210,9호선,샛강,4754,4811,9565,20201213
20201210,9호선,여의도,19494,19033,38527,20201213
20201210,9호선,국회의사당,13747,13994,27741,20201213
20201210,9호선,당산,14730,14431,29161,20201213
20201210,9호선,선유도,6300,6076,12376,20201213
20201210,9호선,신목동,3179,2924,6103,20201213
20201210,9호선,염창,14503,14206,28709,20201213
20201210,9호선,등촌,9332,9298,18630,20201213
20201210,9호선,증미,6196,6286,12482,20201213
20201210,9호선,가양,17101,16696,33797,20201213
20201210,9호선,양천향교,7858,8262,16120,20201213
20201210,9호선,마곡나루(서울식물원),8763,8779,17542,20201213
20201210,9호선,신방화,5736,5634,11370,20201213
20201210,9호선,공항시장,2407,2645,5052,20201213
20201210,9호선,김포공항,5324,7549,12873,20201213
20201210,9호선,개화,2140,1573,3713,20201213
20201210,8호선,모란,3606,2733,6339,20201213
20201210,8호선,수진,4345,3920,8265,20201213
20201210,8호선,신흥,3949,4130,8079,20201213
20201210,8호선,단대오거리,8950,8537,17487,20201213
20201210,8호선,남한산성입구(성남법원.검찰청),12158,11351,23509,20201213
20201210,8호선,산성,5827,5820,11647,20201213
20201210,8호선,복정,8943,7774,16717,20201213
20201210,8호선,장지,14672,14408,29080,20201213
20201210,8호선,문정,19559,20495,40054,20201213
20201210,8호선,가락시장,6912,7745,14657,20201213
20201210,8호선,송파,6781,6807,13588,20201213
20201210,8호선,석촌,6187,7029,13216,20201213
20201210,8호선,잠실(송파구청),11188,12631,23819,20201213
20201210,8호선,몽촌토성(평화의문),4753,4873,9626,20201213
20201210,8호선,강동구청,9091,9635,18726,20201213
20201210,8호선,천호(풍납토성),13235,14549,27784,20201213
20201210,8호선,암사,16320,14594,30914,20201213
20201210,7호선,부평구청,10204,8472,18676,20201213
20201210,7호선,굴포천,7458,7730,15188,20201213
20201210,7호선,삼산체육관,4019,3687,7706,20201213
20201210,7호선,상동,10216,10652,20868,20201213
20201210,7호선,부천시청,10440,10424,20864,20201213
20201210,7호선,신중동,12273,11995,24268,20201213
20201210,7호선,춘의,8955,8794,17749,20201213
20201210,7호선,부천종합운동장,3981,3477,7458,20201213
20201210,7호선,까치울,6602,6390,12992,20201213
20201210,7호선,온수(성공회대입구),9503,8794,18297,20201213
20201210,7호선,천왕,9746,9299,19045,20201213
20201210,7호선,광명사거리,19744,19719,39463,20201213
20201210,7호선,철산,18332,18747,37079,20201213
20201210,7호선,가산디지털단지,42460,42540,85000,20201213
20201210,7호선,남구로,14771,15756,30527,20201213
20201210,7호선,대림(구로구청),6839,6733,13572,20201213
20201210,7호선,신풍,9949,9627,19576,20201213
20201210,7호선,보라매,8817,8760,17577,20201213
20201210,7호선,신대방삼거리,14276,13896,28172,20201213
20201210,7호선,장승배기,8322,8171,16493,20201213
20201210,7호선,상도,8745,8545,17290,20201213
20201210,7호선,숭실대입구(살피재),10299,10559,20858,20201213
20201210,7호선,남성,9786,9069,18855,20201213
20201210,7호선,이수,12725,12651,25376,20201213
20201210,7호선,내방,12640,12689,25329,20201213
20201210,7호선,고속터미널,12049,10877,22926,20201213
20201210,7호선,반포,4899,4737,9636,20201213
20201210,7호선,논현,17125,18713,35838,20201213
20201210,7호선,학동,21722,23046,44768,20201213
20201210,7호선,강남구청,14075,15241,29316,20201213
20201210,7호선,청담,17234,18937,36171,20201213
20201210,7호선,뚝섬유원지,6143,6044,12187,20201213
20201210,7호선,건대입구,9695,9789,19484,20201213
20201210,7호선,어린이대공원(세종대),9680,9527,19207,20201213
20201210,7호선,군자(능동),12584,9909,22493,20201213
20201210,7호선,중곡,8799,8295,17094,20201213
20201210,7호선,용마산(용마폭포공원),5247,5002,10249,20201213
20201210,7호선,사가정,14347,14497,28844,20201213
20201210,7호선,면목,13535,13434,26969,20201213
20201210,7호선,상봉(시외버스터미널),14586,13800,28386,20201213
20201210,7호선,중화,9600,9472,19072,20201213
20201210,7호선,먹골,8768,8598,17366,20201213
20201210,7호선,태릉입구,6852,6437,13289,20201213
20201210,7호선,공릉(서울과학기술대),9939,9820,19759,20201213
20201210,7호선,하계,14990,14454,29444,20201213
20201210,7호선,중계,12657,11615,24272,20201213
20201210,7호선,노원,15432,16196,31628,20201213
20201210,7호선,마들,10518,10204,20722,20201213
20201210,7호선,수락산,10699,10784,21483,20201213
20201210,7호선,도봉산,7911,9407,17318,20201213
20201210,7호선,장암,2058,810,2868,20201213
20201210,6호선,봉화산(서울의료원),7796,7272,15068,20201213
20201210,6호선,화랑대(서울여대입구),9742,7796,17538,20201213
20201210,6호선,태릉입구,4460,4921,9381,20201213
20201210,6호선,석계,10755,11035,21790,20201213
20201210,6호선,돌곶이,7278,6876,14154,20201213
20201210,6호선,상월곡(한국과학기술연구원),5400,4867,10267,20201213
20201210,6호선,월곡(동덕여대),9552,9504,19056,20201213
20201210,6호선,고려대(종암),6294,6184,12478,20201213
20201210,6호선,안암(고대병원앞),7717,7722,15439,20201213
20201210,6호선,보문,6169,5788,11957,20201213
20201210,6호선,창신,3031,2396,5427,20201213
20201210,6호선,동묘앞,6566,6660,13226,20201213
20201210,6호선,신당,6688,7052,13740,20201213
20201210,1호선,서울역,32360,30336,62696,20201213
20201210,6호선,청구,3304,3574,6878,20201213
20201210,6호선,약수,3120,3096,6216,20201213
20201210,6호선,버티고개,1920,1879,3799,20201213
20201210,6호선,한강진,5527,6178,11705,20201213
20201210,6호선,이태원,6692,6826,13518,20201213
20201210,6호선,녹사평(용산구청),3572,3450,7022,20201213
20201210,6호선,삼각지,4597,4021,8618,20201213
20201210,6호선,효창공원앞,6069,5518,11587,20201213
20201210,6호선,공덕,15366,14931,30297,20201213
20201210,6호선,대흥(서강대앞),6403,6623,13026,20201213
20201210,6호선,광흥창(서강),7283,7160,14443,20201213
20201210,6호선,상수,6413,6724,13137,20201213
20201210,6호선,합정,9760,9719,19479,20201213
20201210,6호선,망원,11145,12120,23265,20201213
20201210,6호선,마포구청,11936,10685,22621,20201213
20201210,6호선,월드컵경기장(성산),3614,3839,7453,20201213
20201210,6호선,디지털미디어시티,12157,13264,25421,20201213
20201210,6호선,증산(명지대앞),8830,8684,17514,20201213
20201210,6호선,새절(신사),11087,10417,21504,20201213
20201210,6호선,구산,6180,4837,11017,20201213
20201210,6호선,연신내,1,0,1,20201213
20201210,6호선,독바위,2388,2578,4966,20201213
20201210,6호선,불광,3668,3766,7434,20201213
20201210,6호선,역촌,3182,3663,6845,20201213
20201210,6호선,응암,15098,14946,30044,20201213
20201210,5호선,하남풍산,4142,4109,8251,20201213
20201210,5호선,미사,11043,11082,22125,20201213
20201210,5호선,마천,5152,5123,10275,20201213
20201210,5호선,거여,6867,6582,13449,20201213
20201210,5호선,개롱,5231,5575,10806,20201213
20201210,5호선,오금,3278,3259,6537,20201213
20201210,5호선,방이,5563,5848,11411,20201213
20201210,5호선,올림픽공원(한국체대),3352,2946,6298,20201213
20201210,5호선,둔촌동,7074,7036,14110,20201213
20201210,5호선,상일동,13926,12322,26248,20201213
20201210,5호선,고덕,7404,7263,14667,20201213
20201210,5호선,명일,7078,7292,14370,20201213
20201210,5호선,굽은다리(강동구민회관앞),8033,7668,15701,20201213
20201210,5호선,길동,6576,6946,13522,20201213
20201210,5호선,강동,16970,15859,32829,20201213
20201210,5호선,천호(풍납토성),14807,14837,29644,20201213
20201210,5호선,광나루(장신대),11046,9980,21026,20201213
20201210,5호선,아차산(어린이대공원후문),12180,12065,24245,20201213
20201210,5호선,군자(능동),9186,9981,19167,20201213
20201210,5호선,장한평,16046,15803,31849,20201213
20201210,5호선,답십리,13857,12764,26621,20201213
20201210,5호선,마장,4786,4432,9218,20201213
20201210,5호선,왕십리(성동구청),3650,3951,7601,20201213
20201210,5호선,행당,6889,6160,13049,20201213
20201210,5호선,신금호,5111,5437,10548,20201213
20201210,5호선,청구,3559,3209,6768,20201213
20201210,5호선,동대문역사문화공원(DDP),2574,2899,5473,20201213
20201210,5호선,을지로4가,5408,5461,10869,20201213
20201210,5호선,종로3가,7886,7702,15588,20201213
20201210,5호선,광화문(세종문화회관),25482,26419,51901,20201213
20201210,5호선,서대문,16495,16919,33414,20201213
20201210,5호선,충정로(경기대입구),4165,4332,8497,20201213
20201210,5호선,애오개,5722,5789,11511,20201213
20201210,5호선,공덕,11833,12607,24440,20201213
20201210,5호선,마포,11914,12316,24230,20201213
20201210,5호선,여의나루,6066,6230,12296,20201213
20201210,5호선,여의도,22231,23340,45571,20201213
20201210,5호선,신길,3420,3714,7134,20201213
20201210,5호선,영등포시장,7840,8124,15964,20201213
20201210,5호선,영등포구청,3702,3647,7349,20201213
20201210,5호선,양평,6586,6670,13256,20201213
20201210,5호선,오목교(목동운동장앞),17852,19393,37245,20201213
20201210,5호선,목동,14687,16191,30878,20201213
20201210,5호선,신정(은행정),12353,9716,22069,20201213
20201210,5호선,까치산,24937,24159,49096,20201213
20201210,5호선,화곡,24654,23245,47899,20201213
20201210,5호선,우장산,11695,11620,23315,20201213
20201210,5호선,발산,15445,15671,31116,20201213
20201210,5호선,마곡,7775,7654,15429,20201213
20201210,5호선,송정,5676,5259,10935,20201213
20201210,5호선,김포공항,5242,5177,10419,20201213
20201210,5호선,개화산,4354,4263,8617,20201213
20201210,5호선,방화,5951,5606,11557,20201213
20201210,4호선,쌍문,25717,23690,49407,20201213
20201210,4호선,창동,21775,23090,44865,20201213
20201210,4호선,노원,14995,16782,31777,20201213
20201210,4호선,상계,16557,15463,32020,20201213
20201210,4호선,당고개,10583,9644,20227,20201213
20201210,4호선,남태령,941,833,1774,20201213
20201210,4호선,사당,19173,16097,35270,20201213
20201210,4호선,총신대입구(이수),15618,16832,32450,20201213
20201210,4호선,동작(현충원),2041,2151,4192,20201213
20201210,4호선,이촌(국립중앙박물관),5565,6106,11671,20201213
20201210,4호선,신용산,12207,12910,25117,20201213
20201210,4호선,삼각지,3845,4170,8015,20201213
20201210,4호선,숙대입구(갈월),10355,10216,20571,20201213
20201210,4호선,서울역,9198,11549,20747,20201213
20201210,4호선,회현(남대문시장),18409,19231,37640,20201213
20201210,4호선,명동,14049,14506,28555,20201213
20201210,4호선,충무로,23253,24056,47309,20201213
20201210,4호선,동대문역사문화공원(DDP),12622,11726,24348,20201213
20201210,4호선,동대문,17136,17538,34674,20201213
20201210,4호선,혜화,23103,22840,45943,20201213
20201210,4호선,한성대입구(삼선교),10977,10787,21764,20201213
20201210,4호선,성신여대입구(돈암),15712,14998,30710,20201213
20201210,4호선,길음,16899,16522,33421,20201213
20201210,4호선,미아사거리,23410,22884,46294,20201213
20201210,4호선,미아(서울사이버대학),13010,12789,25799,20201213
20201210,4호선,수유(강북구청),29139,28943,58082,20201213
20201210,3호선,오금,5374,4837,10211,20201213
20201210,3호선,경찰병원,6542,6585,13127,20201213
20201210,3호선,가락시장,7851,7623,15474,20201213
20201210,3호선,수서,13118,13391,26509,20201213
20201210,3호선,일원,8149,7971,16120,20201213
20201210,3호선,대청,8407,7805,16212,20201213
20201210,3호선,학여울,1485,1467,2952,20201213
20201210,3호선,대치,8503,8463,16966,20201213
20201210,3호선,도곡,4560,4536,9096,20201213
20201210,3호선,매봉,10677,10192,20869,20201213
20201210,3호선,양재(서초구청),33242,35921,69163,20201213
20201210,3호선,남부터미널(예술의전당),23810,24601,48411,20201213
20201210,3호선,교대(법원.검찰청),11931,8159,20090,20201213
20201210,3호선,고속터미널,29150,28752,57902,20201213
20201210,3호선,잠원,3866,3793,7659,20201213
20201210,3호선,신사,24054,25228,49282,20201213
20201210,3호선,압구정,25385,26880,52265,20201213
20201210,3호선,옥수,7349,7587,14936,20201213
20201210,3호선,금호,6750,6431,13181,20201213
20201210,3호선,약수,10957,10699,21656,20201213
20201210,3호선,동대입구,6044,6479,12523,20201213
20201210,3호선,충무로,1,0,1,20201213
20201210,3호선,을지로3가,8595,8958,17553,20201213
20201210,3호선,종로3가,8084,9107,17191,20201213
20201210,3호선,안국,14732,15062,29794,20201213
20201210,3호선,경복궁(정부서울청사),14724,14557,29281,20201213
20201210,3호선,독립문,5963,6327,12290,20201213
20201210,3호선,무악재,3317,3389,6706,20201213
20201210,3호선,홍제,15030,14293,29323,20201213
20201210,3호선,녹번,12938,11903,24841,20201213
20201210,3호선,불광,13652,14815,28467,20201213
20201210,3호선,연신내,31874,29932,61806,20201213
20201210,3호선,구파발,17318,16253,33571,20201213
20201210,3호선,지축,2737,2732,5469,20201213
20201210,2호선,용두(동대문구청),1996,2136,4132,20201213
20201210,2호선,신정네거리,8381,8777,17158,20201213
20201210,2호선,양천구청,5523,6007,11530,20201213
20201210,2호선,도림천,1203,1241,2444,20201213
20201210,2호선,신설동,2586,2636,5222,20201213
20201210,2호선,신답,1377,1611,2988,20201213
20201210,2호선,용답,2173,2201,4374,20201213
20201210,2호선,충정로(경기대입구),8876,9234,18110,20201213
20201210,2호선,아현,8524,8237,16761,20201213
20201210,2호선,이대,9166,9585,18751,20201213
20201210,2호선,신촌,23262,23984,47246,20201213
20201210,2호선,홍대입구,34945,36373,71318,20201213
20201210,2호선,합정,23398,24236,47634,20201213
20201210,2호선,당산,15792,18361,34153,20201213
20201210,2호선,영등포구청,20309,20502,40811,20201213
20201210,2호선,문래,18023,18274,36297,20201213
20201210,2호선,신도림,40243,38835,79078,20201213
20201210,2호선,대림(구로구청),21843,22327,44170,20201213
20201210,2호선,구로디지털단지,52346,53037,105383,20201213
20201210,2호선,신대방,22835,22425,45260,20201213
20201210,2호선,신림,53677,52266,105943,20201213
20201210,2호선,봉천,21106,19578,40684,20201213
20201210,2호선,서울대입구(관악구청),38708,37866,76574,20201213
20201210,2호선,낙성대(강감찬),22582,22135,44717,20201213
20201210,2호선,사당,29058,31630,60688,20201213
20201210,2호선,방배,14016,14506,28522,20201213
20201210,2호선,서초,18543,18422,36965,20201213
20201210,2호선,교대(법원.검찰청),28330,31659,59989,20201213
20201210,2호선,강남,62616,60911,123527,20201213
20201210,2호선,역삼,42886,46712,89598,20201213
20201210,2호선,선릉,49134,43858,92992,20201213
20201210,2호선,삼성(무역센터),42578,43009,85587,20201213
20201210,중앙선,용문,1457,1502,2959,20201213
20201210,중앙선,지평,30,32,62,20201213
20201210,1호선,동묘앞,6556,6774,13330,20201213
20201210,1호선,시청,17946,18079,36025,20201213
20201210,1호선,종각,27929,27041,54970,20201213
20201210,1호선,종로3가,18416,16695,35111,20201213
20201210,1호선,종로5가,18107,18111,36218,20201213
20201210,1호선,동대문,9224,8854,18078,20201213
20201210,1호선,신설동,12381,12110,24491,20201213
20201210,1호선,제기동,14476,14833,29309,20201213
20201210,1호선,청량리(서울시립대입구),17064,17117,34181,20201213
20201210,2호선,시청,19574,19063,38637,20201213
20201210,2호선,을지로입구,32712,33206,65918,20201213
20201210,2호선,을지로3가,17281,17116,34397,20201213
20201210,2호선,을지로4가,11499,11310,22809,20201213
20201210,2호선,동대문역사문화공원(DDP),9884,10810,20694,20201213
20201210,2호선,신당,11531,11881,23412,20201213
20201210,2호선,상왕십리,11560,11510,23070,20201213
20201210,2호선,왕십리(성동구청),12114,9582,21696,20201213
20201210,2호선,한양대,5806,6078,11884,20201213
20201210,2호선,뚝섬,17072,18539,35611,20201213
20201210,2호선,성수,29273,31991,61264,20201213
20201210,2호선,건대입구,24796,26694,51490,20201213
20201210,2호선,구의(광진구청),20121,20034,40155,20201213
20201210,2호선,강변(동서울터미널),23833,23622,47455,20201213
20201210,2호선,잠실나루,12404,12143,24547,20201213
20201210,2호선,잠실(송파구청),50200,50025,100225,20201213
20201210,2호선,잠실새내,16107,16145,32252,20201213
20201210,2호선,종합운동장,5406,5921,11327,20201213
20201210,중앙선,원덕,224,214,438,20201213
20201211,5호선,답십리,13965,12909,26874,20201214
20201211,중앙선,용문,1178,1261,2439,20201214
20201211,중앙선,원덕,221,226,447,20201214
20201211,중앙선,양평,1894,1995,3889,20201214
20201211,중앙선,오빈,177,203,380,20201214
20201211,중앙선,아신,459,464,923,20201214
20201211,중앙선,국수,534,534,1068,20201214
20201211,중앙선,신원,166,154,320,20201214
20201211,중앙선,양수,1358,1431,2789,20201214
20201211,중앙선,운길산,453,468,921,20201214
20201211,중앙선,팔당,644,664,1308,20201214
20201211,중앙선,도심,2050,1611,3661,20201214
20201211,중앙선,덕소,4787,4743,9530,20201214
20201211,중앙선,양정,664,611,1275,20201214
20201211,중앙선,도농,8282,7642,15924,20201214
20201211,중앙선,구리,11509,11794,23303,20201214
20201211,중앙선,양원,1458,1399,2857,20201214
20201211,중앙선,망우,6562,6440,13002,20201214
20201211,중앙선,상봉(시외버스터미널),5191,4994,10185,20201214
20201211,중앙선,중랑,4775,4635,9410,20201214
20201211,중앙선,회기,19275,18385,37660,20201214
20201211,장항선,신창(순천향대),1181,898,2079,20201214
20201211,장항선,온양온천,2932,3143,6075,20201214
20201211,장항선,배방,891,838,1729,20201214
20201211,장항선,아산,2587,2512,5099,20201214
20201211,장항선,쌍용(나사렛대),1794,1608,3402,20201214
20201211,장항선,봉명,1033,967,2000,20201214
20201211,일산선,대화,11097,8866,19963,20201214
20201211,일산선,주엽,7276,7336,14612,20201214
20201211,일산선,정발산,5689,5637,11326,20201214
20201211,일산선,마두,6145,6442,12587,20201214
20201211,일산선,백석,8573,8867,17440,20201214
20201211,일산선,대곡,1457,1153,2610,20201214
20201211,일산선,화정,13949,14498,28447,20201214
20201211,일산선,원당,9572,9219,18791,20201214
20201211,일산선,삼송,15181,15044,30225,20201214
20201211,일산선,원흥,7897,7638,15535,20201214
20201211,우이신설선,신설동,1988,1899,3887,20201214
20201211,우이신설선,보문,1262,1281,2543,20201214
20201211,우이신설선,성신여대입구(돈암),2583,2740,5323,20201214
20201211,우이신설선,정릉,3737,3654,7391,20201214
20201211,우이신설선,북한산보국문,4908,4722,9630,20201214
20201211,우이신설선,솔샘,4870,4487,9357,20201214
20201211,우이신설선,삼양사거리,2142,2210,4352,20201214
20201211,우이신설선,삼양,1809,2070,3879,20201214
20201211,우이신설선,화계,2992,2770,5762,20201214
20201211,우이신설선,가오리,3463,3422,6885,20201214
20201211,우이신설선,4.19민주묘지,2303,2226,4529,20201214
20201211,우이신설선,솔밭공원,2040,2037,4077,20201214
20201211,우이신설선,북한산우이,2051,1838,3889,20201214
20201211,안산선,수리산,3746,2963,6709,20201214
20201211,안산선,오이도,7239,7041,14280,20201214
20201211,안산선,정왕,7579,7936,15515,20201214
20201211,안산선,신길온천,1470,1375,2845,20201214
20201211,안산선,안산,10920,9870,20790,20201214
20201211,안산선,초지,3949,4176,8125,20201214
20201211,안산선,고잔,7501,7194,14695,20201214
20201211,안산선,중앙,13586,14594,28180,20201214
20201211,안산선,한대앞,7353,7380,14733,20201214
20201211,안산선,상록수,14305,14453,28758,20201214
20201211,안산선,반월,3819,3641,7460,20201214
20201211,안산선,대야미,4225,3844,8069,20201214
20201211,안산선,산본,13397,14505,27902,20201214
20201211,수인선,인천,794,1331,2125,20201214
20201211,수인선,신포,1510,1546,3056,20201214
20201211,수인선,숭의,3510,3216,6726,20201214
20201211,수인선,인하대,4850,4660,9510,20201214
20201211,수인선,송도,2137,2032,4169,20201214
20201211,수인선,연수,3865,3811,7676,20201214
20201211,수인선,원인재,3776,3923,7699,20201214
20201211,수인선,남동인더스파크,2165,2380,4545,20201214
20201211,수인선,호구포,3394,3457,6851,20201214
20201211,수인선,인천논현,4620,4992,9612,20201214
20201211,수인선,소래포구,4153,3924,8077,20201214
20201211,수인선,월곶,2133,1989,4122,20201214
20201211,수인선,달월,73,48,121,20201214
20201211,수인선,사리,2988,2830,5818,20201214
20201211,수인선,야목,170,137,307,20201214
20201211,수인선,어천,526,495,1021,20201214
20201211,수인선,오목천,1984,1863,3847,20201214
20201211,수인선,고색,2883,2691,5574,20201214
20201211,분당선,매교,2379,2485,4864,20201214
20201211,분당선,수원시청,10082,11080,21162,20201214
20201211,분당선,매탄권선,4122,3940,8062,20201214
20201211,분당선,망포,12332,11542,23874,20201214
20201211,분당선,영통,6823,7015,13838,20201214
20201211,분당선,청명,3652,3327,6979,20201214
20201211,분당선,상갈,4533,4456,8989,20201214
20201211,분당선,기흥,7836,7711,15547,20201214
20201211,분당선,신갈,3694,3750,7444,20201214
20201211,분당선,구성,4044,4221,8265,20201214
20201211,분당선,죽전,11555,12164,23719,20201214
20201211,분당선,보정,1973,1687,3660,20201214
20201211,분당선,이매,4514,4246,8760,20201214
20201211,분당선,오리,9989,8495,18484,20201214
20201211,분당선,미금,13030,13283,26313,20201214
20201211,분당선,정자,13290,14098,27388,20201214
20201211,분당선,수내,10907,11063,21970,20201214
20201211,분당선,서현,20221,20798,41019,20201214
20201211,분당선,야탑,21440,22694,44134,20201214
20201211,분당선,모란,17528,17647,35175,20201214
20201211,분당선,태평,11791,11555,23346,20201214
20201211,분당선,가천대,7319,7933,15252,20201214
20201211,분당선,선정릉,6835,7170,14005,20201214
20201211,분당선,강남구청,8059,9248,17307,20201214
20201211,분당선,압구정로데오,15239,16411,31650,20201214
20201211,분당선,서울숲,7211,7079,14290,20201214
20201211,분당선,수원,6783,5580,12363,20201214
20201211,분당선,수서,10814,12011,22825,20201214
20201211,분당선,대모산입구,3120,2846,5966,20201214
20201211,분당선,개포동,2988,3099,6087,20201214
20201211,분당선,구룡,1363,1325,2688,20201214
20201211,분당선,도곡,5453,5350,10803,20201214
20201211,분당선,한티,11703,12397,24100,20201214
20201211,분당선,선릉,11735,17364,29099,20201214
20201211,과천선,범계,21173,20918,42091,20201214
20201211,과천선,평촌,15189,15345,30534,20201214
20201211,과천선,인덕원,20612,21191,41803,20201214
20201211,과천선,정부과천청사,7807,7831,15638,20201214
20201211,과천선,과천,4359,3980,8339,20201214
20201211,과천선,대공원,1455,1541,2996,20201214
20201211,과천선,경마공원,1126,1114,2240,20201214
20201211,과천선,선바위,7244,6397,13641,20201214
20201211,공항철도 1호선,영종,2286,2415,4701,20201214
20201211,공항철도 1호선,인천공항2터미널,1744,1727,3471,20201214
20201211,공항철도 1호선,인천공항1터미널,2913,3253,6166,20201214
20201211,공항철도 1호선,공항화물청사,2146,2326,4472,20201214
20201211,공항철도 1호선,운서,5064,5089,10153,20201214
20201211,공항철도 1호선,청라국제도시,5444,5100,10544,20201214
20201211,공항철도 1호선,검암,6267,6108,12375,20201214
20201211,공항철도 1호선,계양,7884,7372,15256,20201214
20201211,공항철도 1호선,김포공항,9334,6400,15734,20201214
20201211,공항철도 1호선,마곡나루(서울식물원),6188,5679,11867,20201214
20201211,공항철도 1호선,디지털미디어시티,11445,10074,21519,20201214
20201211,공항철도 1호선,홍대입구,6259,6480,12739,20201214
20201211,공항철도 1호선,공덕,1795,2301,4096,20201214
20201211,공항철도 1호선,서울역,5894,5634,11528,20201214
20201211,경춘선,춘천,1178,951,2129,20201214
20201211,경춘선,남춘천,2095,1910,4005,20201214
20201211,경춘선,김유정,161,198,359,20201214
20201211,경춘선,강촌,225,266,491,20201214
20201211,경춘선,백양리,106,151,257,20201214
20201211,경춘선,굴봉산,76,80,156,20201214
20201211,경춘선,가평,1129,1252,2381,20201214
20201211,경춘선,상천,184,183,367,20201214
20201211,경춘선,청평,1130,1197,2327,20201214
20201211,경춘선,대성리,371,363,734,20201214
20201211,경춘선,마석,3180,3218,6398,20201214
20201211,경춘선,천마산,1394,1298,2692,20201214
20201211,경춘선,평내호평,4920,5084,10004,20201214
20201211,경춘선,금곡,1326,1291,2617,20201214
20201211,경춘선,사릉,3008,2911,5919,20201214
20201211,경춘선,퇴계원,3130,2909,6039,20201214
20201211,경춘선,별내,2383,2318,4701,20201214
20201211,경춘선,갈매,2588,2253,4841,20201214
20201211,경춘선,신내,1372,1376,2748,20201214
20201211,경인선,도화,3545,3206,6751,20201214
20201211,경인선,중동,8094,7779,15873,20201214
20201211,경인선,온수(성공회대입구),5598,5575,11173,20201214
20201211,경인선,도원,2634,2697,5331,20201214
20201211,경인선,간석,4949,4658,9607,20201214
20201211,경인선,부개,7217,6928,14145,20201214
20201211,경인선,소사,8318,8077,16395,20201214
20201211,경인선,구일,5216,5426,10642,20201214
20201211,경인선,인천,2774,2069,4843,20201214
20201211,경인선,동인천,11915,11494,23409,20201214
20201211,경인선,제물포,9064,8609,17673,20201214
20201211,경인선,주안,16243,14976,31219,20201214
20201211,경인선,동암,13503,13691,27194,20201214
20201211,경인선,부평,24538,26647,51185,20201214
20201211,경인선,송내,23844,24319,48163,20201214
20201211,경인선,부천,28528,29040,57568,20201214
20201211,경인선,역곡,23525,23443,46968,20201214
20201211,경인선,오류동,10268,9637,19905,20201214
20201211,경인선,개봉,18719,19443,38162,20201214
20201211,경의선,계양,1,0,1,20201214
20201211,경의선,임진강,11,4,15,20201214
20201211,경의선,문산,4227,4242,8469,20201214
20201211,경의선,파주,1147,834,1981,20201214
20201211,경의선,월롱,1978,1653,3631,20201214
20201211,경의선,금촌,5528,5582,11110,20201214
20201211,경의선,금릉,3771,3684,7455,20201214
20201211,경의선,운정,5187,4883,10070,20201214
20201211,경의선,야당,5043,4965,10008,20201214
20201211,경의선,탄현,6202,6106,12308,20201214
20201211,경의선,일산,7598,7784,15382,20201214
20201211,경의선,풍산,4338,4131,8469,20201214
20201211,경의선,백마,5534,5469,11003,20201214
20201211,경의선,곡산,471,491,962,20201214
20201211,경의선,능곡,3146,2866,6012,20201214
20201211,경의선,행신,6352,6390,12742,20201214
20201211,경의선,강매,2646,2248,4894,20201214
20201211,경의선,화전,1268,1228,2496,20201214
20201211,경의선,수색,2043,2162,4205,20201214
20201211,경의선,디지털미디어시티,2103,2054,4157,20201214
20201211,경의선,가좌,4483,4147,8630,20201214
20201211,경의선,홍대입구,1317,1421,2738,20201214
20201211,경의선,서강대,1663,1568,3231,20201214
20201211,경의선,공덕,2779,2558,5337,20201214
20201211,경의선,효창공원앞,2565,2842,5407,20201214
20201211,경의선,신촌,667,863,1530,20201214
20201211,경의선,서울역,3504,4252,7756,20201214
20201211,경원선,소요산,2163,1813,3976,20201214
20201211,경원선,동두천,1780,1967,3747,20201214
20201211,경원선,보산,1502,1336,2838,20201214
20201211,경원선,동두천중앙,2574,2534,5108,20201214
20201211,경원선,지행,5344,5285,10629,20201214
20201211,경원선,덕정,4794,4595,9389,20201214
20201211,경원선,덕계,2344,2115,4459,20201214
20201211,경원선,양주,6336,5940,12276,20201214
20201211,경원선,녹양,3952,3803,7755,20201214
20201211,경원선,가능,5457,5438,10895,20201214
20201211,경원선,의정부,14611,15227,29838,20201214
20201211,경원선,회룡,10495,10437,20932,20201214
20201211,경원선,망월사,6175,6320,12495,20201214
20201211,경원선,도봉산,6707,4053,10760,20201214
20201211,경원선,도봉,5161,5030,10191,20201214
20201211,경원선,방학,8126,8004,16130,20201214
20201211,경원선,녹천,4204,3526,7730,20201214
20201211,경원선,월계,5662,5384,11046,20201214
20201211,경원선,광운대,7224,6831,14055,20201214
20201211,경원선,석계,6966,8023,14989,20201214
20201211,경원선,신이문,7543,6931,14474,20201214
20201211,경원선,외대앞,5883,5810,11693,20201214
20201211,경원선,청량리(서울시립대입구),12227,13355,25582,20201214
20201211,경원선,왕십리(성동구청),10878,12684,23562,20201214
20201211,경원선,응봉,1599,1362,2961,20201214
20201211,경원선,옥수,45,25,70,20201214
20201211,경원선,한남,3637,3377,7014,20201214
20201211,경원선,서빙고,1615,1472,3087,20201214
20201211,경원선,이촌(국립중앙박물관),3202,2471,5673,20201214
20201211,경부선,광명,2616,2505,5121,20201214
20201211,경부선,서동탄,1297,1101,2398,20201214
20201211,경부선,당정,5264,5076,10340,20201214
20201211,경부선,천안,4497,4616,9113,20201214
20201211,경부선,두정,4750,4527,9277,20201214
20201211,경부선,직산,690,622,1312,20201214
20201211,경부선,성환,3520,3136,6656,20201214
20201211,경부선,평택,10562,10135,20697,20201214
20201211,경부선,지제,2634,2340,4974,20201214
20201211,경부선,서정리,5862,5060,10922,20201214
20201211,경부선,송탄,3688,3480,7168,20201214
20201211,경부선,진위,1603,1279,2882,20201214
20201211,경부선,오산,8384,8150,16534,20201214
20201211,경부선,오산대,2737,2541,5278,20201214
20201211,경부선,세마,2225,2037,4262,20201214
20201211,경부선,병점,11758,11556,23314,20201214
20201211,경부선,세류,2661,2531,5192,20201214
20201211,경부선,독산,15082,15804,30886,20201214
20201211,경부선,수원,27508,29886,57394,20201214
20201211,경부선,화서,6292,6097,12389,20201214
20201211,경부선,성균관대,12237,11974,24211,20201214
20201211,경부선,의왕,7827,7695,15522,20201214
20201211,경부선,군포,7076,7077,14153,20201214
20201211,경부선,금정,22762,23190,45952,20201214
20201211,경부선,명학,8337,8269,16606,20201214
20201211,경부선,안양,19161,19391,38552,20201214
20201211,경부선,관악,6333,5856,12189,20201214
20201211,경부선,석수,8966,7820,16786,20201214
20201211,경부선,금천구청,10213,10322,20535,20201214
20201211,경부선,가산디지털단지,15345,18076,33421,20201214
20201211,경부선,구로,16812,17309,34121,20201214
20201211,경부선,신길,8391,6939,15330,20201214
20201211,경부선,신도림,3522,3531,7053,20201214
20201211,경부선,영등포,31448,32740,64188,20201214
20201211,경부선,대방,11064,11277,22341,20201214
20201211,경부선,노량진,7198,7497,14695,20201214
20201211,경부선,용산,26853,27427,54280,20201214
20201211,경부선,남영,8327,8713,17040,20201214
20201211,경부선,서울역,4114,1322,5436,20201214
20201211,경강선,여주,1480,1604,3084,20201214
20201211,경강선,세종대왕릉,229,226,455,20201214
20201211,경강선,부발,2141,1532,3673,20201214
20201211,경강선,이천,1995,2158,4153,20201214
20201211,경강선,신둔도예촌,1021,951,1972,20201214
20201211,경강선,곤지암,1807,1807,3614,20201214
20201211,경강선,초월,2612,2459,5071,20201214
20201211,경강선,경기광주,5982,5686,11668,20201214
20201211,경강선,삼동,1936,1842,3778,20201214
20201211,경강선,이매,891,775,1666,20201214
20201211,경강선,판교,3821,3655,7476,20201214
20201211,9호선2~3단계,중앙보훈병원,8113,7267,15380,20201214
20201211,9호선2~3단계,둔촌오륜,884,804,1688,20201214
20201211,9호선2~3단계,올림픽공원(한국체대),4263,4397,8660,20201214
20201211,9호선2~3단계,한성백제,1989,1760,3749,20201214
20201211,9호선2~3단계,송파나루,3737,3905,7642,20201214
20201211,9호선2~3단계,석촌,6602,5851,12453,20201214
20201211,9호선2~3단계,석촌고분,4898,4898,9796,20201214
20201211,9호선2~3단계,삼전,5655,5344,10999,20201214
20201211,9호선2~3단계,종합운동장,3391,3336,6727,20201214
20201211,9호선2~3단계,봉은사,13247,13176,26423,20201214
20201211,9호선2~3단계,삼성중앙,5829,5870,11699,20201214
20201211,9호선2~3단계,선정릉,7874,8498,16372,20201214
20201211,9호선2~3단계,언주,8341,8379,16720,20201214
20201211,9호선,신논현,25287,24750,50037,20201214
20201211,9호선,사평,2609,2538,5147,20201214
20201211,9호선,고속터미널,9365,13044,22409,20201214
20201211,9호선,신반포,2517,2461,4978,20201214
20201211,9호선,구반포,2269,2314,4583,20201214
20201211,9호선,동작(현충원),1395,1082,2477,20201214
20201211,9호선,흑석(중앙대입구),6343,6603,12946,20201214
20201211,9호선,노들,3719,3189,6908,20201214
20201211,9호선,노량진,20132,19304,39436,20201214
20201211,9호선,샛강,4744,4951,9695,20201214
20201211,9호선,여의도,20049,19001,39050,20201214
20201211,9호선,국회의사당,13429,13380,26809,20201214
20201211,9호선,당산,15199,14836,30035,20201214
20201211,9호선,선유도,6534,6318,12852,20201214
20201211,9호선,신목동,3156,2897,6053,20201214
20201211,9호선,염창,14501,14153,28654,20201214
20201211,9호선,등촌,9354,9386,18740,20201214
20201211,9호선,증미,6294,6530,12824,20201214
20201211,9호선,가양,17227,16900,34127,20201214
20201211,9호선,양천향교,8224,8231,16455,20201214
20201211,9호선,마곡나루(서울식물원),8882,8877,17759,20201214
20201211,9호선,신방화,5725,5621,11346,20201214
20201211,9호선,공항시장,2488,2703,5191,20201214
20201211,9호선,김포공항,5979,8574,14553,20201214
20201211,9호선,개화,2185,1552,3737,20201214
20201211,8호선,모란,3615,2759,6374,20201214
20201211,8호선,수진,4444,4043,8487,20201214
20201211,8호선,신흥,3935,4285,8220,20201214
20201211,8호선,단대오거리,8983,8465,17448,20201214
20201211,8호선,남한산성입구(성남법원.검찰청),12286,11108,23394,20201214
20201211,8호선,산성,5957,5957,11914,20201214
20201211,8호선,복정,9126,8025,17151,20201214
20201211,8호선,장지,15029,14528,29557,20201214
20201211,8호선,문정,19257,20022,39279,20201214
20201211,8호선,가락시장,7149,8076,15225,20201214
20201211,8호선,송파,6837,6768,13605,20201214
20201211,8호선,잠실(송파구청),11840,13355,25195,20201214
20201211,8호선,몽촌토성(평화의문),4759,4863,9622,20201214
20201211,8호선,강동구청,9257,9651,18908,20201214
20201211,8호선,천호(풍납토성),13501,15477,28978,20201214
20201211,8호선,암사,16435,14714,31149,20201214
20201211,7호선,부평구청,9988,8238,18226,20201214
20201211,7호선,굴포천,7393,7898,15291,20201214
20201211,7호선,삼산체육관,4039,3694,7733,20201214
20201211,7호선,상동,10482,11031,21513,20201214
20201211,7호선,부천시청,10785,10613,21398,20201214
20201211,7호선,신중동,12464,12184,24648,20201214
20201211,7호선,춘의,9013,8860,17873,20201214
20201211,7호선,부천종합운동장,3982,3457,7439,20201214
20201211,7호선,까치울,6427,6403,12830,20201214
20201211,7호선,온수(성공회대입구),9457,8580,18037,20201214
20201211,7호선,천왕,9658,9120,18778,20201214
20201211,7호선,광명사거리,20517,20208,40725,20201214
20201211,7호선,철산,18680,19161,37841,20201214
20201211,7호선,가산디지털단지,41244,41301,82545,20201214
20201211,7호선,남구로,14477,15471,29948,20201214
20201211,7호선,대림(구로구청),6630,6791,13421,20201214
20201211,7호선,신풍,10102,9694,19796,20201214
20201211,7호선,보라매,8602,8554,17156,20201214
20201211,7호선,신대방삼거리,14299,13987,28286,20201214
20201211,7호선,장승배기,8492,8230,16722,20201214
20201211,7호선,상도,8873,8553,17426,20201214
20201211,7호선,숭실대입구(살피재),10458,10450,20908,20201214
20201211,7호선,남성,9822,9011,18833,20201214
20201211,7호선,이수,13121,12700,25821,20201214
20201211,7호선,내방,12664,12897,25561,20201214
20201211,7호선,고속터미널,13381,11787,25168,20201214
20201211,7호선,반포,5054,4756,9810,20201214
20201211,7호선,논현,17567,18912,36479,20201214
20201211,7호선,학동,21084,22315,43399,20201214
20201211,7호선,강남구청,14177,15262,29439,20201214
20201211,7호선,청담,17133,18842,35975,20201214
20201211,7호선,뚝섬유원지,6337,6270,12607,20201214
20201211,7호선,건대입구,10174,10434,20608,20201214
20201211,7호선,어린이대공원(세종대),10059,9756,19815,20201214
20201211,7호선,군자(능동),12601,10154,22755,20201214
20201211,7호선,중곡,8904,8422,17326,20201214
20201211,7호선,용마산(용마폭포공원),5210,4968,10178,20201214
20201211,7호선,사가정,14597,14566,29163,20201214
20201211,7호선,면목,13738,13502,27240,20201214
20201211,7호선,상봉(시외버스터미널),14747,14128,28875,20201214
20201211,7호선,중화,9549,9303,18852,20201214
20201211,7호선,먹골,8804,8601,17405,20201214
20201211,7호선,태릉입구,7037,6532,13569,20201214
20201211,7호선,공릉(서울과학기술대),9790,9762,19552,20201214
20201211,7호선,하계,15073,14221,29294,20201214
20201211,7호선,중계,12284,10998,23282,20201214
20201211,7호선,노원,16132,17285,33417,20201214
20201211,7호선,마들,10654,10215,20869,20201214
20201211,7호선,수락산,10921,10884,21805,20201214
20201211,7호선,도봉산,7805,9339,17144,20201214
20201211,7호선,장암,2004,766,2770,20201214
20201211,6호선,봉화산(서울의료원),7838,7414,15252,20201214
20201211,6호선,화랑대(서울여대입구),9659,7599,17258,20201214
20201211,6호선,태릉입구,4537,5014,9551,20201214
20201211,6호선,석계,10756,10888,21644,20201214
20201211,6호선,돌곶이,7299,6926,14225,20201214
20201211,6호선,상월곡(한국과학기술연구원),5364,4744,10108,20201214
20201211,6호선,월곡(동덕여대),9766,9730,19496,20201214
20201211,6호선,고려대(종암),6536,6217,12753,20201214
20201211,6호선,안암(고대병원앞),7874,7761,15635,20201214
20201211,6호선,보문,6292,5768,12060,20201214
20201211,6호선,창신,3121,2429,5550,20201214
20201211,6호선,동묘앞,6878,6882,13760,20201214
20201211,6호선,신당,6527,6676,13203,20201214
20201211,6호선,청구,3282,3500,6782,20201214
20201211,6호선,약수,3087,3192,6279,20201214
20201211,6호선,버티고개,1882,1837,3719,20201214
20201211,6호선,한강진,5992,6812,12804,20201214
20201211,6호선,이태원,6961,7221,14182,20201214
20201211,6호선,녹사평(용산구청),3648,3697,7345,20201214
20201211,6호선,삼각지,4583,4047,8630,20201214
20201211,6호선,효창공원앞,6092,5613,11705,20201214
20201211,6호선,공덕,15444,14967,30411,20201214
20201211,6호선,대흥(서강대앞),6467,6522,12989,20201214
20201211,6호선,광흥창(서강),7279,7071,14350,20201214
20201211,6호선,합정,10216,10143,20359,20201214
20201211,6호선,망원,11572,12742,24314,20201214
20201211,6호선,마포구청,11799,10673,22472,20201214
20201211,6호선,월드컵경기장(성산),3771,3898,7669,20201214
20201211,6호선,디지털미디어시티,12031,12951,24982,20201214
20201211,6호선,증산(명지대앞),8896,8680,17576,20201214
20201211,6호선,새절(신사),11247,10379,21626,20201214
20201211,6호선,구산,6360,4801,11161,20201214
20201211,6호선,독바위,2373,2573,4946,20201214
20201211,6호선,불광,3845,3950,7795,20201214
20201211,6호선,역촌,3195,3789,6984,20201214
20201211,6호선,응암,15532,15287,30819,20201214
20201211,5호선,하남풍산,4188,4235,8423,20201214
20201211,5호선,미사,11314,11456,22770,20201214
20201211,5호선,마천,5182,5252,10434,20201214
20201211,5호선,거여,6983,6659,13642,20201214
20201211,5호선,개롱,5250,5388,10638,20201214
20201211,5호선,오금,3254,3200,6454,20201214
20201211,5호선,방이,5529,5789,11318,20201214
20201211,5호선,올림픽공원(한국체대),3394,2917,6311,20201214
20201211,5호선,둔촌동,7229,7257,14486,20201214
20201211,5호선,상일동,13422,12106,25528,20201214
20201211,5호선,고덕,7367,7363,14730,20201214
20201211,5호선,명일,7122,7264,14386,20201214
20201211,5호선,굽은다리(강동구민회관앞),7943,7509,15452,20201214
20201211,5호선,길동,6896,7170,14066,20201214
20201211,5호선,강동,16932,15911,32843,20201214
20201211,5호선,천호(풍납토성),15388,15638,31026,20201214
20201211,5호선,광나루(장신대),10900,9999,20899,20201214
20201211,5호선,아차산(어린이대공원후문),12149,12125,24274,20201214
20201211,5호선,군자(능동),9452,10155,19607,20201214
20201211,5호선,장한평,15945,15824,31769,20201214
20201211,5호선,마장,4938,4657,9595,20201214
20201211,5호선,왕십리(성동구청),3852,4161,8013,20201214
20201211,5호선,행당,6982,6166,13148,20201214
20201211,5호선,신금호,5247,5422,10669,20201214
20201211,5호선,청구,3466,3228,6694,20201214
20201211,5호선,동대문역사문화공원(DDP),2515,2914,5429,20201214
20201211,5호선,을지로4가,5455,5563,11018,20201214
20201211,5호선,종로3가,7957,7956,15913,20201214
20201211,5호선,광화문(세종문화회관),24461,25349,49810,20201214
20201211,5호선,서대문,16012,16327,32339,20201214
20201211,5호선,충정로(경기대입구),4082,4189,8271,20201214
20201211,5호선,애오개,5678,5673,11351,20201214
20201211,5호선,공덕,11729,12618,24347,20201214
20201211,5호선,마포,11798,12301,24099,20201214
20201211,5호선,여의나루,6037,6104,12141,20201214
20201211,5호선,여의도,22342,23254,45596,20201214
20201211,5호선,신길,3421,3758,7179,20201214
20201211,5호선,영등포시장,7977,8188,16165,20201214
20201211,5호선,영등포구청,3649,3642,7291,20201214
20201211,5호선,양평,6487,6454,12941,20201214
20201211,5호선,오목교(목동운동장앞),18652,20279,38931,20201214
20201211,5호선,목동,14715,16069,30784,20201214
20201211,5호선,신정(은행정),12281,9699,21980,20201214
20201211,5호선,까치산,25161,24250,49411,20201214
20201211,5호선,화곡,24915,23267,48182,20201214
20201211,5호선,우장산,11719,11661,23380,20201214
20201211,5호선,발산,15199,15627,30826,20201214
20201211,5호선,마곡,7936,7609,15545,20201214
20201211,5호선,송정,5800,5432,11232,20201214
20201211,5호선,김포공항,5917,5952,11869,20201214
20201211,5호선,개화산,4437,4309,8746,20201214
20201211,5호선,방화,5720,5504,11224,20201214
20201211,4호선,쌍문,26012,23814,49826,20201214
20201211,4호선,창동,22049,23581,45630,20201214
20201211,4호선,노원,15721,17602,33323,20201214
20201211,4호선,상계,16454,15358,31812,20201214
20201211,4호선,당고개,10576,9721,20297,20201214
20201211,4호선,남태령,998,831,1829,20201214
20201211,4호선,사당,19929,16553,36482,20201214
20201211,4호선,총신대입구(이수),16246,17478,33724,20201214
20201211,4호선,동작(현충원),2031,2196,4227,20201214
20201211,4호선,이촌(국립중앙박물관),5702,6278,11980,20201214
20201211,4호선,신용산,12435,13311,25746,20201214
20201211,4호선,삼각지,3942,4234,8176,20201214
20201211,4호선,숙대입구(갈월),10685,10458,21143,20201214
20201211,4호선,서울역,8918,12499,21417,20201214
20201211,4호선,회현(남대문시장),18668,19601,38269,20201214
20201211,4호선,명동,14145,14504,28649,20201214
20201211,4호선,충무로,23180,23945,47125,20201214
20201211,4호선,동대문역사문화공원(DDP),12788,11914,24702,20201214
20201211,4호선,동대문,17523,18011,35534,20201214
20201211,4호선,혜화,23241,22918,46159,20201214
20201211,4호선,한성대입구(삼선교),11481,11034,22515,20201214
20201211,4호선,성신여대입구(돈암),16241,15734,31975,20201214
20201211,4호선,길음,17191,16791,33982,20201214
20201211,4호선,미아사거리,24131,23779,47910,20201214
20201211,4호선,미아(서울사이버대학),13204,12887,26091,20201214
20201211,4호선,수유(강북구청),29764,29819,59583,20201214
20201211,3호선,오금,5483,4792,10275,20201214
20201211,3호선,경찰병원,6594,6596,13190,20201214
20201211,3호선,가락시장,8021,7882,15903,20201214
20201211,3호선,수서,13950,14335,28285,20201214
20201211,3호선,일원,7927,7665,15592,20201214
20201211,3호선,대청,8604,7752,16356,20201214
20201211,3호선,학여울,1490,1470,2960,20201214
20201211,3호선,대치,8684,8749,17433,20201214
20201211,3호선,도곡,4405,4416,8821,20201214
20201211,3호선,매봉,10607,10168,20775,20201214
20201211,3호선,양재(서초구청),33979,35255,69234,20201214
20201211,3호선,남부터미널(예술의전당),25268,26166,51434,20201214
20201211,3호선,교대(법원.검찰청),12028,7992,20020,20201214
20201211,3호선,고속터미널,33818,36480,70298,20201214
20201211,3호선,잠원,4029,3974,8003,20201214
20201211,3호선,신사,25313,26658,51971,20201214
20201211,3호선,압구정,27109,28674,55783,20201214
20201211,3호선,옥수,7636,7774,15410,20201214
20201211,3호선,금호,6995,6627,13622,20201214
20201211,3호선,약수,11088,10868,21956,20201214
20201211,3호선,동대입구,5982,6242,12224,20201214
20201211,3호선,충무로,3,0,3,20201214
20201211,3호선,을지로3가,8705,8911,17616,20201214
20201211,3호선,종로3가,7812,8965,16777,20201214
20201211,3호선,안국,14544,14944,29488,20201214
20201211,3호선,경복궁(정부서울청사),14766,14617,29383,20201214
20201211,3호선,독립문,5990,6123,12113,20201214
20201211,3호선,무악재,3357,3381,6738,20201214
20201211,3호선,홍제,15070,14550,29620,20201214
20201211,3호선,녹번,12926,11809,24735,20201214
20201211,3호선,불광,13792,14625,28417,20201214
20201211,3호선,연신내,32589,30626,63215,20201214
20201211,3호선,구파발,17384,16189,33573,20201214
20201211,3호선,지축,2847,2791,5638,20201214
20201211,2호선,용두(동대문구청),2156,2202,4358,20201214
20201211,2호선,신정네거리,8541,8861,17402,20201214
20201211,2호선,양천구청,5571,5969,11540,20201214
20201211,2호선,도림천,1177,1294,2471,20201214
20201211,2호선,신설동,2616,2593,5209,20201214
20201211,2호선,신답,1370,1550,2920,20201214
20201211,2호선,용답,2222,2236,4458,20201214
20201211,2호선,충정로(경기대입구),8556,8998,17554,20201214
20201211,2호선,아현,8764,8427,17191,20201214
20201211,2호선,이대,9665,9895,19560,20201214
20201211,2호선,신촌,24674,25348,50022,20201214
20201211,2호선,홍대입구,36793,39445,76238,20201214
20201211,2호선,합정,23875,25172,49047,20201214
20201211,2호선,당산,16109,18521,34630,20201214
20201211,2호선,영등포구청,20218,20465,40683,20201214
20201211,2호선,문래,17828,18099,35927,20201214
20201211,2호선,신도림,41381,40193,81574,20201214
20201211,2호선,대림(구로구청),21750,22313,44063,20201214
20201211,2호선,구로디지털단지,52383,52613,104996,20201214
20201211,2호선,신대방,23006,22531,45537,20201214
20201211,2호선,신림,55109,52987,108096,20201214
20201211,2호선,봉천,21267,19633,40900,20201214
20201211,2호선,서울대입구(관악구청),40042,38321,78363,20201214
20201211,2호선,낙성대(강감찬),23462,22148,45610,20201214
20201211,2호선,사당,29997,32452,62449,20201214
20201211,2호선,방배,13976,14523,28499,20201214
20201211,2호선,서초,18053,17840,35893,20201214
20201211,2호선,교대(법원.검찰청),28748,32182,60930,20201214
20201211,2호선,강남,65160,63376,128536,20201214
20201211,2호선,역삼,41828,45450,87278,20201214
20201211,2호선,선릉,48414,43188,91602,20201214
20201211,2호선,삼성(무역센터),42459,42705,85164,20201214
20201211,2호선,종합운동장,5830,6090,11920,20201214
20201211,2호선,잠실새내,16607,16793,33400,20201214
20201211,2호선,잠실(송파구청),52312,52024,104336,20201214
20201211,2호선,잠실나루,12219,11683,23902,20201214
20201211,2호선,강변(동서울터미널),25473,26130,51603,20201214
20201211,2호선,구의(광진구청),20341,19937,40278,20201214
20201211,2호선,건대입구,26276,28313,54589,20201214
20201211,2호선,성수,28626,31543,60169,20201214
20201211,2호선,뚝섬,17118,18551,35669,20201214
20201211,2호선,한양대,5868,6020,11888,20201214
20201211,2호선,왕십리(성동구청),12478,9995,22473,20201214
20201211,2호선,상왕십리,11850,11435,23285,20201214
20201211,2호선,신당,11970,12300,24270,20201214
20201211,2호선,동대문역사문화공원(DDP),10105,11070,21175,20201214
20201211,2호선,을지로4가,11618,11598,23216,20201214
20201211,2호선,을지로3가,16956,16963,33919,20201214
20201211,2호선,을지로입구,32485,32954,65439,20201214
20201211,2호선,시청,19413,18734,38147,20201214
20201211,1호선,청량리(서울시립대입구),17713,17958,35671,20201214
20201211,1호선,제기동,15027,15270,30297,20201214
20201211,1호선,신설동,12351,12148,24499,20201214
20201211,1호선,동대문,9227,8667,17894,20201214
20201211,1호선,종로5가,18649,18566,37215,20201214
20201211,1호선,종로3가,19101,17259,36360,20201214
20201211,1호선,종각,27434,26488,53922,20201214
20201211,1호선,시청,17712,17515,35227,20201214
20201211,1호선,동묘앞,6852,7074,13926,20201214
20201211,1호선,서울역,34458,33307,67765,20201214
20201211,경원선,창동,1,0,1,20201214
20201211,경인선,백운,6239,6236,12475,20201214
20201211,8호선,석촌,6675,7553,14228,20201214
20201211,6호선,상수,6393,7043,13436,20201214
20201211,중앙선,지평,38,44,82,20201214
20201212,일산선,대곡,869,737,1606,20201215
20201212,일산선,화정,8586,8955,17541,20201215
20201212,일산선,원당,5826,5605,11431,20201215
20201212,일산선,삼송,9179,9091,18270,20201215
20201212,일산선,원흥,4405,4274,8679,20201215
20201212,우이신설선,신설동,1227,1134,2361,20201215
20201212,우이신설선,보문,821,827,1648,20201215
20201212,우이신설선,성신여대입구(돈암),1712,2016,3728,20201215
20201212,우이신설선,정릉,2480,2079,4559,20201215
20201212,우이신설선,북한산보국문,3279,3166,6445,20201215
20201212,우이신설선,솔샘,2467,2276,4743,20201215
20201212,우이신설선,삼양사거리,1394,1361,2755,20201215
20201212,우이신설선,삼양,1094,1210,2304,20201215
20201212,우이신설선,화계,1836,1764,3600,20201215
20201212,우이신설선,가오리,2066,1921,3987,20201215
20201212,우이신설선,4.19민주묘지,1739,1542,3281,20201215
20201212,우이신설선,솔밭공원,1264,1229,2493,20201215
20201212,우이신설선,북한산우이,2164,2314,4478,20201215
20201212,안산선,수리산,2161,1915,4076,20201215
20201212,수인선,원인재,2551,2663,5214,20201215
20201212,수인선,남동인더스파크,821,828,1649,20201215
20201212,수인선,호구포,1854,1783,3637,20201215
20201212,수인선,인천논현,3044,3093,6137,20201215
20201212,수인선,소래포구,3252,3453,6705,20201215
20201212,수인선,월곶,1534,1503,3037,20201215
20201212,수인선,달월,59,36,95,20201215
20201212,수인선,사리,1875,1626,3501,20201215
20201212,수인선,야목,128,113,241,20201215
20201212,수인선,어천,362,333,695,20201215
20201212,수인선,오목천,1154,1060,2214,20201215
20201212,수인선,고색,1421,1452,2873,20201215
20201212,분당선,매교,1473,1488,2961,20201215
20201212,분당선,수원시청,6588,7122,13710,20201215
20201212,분당선,매탄권선,2131,2004,4135,20201215
20201212,분당선,망포,5858,5447,11305,20201215
20201212,분당선,영통,4211,4180,8391,20201215
20201212,분당선,청명,1725,1683,3408,20201215
20201212,분당선,상갈,2500,2576,5076,20201215
20201212,분당선,기흥,4540,4437,8977,20201215
20201212,분당선,신갈,1913,1921,3834,20201215
20201212,분당선,구성,2189,2242,4431,20201215
20201212,분당선,죽전,6871,7510,14381,20201215
20201212,분당선,보정,1059,959,2018,20201215
20201212,분당선,이매,2372,2462,4834,20201215
20201212,분당선,오리,5622,4672,10294,20201215
20201212,분당선,미금,7676,7971,15647,20201215
20201212,분당선,정자,6997,7160,14157,20201215
20201212,분당선,수내,5995,5709,11704,20201215
20201212,분당선,서현,11994,11918,23912,20201215
20201212,분당선,야탑,11718,12446,24164,20201215
20201212,분당선,모란,11736,11866,23602,20201215
20201212,분당선,태평,7900,7934,15834,20201215
20201212,분당선,가천대,3687,4089,7776,20201215
20201212,분당선,선정릉,2573,2657,5230,20201215
20201212,분당선,강남구청,3330,4014,7344,20201215
20201212,공항철도 1호선,공항화물청사,1228,1280,2508,20201215
20201212,공항철도 1호선,운서,4109,4176,8285,20201215
20201212,공항철도 1호선,청라국제도시,2427,2458,4885,20201215
20201212,공항철도 1호선,검암,3218,3299,6517,20201215
20201212,공항철도 1호선,계양,4182,4014,8196,20201215
20201212,공항철도 1호선,김포공항,6927,4668,11595,20201215
20201212,공항철도 1호선,마곡나루(서울식물원),1792,1820,3612,20201215
20201212,공항철도 1호선,디지털미디어시티,3508,3360,6868,20201215
20201212,공항철도 1호선,홍대입구,4753,4681,9434,20201215
20201212,공항철도 1호선,공덕,944,1523,2467,20201215
20201212,공항철도 1호선,서울역,3889,3803,7692,20201215
20201212,경춘선,춘천,781,774,1555,20201215
20201212,경춘선,남춘천,1717,1752,3469,20201215
20201212,경춘선,김유정,278,320,598,20201215
20201212,경춘선,강촌,272,307,579,20201215
20201212,경춘선,백양리,163,142,305,20201215
20201212,경춘선,굴봉산,114,120,234,20201215
20201212,경춘선,가평,889,1018,1907,20201215
20201212,경춘선,상천,223,206,429,20201215
20201212,경춘선,청평,1002,1018,2020,20201215
20201212,경춘선,대성리,379,391,770,20201215
20201212,경춘선,마석,2111,2138,4249,20201215
20201212,경춘선,천마산,989,998,1987,20201215
20201212,경춘선,평내호평,2951,2874,5825,20201215
20201212,경춘선,금곡,836,779,1615,20201215
20201212,경춘선,사릉,1590,1624,3214,20201215
20201212,경춘선,퇴계원,1760,1644,3404,20201215
20201212,경춘선,별내,1517,1558,3075,20201215
20201212,경춘선,갈매,1324,1187,2511,20201215
20201212,경춘선,신내,718,784,1502,20201215
20201212,경인선,도화,2178,2085,4263,20201215
20201212,경인선,중동,4628,4477,9105,20201215
20201212,경인선,온수(성공회대입구),3349,3276,6625,20201215
20201212,경인선,도원,1653,1718,3371,20201215
20201212,경인선,간석,2898,2744,5642,20201215
20201212,경인선,부개,4424,4269,8693,20201215
20201212,경인선,소사,5737,5661,11398,20201215
20201212,경인선,구일,3014,2787,5801,20201215
20201212,경인선,인천,2259,1924,4183,20201215
20201212,경인선,동인천,8058,8006,16064,20201215
20201212,경인선,제물포,5026,4945,9971,20201215
20201212,경인선,주안,11130,10174,21304,20201215
20201212,경인선,동암,9254,9495,18749,20201215
20201212,경인선,백운,3983,3969,7952,20201215
20201212,경인선,부평,18887,20464,39351,20201215
20201212,경인선,송내,12421,12709,25130,20201215
20201212,경인선,부천,20776,21465,42241,20201215
20201212,경인선,역곡,13959,14057,28016,20201215
20201212,경인선,오류동,6505,6173,12678,20201215
20201212,경인선,개봉,11804,11891,23695,20201215
20201212,경의선,임진강,34,33,67,20201215
20201212,경의선,문산,2967,2923,5890,20201215
20201212,경의선,파주,616,498,1114,20201215
20201212,경의선,월롱,890,876,1766,20201215
20201212,경의선,금촌,3722,3578,7300,20201215
20201212,경의선,금릉,2286,2329,4615,20201215
20201212,경의선,운정,2787,2728,5515,20201215
20201212,경의선,야당,3036,3001,6037,20201215
20201212,경의선,탄현,3365,3401,6766,20201215
20201212,경의선,일산,3964,3884,7848,20201215
20201212,경의선,풍산,2538,2529,5067,20201215
20201212,경의선,백마,2579,2581,5160,20201215
20201212,경의선,곡산,283,261,544,20201215
20201212,경의선,능곡,1936,1868,3804,20201215
20201212,경의선,행신,3193,3282,6475,20201215
20201212,경의선,강매,1267,1192,2459,20201215
20201212,경의선,화전,673,644,1317,20201215
20201212,경의선,수색,834,804,1638,20201215
20201212,경의선,디지털미디어시티,1269,1145,2414,20201215
20201212,경의선,가좌,2412,2363,4775,20201215
20201212,경의선,홍대입구,890,994,1884,20201215
20201212,경의선,서강대,1111,986,2097,20201215
20201212,경의선,공덕,1711,1250,2961,20201215
20201212,경의선,효창공원앞,1137,1269,2406,20201215
20201212,경의선,신촌,338,295,633,20201215
20201212,경의선,서울역,844,845,1689,20201215
20201212,경원선,소요산,2634,2316,4950,20201215
20201212,경원선,동두천,1098,1437,2535,20201215
20201212,경원선,보산,1326,1361,2687,20201215
20201212,경원선,동두천중앙,1922,1986,3908,20201215
20201212,경원선,지행,3806,3767,7573,20201215
20201212,경원선,덕정,2950,2954,5904,20201215
20201212,경원선,덕계,1507,1358,2865,20201215
20201212,경원선,양주,4236,4176,8412,20201215
20201212,경원선,녹양,2442,2455,4897,20201215
20201212,경원선,가능,3906,3737,7643,20201215
20201212,경원선,의정부,11743,12116,23859,20201215
20201212,경원선,회룡,6760,6780,13540,20201215
20201212,경원선,망월사,4025,4242,8267,20201215
20201212,경원선,도봉산,6994,4626,11620,20201215
20201212,경원선,도봉,3376,3313,6689,20201215
20201212,경원선,방학,5622,5493,11115,20201215
20201212,경원선,녹천,2618,2218,4836,20201215
20201212,경원선,월계,3518,3340,6858,20201215
20201212,경원선,광운대,5664,5307,10971,20201215
20201212,경원선,석계,4894,5222,10116,20201215
20201212,경원선,신이문,4777,4498,9275,20201215
20201212,경원선,외대앞,7177,6829,14006,20201215
20201212,경원선,청량리(서울시립대입구),9428,10403,19831,20201215
20201212,경원선,왕십리(성동구청),7641,9126,16767,20201215
20201212,경원선,응봉,938,820,1758,20201215
20201212,경원선,옥수,25,19,44,20201215
20201212,경원선,한남,2037,1920,3957,20201215
20201212,경원선,서빙고,878,766,1644,20201215
20201212,경원선,이촌(국립중앙박물관),1927,1436,3363,20201215
20201212,경부선,광명,1616,1389,3005,20201215
20201212,경부선,서동탄,631,644,1275,20201215
20201212,경부선,당정,2657,2613,5270,20201215
20201212,경부선,천안,3999,4040,8039,20201215
20201212,경부선,두정,3440,3330,6770,20201215
20201212,경부선,직산,460,492,952,20201215
20201212,경부선,성환,2278,2045,4323,20201215
20201212,경부선,평택,8899,8391,17290,20201215
20201212,경부선,지제,2014,1694,3708,20201215
20201212,경부선,서정리,4883,3855,8738,20201215
20201212,경부선,송탄,3461,3132,6593,20201215
20201212,경부선,진위,760,693,1453,20201215
20201212,경부선,오산,6463,6071,12534,20201215
20201212,경부선,오산대,1719,1623,3342,20201215
20201212,경부선,세마,1418,1269,2687,20201215
20201212,경부선,병점,7765,7603,15368,20201215
20201212,경부선,세류,1787,1816,3603,20201215
20201212,경부선,독산,6320,6415,12735,20201215
20201212,경부선,수원,22752,24567,47319,20201215
20201212,경부선,화서,3531,3488,7019,20201215
20201212,경부선,성균관대,6504,6538,13042,20201215
20201212,경부선,의왕,4223,4184,8407,20201215
20201212,경부선,군포,3558,3327,6885,20201215
20201212,경부선,금정,13107,13302,26409,20201215
20201212,경부선,명학,3938,3883,7821,20201215
20201212,경부선,안양,12382,12458,24840,20201215
20201212,경부선,관악,4231,3969,8200,20201215
20201212,경부선,석수,4965,4902,9867,20201215
20201212,경부선,금천구청,5820,5915,11735,20201215
20201212,경부선,가산디지털단지,4506,6066,10572,20201215
20201212,경부선,구로,10034,10086,20120,20201215
20201212,경부선,신길,4764,4013,8777,20201215
20201212,경부선,신도림,1952,1979,3931,20201215
20201212,경부선,영등포,24484,25417,49901,20201215
20201212,경부선,대방,5330,5431,10761,20201215
20201212,경부선,노량진,5368,5317,10685,20201215
20201212,경부선,용산,17885,19304,37189,20201215
20201212,경부선,남영,4143,4095,8238,20201215
20201212,경부선,서울역,2941,893,3834,20201215
20201212,경강선,여주,1256,1384,2640,20201215
20201212,경강선,세종대왕릉,189,190,379,20201215
20201212,경강선,부발,1210,967,2177,20201215
20201212,경강선,이천,1642,1804,3446,20201215
20201212,경강선,신둔도예촌,648,636,1284,20201215
20201212,경강선,곤지암,1266,1323,2589,20201215
20201212,경강선,초월,1409,1342,2751,20201215
20201212,경강선,경기광주,3183,3156,6339,20201215
20201212,경강선,삼동,990,928,1918,20201215
20201212,경강선,이매,525,389,914,20201215
20201212,경강선,판교,2028,1826,3854,20201215
20201212,9호선2~3단계,중앙보훈병원,2918,2713,5631,20201215
20201212,9호선2~3단계,둔촌오륜,429,374,803,20201215
20201212,9호선2~3단계,올림픽공원(한국체대),2312,2367,4679,20201215
20201212,9호선2~3단계,한성백제,1086,1010,2096,20201215
20201212,9호선2~3단계,송파나루,2254,2357,4611,20201215
20201212,9호선2~3단계,석촌,3927,3346,7273,20201215
20201212,9호선2~3단계,석촌고분,2888,2762,5650,20201215
20201212,9호선2~3단계,삼전,3360,3149,6509,20201215
20201212,9호선2~3단계,종합운동장,2012,1895,3907,20201215
20201212,9호선2~3단계,봉은사,6505,6706,13211,20201215
20201212,9호선2~3단계,삼성중앙,2129,2132,4261,20201215
20201212,9호선2~3단계,선정릉,3350,3706,7056,20201215
20201212,9호선2~3단계,언주,3911,3933,7844,20201215
20201212,9호선,신논현,15043,14759,29802,20201215
20201212,9호선,사평,1303,1276,2579,20201215
20201212,9호선,고속터미널,6831,9379,16210,20201215
20201212,9호선,신반포,1440,1412,2852,20201215
20201212,9호선,구반포,1426,1485,2911,20201215
20201212,9호선,동작(현충원),957,712,1669,20201215
20201212,9호선,흑석(중앙대입구),7952,7053,15005,20201215
20201212,9호선,노들,2278,1944,4222,20201215
20201212,9호선,노량진,12958,12805,25763,20201215
20201212,9호선,샛강,1750,1700,3450,20201215
20201212,9호선,여의도,5012,4874,9886,20201215
20201212,9호선,국회의사당,3014,3141,6155,20201215
20201212,9호선,당산,8268,7676,15944,20201215
20201212,9호선,선유도,2477,2447,4924,20201215
20201212,9호선,신목동,1495,1376,2871,20201215
20201212,9호선,염창,7727,7488,15215,20201215
20201212,9호선,등촌,5070,4984,10054,20201215
20201212,9호선,증미,3105,3026,6131,20201215
20201212,9호선,가양,9781,9494,19275,20201215
20201212,9호선,양천향교,3978,3903,7881,20201215
20201212,9호선,마곡나루(서울식물원),4514,4466,8980,20201215
20201212,9호선,신방화,3318,3254,6572,20201215
20201212,9호선,공항시장,1631,1720,3351,20201215
20201212,9호선,김포공항,4846,7129,11975,20201215
20201212,9호선,개화,992,869,1861,20201215
20201212,8호선,모란,2595,2128,4723,20201215
20201212,8호선,수진,3048,2709,5757,20201215
20201212,8호선,신흥,2798,2994,5792,20201215
20201212,8호선,단대오거리,5399,5063,10462,20201215
20201212,8호선,남한산성입구(성남법원.검찰청),6733,6226,12959,20201215
20201212,8호선,산성,3908,4027,7935,20201215
20201212,8호선,복정,5177,4545,9722,20201215
20201212,8호선,장지,8766,8553,17319,20201215
20201212,8호선,문정,5918,6034,11952,20201215
20201212,8호선,가락시장,4547,4647,9194,20201215
20201212,8호선,송파,3638,3804,7442,20201215
20201212,8호선,석촌,3901,4509,8410,20201215
20201212,8호선,잠실(송파구청),7488,8009,15497,20201215
20201212,8호선,몽촌토성(평화의문),2813,2984,5797,20201215
20201212,8호선,강동구청,4279,4371,8650,20201215
20201212,8호선,천호(풍납토성),9069,10169,19238,20201215
20201212,8호선,암사,9137,8582,17719,20201215
20201212,7호선,부평구청,5022,4471,9493,20201215
20201212,7호선,굴포천,4303,4683,8986,20201215
20201212,7호선,삼산체육관,2129,1909,4038,20201215
20201212,7호선,상동,6317,6430,12747,20201215
20201212,7호선,부천시청,6167,6100,12267,20201215
20201212,7호선,신중동,6502,6372,12874,20201215
20201212,7호선,춘의,4119,3984,8103,20201215
20201212,7호선,부천종합운동장,2248,2055,4303,20201215
20201212,7호선,까치울,3578,3571,7149,20201215
20201212,7호선,온수(성공회대입구),4288,4218,8506,20201215
20201212,7호선,천왕,4663,4449,9112,20201215
20201212,7호선,광명사거리,12808,13047,25855,20201215
20201212,7호선,철산,10180,10495,20675,20201215
20201212,7호선,가산디지털단지,11391,10812,22203,20201215
20201212,7호선,남구로,6771,7323,14094,20201215
20201212,7호선,대림(구로구청),5013,5312,10325,20201215
20201212,7호선,신풍,5983,5859,11842,20201215
20201212,7호선,보라매,4294,4047,8341,20201215
20201212,7호선,신대방삼거리,8282,7892,16174,20201215
20201212,7호선,장승배기,5108,4971,10079,20201215
20201212,7호선,상도,7781,7267,15048,20201215
20201212,7호선,숭실대입구(살피재),5947,5773,11720,20201215
20201212,7호선,남성,5694,5287,10981,20201215
20201212,7호선,이수,8220,7619,15839,20201215
20201212,7호선,내방,5786,5671,11457,20201215
20201212,7호선,고속터미널,8225,7227,15452,20201215
20201212,7호선,반포,3141,2912,6053,20201215
20201212,7호선,논현,8053,8650,16703,20201215
20201212,7호선,학동,7936,8147,16083,20201215
20201212,7호선,강남구청,7103,7682,14785,20201215
20201212,7호선,청담,8568,9048,17616,20201215
20201212,7호선,뚝섬유원지,4156,3991,8147,20201215
20201212,7호선,건대입구,7274,7062,14336,20201215
20201212,7호선,어린이대공원(세종대),6847,6428,13275,20201215
20201212,7호선,군자(능동),7738,6041,13779,20201215
20201212,7호선,중곡,5223,5048,10271,20201215
20201212,7호선,용마산(용마폭포공원),3249,3167,6416,20201215
20201212,7호선,사가정,9381,9284,18665,20201215
20201212,7호선,면목,8527,8223,16750,20201215
20201212,7호선,상봉(시외버스터미널),9572,9224,18796,20201215
20201212,7호선,중화,5793,5821,11614,20201215
20201212,7호선,먹골,5749,5741,11490,20201215
20201212,7호선,태릉입구,4531,4168,8699,20201215
20201212,7호선,공릉(서울과학기술대),6217,6054,12271,20201215
20201212,7호선,하계,8565,8105,16670,20201215
20201212,7호선,중계,6756,6158,12914,20201215
20201212,7호선,노원,10799,11017,21816,20201215
20201212,7호선,마들,6337,6079,12416,20201215
20201212,7호선,수락산,7470,7461,14931,20201215
20201212,7호선,도봉산,4534,6585,11119,20201215
20201212,7호선,장암,1106,790,1896,20201215
20201212,6호선,봉화산(서울의료원),3828,3711,7539,20201215
20201212,6호선,화랑대(서울여대입구),4497,3830,8327,20201215
20201212,6호선,태릉입구,2803,2874,5677,20201215
20201212,6호선,석계,6390,6501,12891,20201215
20201212,6호선,돌곶이,5095,4642,9737,20201215
20201212,6호선,상월곡(한국과학기술연구원),3106,2740,5846,20201215
20201212,6호선,월곡(동덕여대),5293,5444,10737,20201215
20201212,6호선,고려대(종암),3704,3516,7220,20201215
20201212,6호선,안암(고대병원앞),3956,3745,7701,20201215
20201212,6호선,보문,3513,3107,6620,20201215
20201212,6호선,창신,1560,1341,2901,20201215
20201212,6호선,동묘앞,5514,5097,10611,20201215
20201212,6호선,신당,3944,3305,7249,20201215
20201212,6호선,청구,1652,1830,3482,20201215
20201212,6호선,약수,1766,1761,3527,20201215
20201212,6호선,버티고개,1108,1107,2215,20201215
20201212,6호선,한강진,3046,3786,6832,20201215
20201212,6호선,이태원,5355,5738,11093,20201215
20201212,6호선,녹사평(용산구청),2577,2610,5187,20201215
20201212,6호선,삼각지,2560,2122,4682,20201215
20201212,6호선,효창공원앞,3292,2929,6221,20201215
20201212,6호선,공덕,6724,6368,13092,20201215
20201212,6호선,대흥(서강대앞),3442,3378,6820,20201215
20201212,6호선,광흥창(서강),3408,3267,6675,20201215
20201212,6호선,상수,4033,4630,8663,20201215
20201212,6호선,합정,7028,6497,13525,20201215
20201212,6호선,망원,8085,8596,16681,20201215
20201212,6호선,마포구청,6594,5932,12526,20201215
20201212,6호선,월드컵경기장(성산),3053,3179,6232,20201215
20201212,6호선,디지털미디어시티,5183,5288,10471,20201215
20201212,6호선,증산(명지대앞),5408,5385,10793,20201215
20201212,6호선,새절(신사),6471,6236,12707,20201215
20201212,6호선,구산,3710,2873,6583,20201215
20201212,6호선,연신내,1,0,1,20201215
20201212,6호선,독바위,1521,1802,3323,20201215
20201212,6호선,불광,2938,2783,5721,20201215
20201212,6호선,역촌,1882,2166,4048,20201215
20201212,6호선,응암,9023,9160,18183,20201215
20201212,5호선,하남풍산,2351,2521,4872,20201215
20201212,5호선,미사,6461,6423,12884,20201215
20201212,5호선,마천,3369,3475,6844,20201215
20201212,5호선,거여,3849,3772,7621,20201215
20201212,5호선,개롱,2972,3098,6070,20201215
20201212,5호선,오금,1502,1396,2898,20201215
20201212,5호선,방이,3004,3091,6095,20201215
20201212,5호선,올림픽공원(한국체대),1920,1692,3612,20201215
20201212,5호선,둔촌동,4285,4301,8586,20201215
20201212,5호선,상일동,6476,5997,12473,20201215
20201212,5호선,고덕,3924,3834,7758,20201215
20201212,5호선,명일,3952,3987,7939,20201215
20201212,5호선,굽은다리(강동구민회관앞),4913,4644,9557,20201215
20201212,5호선,길동,4062,4369,8431,20201215
20201212,5호선,강동,9737,9179,18916,20201215
20201212,5호선,천호(풍납토성),11525,11168,22693,20201215
20201212,5호선,광나루(장신대),6622,6410,13032,20201215
20201212,5호선,아차산(어린이대공원후문),8751,8700,17451,20201215
20201212,5호선,군자(능동),5779,6327,12106,20201215
20201212,5호선,장한평,7676,7648,15324,20201215
20201212,5호선,답십리,7545,7053,14598,20201215
20201212,5호선,마장,2797,2676,5473,20201215
20201212,5호선,왕십리(성동구청),2379,2675,5054,20201215
20201212,5호선,행당,3775,3288,7063,20201215
20201212,5호선,신금호,2928,3014,5942,20201215
20201212,5호선,청구,1869,1680,3549,20201215
20201212,5호선,동대문역사문화공원(DDP),709,898,1607,20201215
20201212,5호선,을지로4가,2462,2620,5082,20201215
20201212,5호선,종로3가,4840,5025,9865,20201215
20201212,5호선,광화문(세종문화회관),8112,8168,16280,20201215
20201212,5호선,서대문,4825,4906,9731,20201215
20201212,5호선,충정로(경기대입구),1449,1326,2775,20201215
20201212,5호선,애오개,2596,2493,5089,20201215
20201212,5호선,공덕,4638,4854,9492,20201215
20201212,5호선,마포,4822,4801,9623,20201215
20201212,5호선,여의나루,2798,2768,5566,20201215
20201212,5호선,여의도,5545,5775,11320,20201215
20201212,5호선,신길,1672,1843,3515,20201215
20201212,5호선,영등포시장,4988,5199,10187,20201215
20201212,5호선,영등포구청,1488,1382,2870,20201215
20201212,5호선,양평,2687,2632,5319,20201215
20201212,5호선,오목교(목동운동장앞),10508,11099,21607,20201215
20201212,5호선,목동,7729,7970,15699,20201215
20201212,5호선,신정(은행정),6398,5592,11990,20201215
20201212,5호선,까치산,15041,14615,29656,20201215
20201212,5호선,화곡,14003,13194,27197,20201215
20201212,5호선,우장산,6699,6767,13466,20201215
20201212,5호선,발산,8100,8467,16567,20201215
20201212,5호선,마곡,3339,3145,6484,20201215
20201212,5호선,송정,3676,3571,7247,20201215
20201212,5호선,김포공항,4664,5032,9696,20201215
20201212,5호선,개화산,2662,2706,5368,20201215
20201212,5호선,방화,3480,3176,6656,20201215
20201212,4호선,쌍문,15654,14531,30185,20201215
20201212,4호선,창동,13685,14747,28432,20201215
20201212,4호선,노원,10467,11353,21820,20201215
20201212,4호선,상계,9900,9530,19430,20201215
20201212,4호선,당고개,7175,6905,14080,20201215
20201212,4호선,남태령,587,476,1063,20201215
20201212,4호선,사당,12216,10519,22735,20201215
20201212,4호선,총신대입구(이수),9957,10743,20700,20201215
20201212,4호선,동작(현충원),1342,1372,2714,20201215
20201212,4호선,이촌(국립중앙박물관),3197,3515,6712,20201215
20201212,4호선,신용산,5714,6126,11840,20201215
20201212,4호선,삼각지,1721,2048,3769,20201215
20201212,4호선,숙대입구(갈월),5835,5530,11365,20201215
20201212,4호선,서울역,3562,6689,10251,20201215
20201212,4호선,회현(남대문시장),10063,10695,20758,20201215
20201212,4호선,명동,7876,8691,16567,20201215
20201212,4호선,충무로,8723,8853,17576,20201215
20201212,4호선,동대문역사문화공원(DDP),7021,6004,13025,20201215
20201212,4호선,동대문,9442,9249,18691,20201215
20201212,4호선,혜화,12379,12565,24944,20201215
20201212,4호선,한성대입구(삼선교),7126,6876,14002,20201215
20201212,4호선,성신여대입구(돈암),10917,10428,21345,20201215
20201212,4호선,길음,9337,9070,18407,20201215
20201212,4호선,미아사거리,16075,15528,31603,20201215
20201212,4호선,미아(서울사이버대학),8013,7875,15888,20201215
20201212,4호선,수유(강북구청),19243,18590,37833,20201215
20201212,3호선,오금,2381,2239,4620,20201215
20201212,3호선,경찰병원,2812,2701,5513,20201215
20201212,3호선,가락시장,4585,4394,8979,20201215
20201212,3호선,수서,7872,8076,15948,20201215
20201212,3호선,일원,3242,3222,6464,20201215
20201212,3호선,대청,3988,3679,7667,20201215
20201212,3호선,학여울,719,683,1402,20201215
20201212,3호선,대치,5053,4836,9889,20201215
20201212,3호선,도곡,2173,2156,4329,20201215
20201212,3호선,매봉,4024,3798,7822,20201215
20201212,3호선,양재(서초구청),13199,14171,27370,20201215
20201212,3호선,남부터미널(예술의전당),12844,13212,26056,20201215
20201212,3호선,교대(법원.검찰청),4158,2625,6783,20201215
20201212,3호선,고속터미널,28371,29403,57774,20201215
20201212,3호선,잠원,2153,2073,4226,20201215
20201212,3호선,신사,14868,15317,30185,20201215
20201212,3호선,압구정,16856,17433,34289,20201215
20201212,3호선,옥수,4699,4737,9436,20201215
20201212,3호선,금호,4248,3947,8195,20201215
20201212,3호선,약수,6397,5963,12360,20201215
20201212,3호선,동대입구,4085,4413,8498,20201215
20201212,3호선,을지로3가,2928,3260,6188,20201215
20201212,3호선,종로3가,2769,3679,6448,20201215
20201212,3호선,안국,6173,6784,12957,20201215
20201212,3호선,경복궁(정부서울청사),7527,7665,15192,20201215
20201212,3호선,독립문,3915,4060,7975,20201215
20201212,3호선,무악재,1857,1907,3764,20201215
20201212,3호선,홍제,9271,8990,18261,20201215
20201212,3호선,녹번,6980,6295,13275,20201215
20201212,3호선,불광,9410,10648,20058,20201215
20201212,3호선,연신내,21433,20150,41583,20201215
20201212,3호선,구파발,9932,10004,19936,20201215
20201212,3호선,지축,1656,1639,3295,20201215
20201212,2호선,용두(동대문구청),1240,1228,2468,20201215
20201212,2호선,신정네거리,4906,5104,10010,20201215
20201212,2호선,양천구청,2862,3050,5912,20201215
20201212,2호선,도림천,609,570,1179,20201215
20201212,2호선,신설동,2235,2231,4466,20201215
20201212,2호선,신답,680,708,1388,20201215
20201212,2호선,용답,1449,1440,2889,20201215
20201212,2호선,충정로(경기대입구),3861,4043,7904,20201215
20201212,2호선,아현,5292,5237,10529,20201215
20201212,2호선,이대,8426,8325,16751,20201215
20201212,2호선,신촌,17562,17759,35321,20201215
20201212,2호선,홍대입구,27685,28622,56307,20201215
20201212,2호선,합정,14985,15791,30776,20201215
20201212,2호선,당산,8346,9237,17583,20201215
20201212,2호선,영등포구청,8786,9094,17880,20201215
20201212,2호선,문래,7415,7568,14983,20201215
20201212,2호선,신도림,26613,26429,53042,20201215
20201212,2호선,대림(구로구청),13707,14905,28612,20201215
20201212,2호선,구로디지털단지,24596,24809,49405,20201215
20201212,2호선,신대방,14459,14251,28710,20201215
20201212,2호선,신림,36168,34500,70668,20201215
20201212,2호선,봉천,12635,11890,24525,20201215
20201212,2호선,서울대입구(관악구청),25713,24627,50340,20201215
20201212,2호선,낙성대(강감찬),14864,13808,28672,20201215
20201212,2호선,사당,18730,20229,38959,20201215
20201212,2호선,방배,7166,7166,14332,20201215
20201212,2호선,서초,7305,6673,13978,20201215
20201212,2호선,교대(법원.검찰청),11326,12371,23697,20201215
20201212,2호선,강남,33933,33492,67425,20201215
20201212,2호선,역삼,13345,14169,27514,20201215
20201212,2호선,선릉,17012,15096,32108,20201215
20201212,2호선,삼성(무역센터),18389,18526,36915,20201215
20201212,2호선,종합운동장,3066,3295,6361,20201215
20201212,2호선,잠실새내,10145,10533,20678,20201215
20201212,2호선,잠실(송파구청),33955,32459,66414,20201215
20201212,2호선,잠실나루,4985,4819,9804,20201215
20201212,2호선,강변(동서울터미널),16207,16870,33077,20201215
20201212,2호선,구의(광진구청),11472,11321,22793,20201215
20201212,2호선,건대입구,18670,20194,38864,20201215
20201212,2호선,성수,9443,10248,19691,20201215
20201212,2호선,뚝섬,6592,6879,13471,20201215
20201212,2호선,한양대,3007,3064,6071,20201215
20201212,2호선,왕십리(성동구청),8410,6878,15288,20201215
20201212,2호선,상왕십리,6564,6150,12714,20201215
20201212,2호선,신당,7717,7924,15641,20201215
20201212,2호선,동대문역사문화공원(DDP),6184,6327,12511,20201215
20201212,2호선,을지로4가,5536,5424,10960,20201215
20201212,2호선,을지로3가,5442,5395,10837,20201215
20201212,2호선,을지로입구,13223,13136,26359,20201215
20201212,2호선,시청,5076,4276,9352,20201215
20201212,1호선,청량리(서울시립대입구),13818,14040,27858,20201215
20201212,1호선,제기동,11579,11788,23367,20201215
20201212,1호선,신설동,7295,6994,14289,20201215
20201212,1호선,동대문,7810,7070,14880,20201215
20201212,1호선,종로5가,11293,11471,22764,20201215
20201212,1호선,종로3가,12568,11455,24023,20201215
20201212,1호선,종각,9994,9561,19555,20201215
20201212,1호선,시청,5963,5990,11953,20201215
20201212,1호선,동묘앞,8518,8705,17223,20201215
20201212,1호선,서울역,17462,17665,35127,20201215
20201212,일산선,백석,5449,5644,11093,20201215
20201212,중앙선,망우,4411,4326,8737,20201215
20201212,중앙선,오빈,160,160,320,20201215
20201212,중앙선,양평,1430,1495,2925,20201215
20201212,중앙선,원덕,202,237,439,20201215
20201212,분당선,압구정로데오,10913,11908,22821,20201215
20201212,분당선,서울숲,3421,3335,6756,20201215
20201212,분당선,수원,4704,3734,8438,20201215
20201212,분당선,수서,5997,6539,12536,20201215
20201212,분당선,대모산입구,1886,1757,3643,20201215
20201212,분당선,개포동,1592,1565,3157,20201215
20201212,분당선,구룡,818,727,1545,20201215
20201212,분당선,도곡,2880,2641,5521,20201215
20201212,분당선,한티,6857,7014,13871,20201215
20201212,분당선,선릉,3805,5495,9300,20201215
20201212,과천선,범계,12634,12100,24734,20201215
20201212,과천선,평촌,6342,6431,12773,20201215
20201212,과천선,인덕원,10334,10322,20656,20201215
20201212,과천선,정부과천청사,3573,3682,7255,20201215
20201212,과천선,과천,2718,2424,5142,20201215
20201212,과천선,대공원,1884,2110,3994,20201215
20201212,과천선,경마공원,807,791,1598,20201215
20201212,과천선,선바위,3346,3162,6508,20201215
20201212,공항철도 1호선,영종,1659,1738,3397,20201215
20201212,공항철도 1호선,인천공항2터미널,1535,1365,2900,20201215
20201212,공항철도 1호선,인천공항1터미널,2698,2892,5590,20201215
20201212,안산선,정왕,4391,4381,8772,20201215
20201212,안산선,오이도,4799,5026,9825,20201215
20201212,중앙선,용문,1093,1196,2289,20201215
20201212,중앙선,지평,32,27,59,20201215
20201212,일산선,마두,3439,3509,6948,20201215
20201212,수인선,연수,2739,2743,5482,20201215
20201212,수인선,송도,1566,1474,3040,20201215
20201212,수인선,인하대,3048,2784,5832,20201215
20201212,수인선,숭의,1983,1881,3864,20201215
20201212,수인선,신포,983,1044,2027,20201215
20201212,수인선,인천,714,1064,1778,20201215
20201212,안산선,산본,8003,8573,16576,20201215
20201212,안산선,대야미,2814,2432,5246,20201215
20201212,안산선,반월,2392,2280,4672,20201215
20201212,안산선,상록수,8836,8909,17745,20201215
20201212,안산선,한대앞,4797,4851,9648,20201215
20201212,안산선,중앙,9258,9839,19097,20201215
20201212,안산선,고잔,4211,4226,8437,20201215
20201212,안산선,초지,2045,2203,4248,20201215
20201212,안산선,안산,7770,8083,15853,20201215
20201212,안산선,신길온천,989,963,1952,20201215
20201212,일산선,정발산,3857,3852,7709,20201215
20201212,일산선,주엽,4150,4236,8386,20201215
20201212,일산선,대화,5771,5338,11109,20201215
20201212,장항선,봉명,607,583,1190,20201215
20201212,장항선,쌍용(나사렛대),1077,1017,2094,20201215
20201212,장항선,아산,1757,1777,3534,20201215
20201212,장항선,배방,723,619,1342,20201215
20201212,장항선,온양온천,2504,2582,5086,20201215
20201212,장항선,신창(순천향대),845,779,1624,20201215
20201212,중앙선,회기,12771,12140,24911,20201215
20201212,중앙선,중랑,3231,3106,6337,20201215
20201212,중앙선,상봉(시외버스터미널),3472,3404,6876,20201215
20201212,중앙선,양원,791,829,1620,20201215
20201212,중앙선,구리,6865,7119,13984,20201215
20201212,중앙선,도농,4474,4277,8751,20201215
20201212,중앙선,양정,421,353,774,20201215
20201212,중앙선,덕소,2923,3002,5925,20201215
20201212,중앙선,도심,1085,1002,2087,20201215
20201212,중앙선,팔당,876,953,1829,20201215
20201212,중앙선,운길산,781,712,1493,20201215
20201212,중앙선,양수,1203,1157,2360,20201215
20201212,중앙선,신원,202,155,357,20201215
20201212,중앙선,국수,366,413,779,20201215
20201212,중앙선,아신,375,380,755,20201215
20201213,5호선,미사,4296,4125,8421,20201216
20201213,중앙선,양평,1399,1169,2568,20201216
20201213,중앙선,원덕,164,117,281,20201216
20201213,중앙선,용문,1086,892,1978,20201216
20201213,중앙선,지평,27,18,45,20201216
20201213,장항선,봉명,363,367,730,20201216
20201213,장항선,쌍용(나사렛대),712,760,1472,20201216
20201213,장항선,아산,1848,1257,3105,20201216
20201213,장항선,배방,442,557,999,20201216
20201213,장항선,온양온천,2034,2091,4125,20201216
20201213,장항선,신창(순천향대),576,716,1292,20201216
20201213,중앙선,회기,8789,8745,17534,20201216
20201213,중앙선,중랑,2002,1970,3972,20201216
20201213,중앙선,상봉(시외버스터미널),2374,2278,4652,20201216
20201213,중앙선,망우,2627,2646,5273,20201216
20201213,중앙선,양원,476,451,927,20201216
20201213,중앙선,구리,4384,4700,9084,20201216
20201213,중앙선,도농,2827,2863,5690,20201216
20201213,중앙선,양정,276,212,488,20201216
20201213,중앙선,덕소,1933,1926,3859,20201216
20201213,중앙선,도심,728,663,1391,20201216
20201213,중앙선,팔당,743,710,1453,20201216
20201213,중앙선,운길산,550,593,1143,20201216
20201213,중앙선,양수,898,780,1678,20201216
20201213,중앙선,신원,104,93,197,20201216
20201213,중앙선,국수,364,337,701,20201216
20201213,중앙선,아신,279,271,550,20201216
20201213,중앙선,오빈,118,119,237,20201216
20201213,1호선,서울역,14350,13162,27512,20201216
20201213,1호선,동묘앞,5425,5533,10958,20201216
20201213,1호선,시청,4117,3918,8035,20201216
20201213,1호선,종각,6034,5733,11767,20201216
20201213,1호선,종로3가,6608,6064,12672,20201216
20201213,1호선,종로5가,3907,4182,8089,20201216
20201213,1호선,동대문,4904,5382,10286,20201216
20201213,1호선,신설동,4122,4098,8220,20201216
20201213,1호선,제기동,5255,5468,10723,20201216
20201213,1호선,청량리(서울시립대입구),8010,7967,15977,20201216
20201213,2호선,시청,3092,2580,5672,20201216
20201213,2호선,을지로입구,9581,9431,19012,20201216
20201213,2호선,을지로3가,3145,2869,6014,20201216
20201213,2호선,을지로4가,1895,1740,3635,20201216
20201213,2호선,동대문역사문화공원(DDP),4192,5088,9280,20201216
20201213,2호선,신당,4534,4938,9472,20201216
20201213,2호선,상왕십리,3933,4092,8025,20201216
20201213,2호선,왕십리(성동구청),5253,4375,9628,20201216
20201213,2호선,한양대,1534,1688,3222,20201216
20201213,2호선,뚝섬,4348,4557,8905,20201216
20201213,2호선,성수,4980,5435,10415,20201216
20201213,2호선,건대입구,12367,12740,25107,20201216
20201213,2호선,구의(광진구청),7073,7126,14199,20201216
20201213,2호선,강변(동서울터미널),12552,12234,24786,20201216
20201213,2호선,잠실나루,3182,3170,6352,20201216
20201213,2호선,잠실(송파구청),22905,21594,44499,20201216
20201213,2호선,잠실새내,5830,6041,11871,20201216
20201213,2호선,종합운동장,1866,2048,3914,20201216
20201213,2호선,삼성(무역센터),12058,11799,23857,20201216
20201213,2호선,선릉,7931,7081,15012,20201216
20201213,2호선,역삼,7056,7702,14758,20201216
20201213,2호선,강남,16263,15909,32172,20201216
20201213,2호선,교대(법원.검찰청),5533,6359,11892,20201216
20201213,2호선,서초,3836,3511,7347,20201216
20201213,2호선,방배,3807,4041,7848,20201216
20201213,2호선,사당,11466,12654,24120,20201216
20201213,2호선,낙성대(강감찬),9279,9894,19173,20201216
20201213,2호선,서울대입구(관악구청),15438,15999,31437,20201216
20201213,2호선,봉천,7560,7584,15144,20201216
20201213,2호선,신림,23270,23115,46385,20201216
20201213,2호선,신대방,9678,9497,19175,20201216
20201213,2호선,구로디지털단지,14818,14698,29516,20201216
20201213,2호선,대림(구로구청),9438,9763,19201,20201216
20201213,2호선,신도림,16235,16163,32398,20201216
20201213,2호선,문래,4050,4186,8236,20201216
20201213,2호선,영등포구청,4933,5166,10099,20201216
20201213,2호선,당산,4861,5479,10340,20201216
20201213,2호선,합정,9870,10064,19934,20201216
20201213,2호선,홍대입구,18536,17866,36402,20201216
20201213,2호선,신촌,11464,11207,22671,20201216
20201213,2호선,이대,4979,5065,10044,20201216
20201213,2호선,아현,3194,3128,6322,20201216
20201213,2호선,충정로(경기대입구),2359,2530,4889,20201216
20201213,2호선,용답,871,972,1843,20201216
20201213,2호선,신답,432,459,891,20201216
20201213,2호선,신설동,1478,1383,2861,20201216
20201213,2호선,도림천,250,283,533,20201216
20201213,2호선,양천구청,1831,1986,3817,20201216
20201213,2호선,신정네거리,2818,2846,5664,20201216
20201213,2호선,용두(동대문구청),619,662,1281,20201216
20201213,3호선,지축,1023,983,2006,20201216
20201213,3호선,구파발,6488,6422,12910,20201216
20201213,3호선,연신내,13525,12852,26377,20201216
20201213,3호선,불광,5906,6978,12884,20201216
20201213,3호선,녹번,4354,3821,8175,20201216
20201213,3호선,홍제,5613,5483,11096,20201216
20201213,3호선,무악재,1144,1177,2321,20201216
20201213,3호선,독립문,2402,2482,4884,20201216
20201213,3호선,경복궁(정부서울청사),4877,5041,9918,20201216
20201213,3호선,안국,3823,4031,7854,20201216
20201213,3호선,종로3가,1602,1975,3577,20201216
20201213,3호선,을지로3가,1504,1481,2985,20201216
20201213,3호선,동대입구,2934,3223,6157,20201216
20201213,3호선,약수,3647,3517,7164,20201216
20201213,3호선,금호,2556,2551,5107,20201216
20201213,3호선,옥수,2711,3010,5721,20201216
20201213,3호선,압구정,7443,7912,15355,20201216
20201213,3호선,신사,6745,7006,13751,20201216
20201213,3호선,잠원,1096,1156,2252,20201216
20201213,3호선,고속터미널,22064,20735,42799,20201216
20201213,3호선,교대(법원.검찰청),2085,1480,3565,20201216
20201213,3호선,남부터미널(예술의전당),8365,8542,16907,20201216
20201213,3호선,양재(서초구청),7559,8888,16447,20201216
20201213,3호선,매봉,2461,2539,5000,20201216
20201213,3호선,도곡,1204,1161,2365,20201216
20201213,3호선,대치,2576,2585,5161,20201216
20201213,3호선,학여울,397,425,822,20201216
20201213,3호선,대청,2414,2335,4749,20201216
20201213,3호선,일원,2008,2034,4042,20201216
20201213,3호선,수서,5739,5437,11176,20201216
20201213,3호선,가락시장,2256,2509,4765,20201216
20201213,3호선,경찰병원,1813,1802,3615,20201216
20201213,3호선,오금,1657,1606,3263,20201216
20201213,4호선,수유(강북구청),12241,11946,24187,20201216
20201213,4호선,미아(서울사이버대학),5046,4825,9871,20201216
20201213,4호선,미아사거리,10180,9573,19753,20201216
20201213,4호선,길음,5945,5949,11894,20201216
20201213,4호선,성신여대입구(돈암),6983,6720,13703,20201216
20201213,4호선,한성대입구(삼선교),4555,4546,9101,20201216
20201213,4호선,혜화,8418,8689,17107,20201216
20201213,4호선,동대문,3406,3980,7386,20201216
20201213,4호선,동대문역사문화공원(DDP),4911,5079,9990,20201216
20201213,4호선,충무로,4662,4765,9427,20201216
20201213,4호선,명동,5383,5479,10862,20201216
20201213,4호선,회현(남대문시장),5356,5443,10799,20201216
20201213,4호선,서울역,2395,4593,6988,20201216
20201213,4호선,숙대입구(갈월),3552,3371,6923,20201216
20201213,4호선,삼각지,1005,1263,2268,20201216
20201213,4호선,신용산,3736,3675,7411,20201216
20201213,4호선,이촌(국립중앙박물관),1938,2249,4187,20201216
20201213,4호선,동작(현충원),777,797,1574,20201216
20201213,4호선,총신대입구(이수),5795,6324,12119,20201216
20201213,4호선,사당,7636,7576,15212,20201216
20201213,4호선,남태령,324,299,623,20201216
20201213,4호선,당고개,4854,4638,9492,20201216
20201213,4호선,상계,6266,6047,12313,20201216
20201213,4호선,노원,6521,7113,13634,20201216
20201213,4호선,창동,8795,9386,18181,20201216
20201213,4호선,쌍문,9941,9190,19131,20201216
20201213,5호선,방화,2133,2177,4310,20201216
20201213,5호선,개화산,1623,1601,3224,20201216
20201213,5호선,김포공항,4270,4083,8353,20201216
20201213,5호선,송정,2335,2401,4736,20201216
20201213,5호선,마곡,1861,1932,3793,20201216
20201213,5호선,발산,4861,4950,9811,20201216
20201213,5호선,우장산,3676,3848,7524,20201216
20201213,5호선,화곡,8579,8112,16691,20201216
20201213,5호선,까치산,9463,9409,18872,20201216
20201213,5호선,신정(은행정),3990,3555,7545,20201216
20201213,5호선,목동,4648,4845,9493,20201216
20201213,5호선,오목교(목동운동장앞),6818,7202,14020,20201216
20201213,5호선,양평,1589,1654,3243,20201216
20201213,5호선,영등포구청,783,775,1558,20201216
20201213,5호선,영등포시장,2591,2873,5464,20201216
20201213,5호선,신길,1104,1339,2443,20201216
20201213,5호선,여의도,3372,3559,6931,20201216
20201213,5호선,여의나루,1895,1810,3705,20201216
20201213,5호선,마포,2763,2801,5564,20201216
20201213,5호선,공덕,2580,2749,5329,20201216
20201213,5호선,애오개,1556,1640,3196,20201216
20201213,5호선,충정로(경기대입구),875,930,1805,20201216
20201213,5호선,서대문,3207,3155,6362,20201216
20201213,5호선,광화문(세종문화회관),5541,5467,11008,20201216
20201213,5호선,종로3가,2926,2700,5626,20201216
20201213,5호선,을지로4가,786,836,1622,20201216
20201213,5호선,동대문역사문화공원(DDP),488,548,1036,20201216
20201213,5호선,청구,1095,987,2082,20201216
20201213,5호선,신금호,1792,1947,3739,20201216
20201213,5호선,행당,2484,2310,4794,20201216
20201213,5호선,왕십리(성동구청),1386,1473,2859,20201216
20201213,5호선,마장,1705,1662,3367,20201216
20201213,5호선,답십리,4514,4371,8885,20201216
20201213,5호선,장한평,4443,4514,8957,20201216
20201213,5호선,군자(능동),3691,4022,7713,20201216
20201213,5호선,아차산(어린이대공원후문),5573,5624,11197,20201216
20201213,5호선,광나루(장신대),4273,4246,8519,20201216
20201213,5호선,천호(풍납토성),7120,6889,14009,20201216
20201213,5호선,강동,6067,6047,12114,20201216
20201213,5호선,길동,2639,2689,5328,20201216
20201213,5호선,굽은다리(강동구민회관앞),3008,2829,5837,20201216
20201213,5호선,명일,2505,2508,5013,20201216
20201213,5호선,고덕,2139,2197,4336,20201216
20201213,5호선,상일동,3998,3983,7981,20201216
20201213,5호선,둔촌동,2713,2689,5402,20201216
20201213,5호선,올림픽공원(한국체대),1141,1024,2165,20201216
20201213,5호선,방이,2097,1994,4091,20201216
20201213,5호선,오금,965,889,1854,20201216
20201213,5호선,개롱,2070,2099,4169,20201216
20201213,5호선,거여,2235,2226,4461,20201216
20201213,5호선,마천,2056,2197,4253,20201216
20201213,5호선,하남풍산,1558,1649,3207,20201216
20201213,6호선,응암,5492,5662,11154,20201216
20201213,6호선,역촌,1196,1384,2580,20201216
20201213,6호선,불광,2160,1925,4085,20201216
20201213,6호선,독바위,919,1172,2091,20201216
20201213,6호선,구산,2286,1792,4078,20201216
20201213,6호선,새절(신사),4096,3919,8015,20201216
20201213,6호선,증산(명지대앞),3370,3432,6802,20201216
20201213,6호선,디지털미디어시티,3170,3412,6582,20201216
20201213,6호선,월드컵경기장(성산),1430,1490,2920,20201216
20201213,6호선,마포구청,4329,4124,8453,20201216
20201213,6호선,망원,4934,5142,10076,20201216
20201213,6호선,합정,4443,4056,8499,20201216
20201213,6호선,상수,2661,2886,5547,20201216
20201213,6호선,광흥창(서강),2203,2136,4339,20201216
20201213,6호선,대흥(서강대앞),2101,2227,4328,20201216
20201213,6호선,공덕,3872,3634,7506,20201216
20201213,6호선,효창공원앞,2046,1803,3849,20201216
20201213,6호선,삼각지,1528,1272,2800,20201216
20201213,6호선,녹사평(용산구청),1819,1702,3521,20201216
20201213,6호선,이태원,4099,3891,7990,20201216
20201213,6호선,한강진,2033,2287,4320,20201216
20201213,6호선,버티고개,674,697,1371,20201216
20201213,6호선,약수,957,1024,1981,20201216
20201213,6호선,청구,1071,1031,2102,20201216
20201213,6호선,신당,1955,2754,4709,20201216
20201213,6호선,동묘앞,3242,3337,6579,20201216
20201213,6호선,창신,1067,969,2036,20201216
20201213,6호선,보문,2416,2341,4757,20201216
20201213,6호선,안암(고대병원앞),2508,2680,5188,20201216
20201213,6호선,고려대(종암),2391,2339,4730,20201216
20201213,6호선,월곡(동덕여대),3296,3280,6576,20201216
20201213,6호선,상월곡(한국과학기술연구원),2101,1885,3986,20201216
20201213,6호선,돌곶이,3361,3075,6436,20201216
20201213,6호선,석계,4202,4298,8500,20201216
20201213,6호선,태릉입구,1747,1865,3612,20201216
20201213,6호선,화랑대(서울여대입구),3097,2614,5711,20201216
20201213,6호선,봉화산(서울의료원),2426,2327,4753,20201216
20201213,7호선,장암,807,508,1315,20201216
20201213,7호선,도봉산,3246,4808,8054,20201216
20201213,7호선,수락산,5396,5422,10818,20201216
20201213,7호선,마들,3685,3423,7108,20201216
20201213,7호선,노원,6646,6494,13140,20201216
20201213,7호선,중계,4368,4055,8423,20201216
20201213,7호선,하계,5763,5452,11215,20201216
20201213,7호선,공릉(서울과학기술대),4065,4175,8240,20201216
20201213,7호선,태릉입구,2883,2608,5491,20201216
20201213,7호선,먹골,3772,3733,7505,20201216
20201213,7호선,중화,3700,3742,7442,20201216
20201213,7호선,상봉(시외버스터미널),5719,5489,11208,20201216
20201213,7호선,면목,5207,5286,10493,20201216
20201213,7호선,사가정,5907,5881,11788,20201216
20201213,7호선,용마산(용마폭포공원),1977,2118,4095,20201216
20201213,7호선,중곡,3039,3058,6097,20201216
20201213,7호선,군자(능동),4753,3838,8591,20201216
20201213,7호선,어린이대공원(세종대),5533,5249,10782,20201216
20201213,7호선,건대입구,4529,4378,8907,20201216
20201213,7호선,뚝섬유원지,2390,2398,4788,20201216
20201213,7호선,청담,4657,4948,9605,20201216
20201213,7호선,강남구청,3720,4056,7776,20201216
20201213,7호선,학동,4285,4598,8883,20201216
20201213,7호선,논현,3989,4251,8240,20201216
20201213,7호선,반포,1748,1861,3609,20201216
20201213,7호선,고속터미널,7183,4920,12103,20201216
20201213,7호선,내방,3349,3404,6753,20201216
20201213,7호선,이수,4572,4455,9027,20201216
20201213,7호선,남성,3519,3620,7139,20201216
20201213,7호선,숭실대입구(살피재),3535,3689,7224,20201216
20201213,7호선,상도,5204,5012,10216,20201216
20201213,7호선,장승배기,3352,3241,6593,20201216
20201213,7호선,신대방삼거리,5177,5237,10414,20201216
20201213,7호선,보라매,3009,2998,6007,20201216
20201213,7호선,신풍,3885,3570,7455,20201216
20201213,7호선,대림(구로구청),4166,3899,8065,20201216
20201213,7호선,남구로,4794,4734,9528,20201216
20201213,7호선,가산디지털단지,7185,6637,13822,20201216
20201213,7호선,철산,6357,6283,12640,20201216
20201213,7호선,광명사거리,8003,7921,15924,20201216
20201213,7호선,천왕,3037,2913,5950,20201216
20201213,7호선,온수(성공회대입구),2411,2444,4855,20201216
20201213,7호선,까치울,2287,2354,4641,20201216
20201213,7호선,부천종합운동장,1374,1207,2581,20201216
20201213,7호선,춘의,2286,2129,4415,20201216
20201213,7호선,신중동,4037,3922,7959,20201216
20201213,7호선,부천시청,3776,3734,7510,20201216
20201213,7호선,상동,3838,3759,7597,20201216
20201213,7호선,삼산체육관,1254,1155,2409,20201216
20201213,7호선,굴포천,2745,2710,5455,20201216
20201213,7호선,부평구청,3177,2769,5946,20201216
20201213,8호선,암사,5789,5585,11374,20201216
20201213,8호선,천호(풍납토성),5877,6549,12426,20201216
20201213,8호선,강동구청,2781,2998,5779,20201216
20201213,8호선,몽촌토성(평화의문),1845,1945,3790,20201216
20201213,8호선,잠실(송파구청),5442,5896,11338,20201216
20201213,8호선,석촌,2498,2985,5483,20201216
20201213,8호선,송파,2563,2537,5100,20201216
20201213,8호선,가락시장,2275,3030,5305,20201216
20201213,8호선,문정,3510,3826,7336,20201216
20201213,8호선,장지,6095,6555,12650,20201216
20201213,8호선,복정,3320,3438,6758,20201216
20201213,8호선,산성,2466,2545,5011,20201216
20201213,8호선,남한산성입구(성남법원.검찰청),4451,4100,8551,20201216
20201213,8호선,단대오거리,3501,3464,6965,20201216
20201213,8호선,신흥,1823,2004,3827,20201216
20201213,8호선,수진,2046,1832,3878,20201216
20201213,8호선,모란,1800,1399,3199,20201216
20201213,9호선,개화,655,544,1199,20201216
20201213,9호선,김포공항,4771,6180,10951,20201216
20201213,9호선,공항시장,1002,1226,2228,20201216
20201213,9호선,신방화,2062,2037,4099,20201216
20201213,9호선,마곡나루(서울식물원),2784,2914,5698,20201216
20201213,9호선,양천향교,2346,2542,4888,20201216
20201213,9호선,가양,5972,6088,12060,20201216
20201213,9호선,증미,1558,1634,3192,20201216
20201213,9호선,등촌,3039,3181,6220,20201216
20201213,9호선,염창,5100,5056,10156,20201216
20201213,9호선,신목동,989,907,1896,20201216
20201213,9호선,선유도,1500,1537,3037,20201216
20201213,9호선,당산,5114,5082,10196,20201216
20201213,9호선,국회의사당,2512,2317,4829,20201216
20201213,9호선,여의도,3235,3007,6242,20201216
20201213,9호선,샛강,973,997,1970,20201216
20201213,9호선,노량진,8029,8662,16691,20201216
20201213,9호선,노들,1457,1316,2773,20201216
20201213,9호선,흑석(중앙대입구),5850,5054,10904,20201216
20201213,9호선,동작(현충원),552,476,1028,20201216
20201213,9호선,구반포,789,844,1633,20201216
20201213,9호선,신반포,722,720,1442,20201216
20201213,9호선,고속터미널,5183,6363,11546,20201216
20201213,9호선,사평,666,747,1413,20201216
20201213,9호선,신논현,7957,7552,15509,20201216
20201213,9호선2~3단계,언주,2346,2393,4739,20201216
20201213,9호선2~3단계,선정릉,1909,2122,4031,20201216
20201213,9호선2~3단계,삼성중앙,1240,1296,2536,20201216
20201213,9호선2~3단계,봉은사,4205,4285,8490,20201216
20201213,9호선2~3단계,종합운동장,1208,1140,2348,20201216
20201213,9호선2~3단계,삼전,2158,2199,4357,20201216
20201213,9호선2~3단계,석촌고분,1888,1929,3817,20201216
20201213,9호선2~3단계,석촌,2433,2115,4548,20201216
20201213,9호선2~3단계,송파나루,1500,1567,3067,20201216
20201213,9호선2~3단계,한성백제,752,774,1526,20201216
20201213,9호선2~3단계,올림픽공원(한국체대),1543,1585,3128,20201216
20201213,9호선2~3단계,둔촌오륜,263,267,530,20201216
20201213,9호선2~3단계,중앙보훈병원,1978,1834,3812,20201216
20201213,경강선,판교,1436,1419,2855,20201216
20201213,경강선,이매,374,216,590,20201216
20201213,경강선,삼동,627,611,1238,20201216
20201213,경강선,경기광주,2351,2334,4685,20201216
20201213,경강선,초월,927,976,1903,20201216
20201213,경강선,곤지암,920,977,1897,20201216
20201213,경강선,신둔도예촌,486,449,935,20201216
20201213,경강선,이천,1191,1328,2519,20201216
20201213,경강선,부발,786,1324,2110,20201216
20201213,경강선,세종대왕릉,138,122,260,20201216
20201213,경강선,여주,1149,954,2103,20201216
20201213,경부선,서울역,3414,775,4189,20201216
20201213,경부선,남영,2261,2486,4747,20201216
20201213,경부선,용산,15644,13899,29543,20201216
20201213,경부선,노량진,3289,3582,6871,20201216
20201213,경부선,대방,3551,3845,7396,20201216
20201213,경부선,영등포,17930,17214,35144,20201216
20201213,경부선,신도림,1146,1140,2286,20201216
20201213,경부선,신길,3005,2659,5664,20201216
20201213,경부선,구로,6339,6468,12807,20201216
20201213,경부선,가산디지털단지,2723,3784,6507,20201216
20201213,경부선,금천구청,3654,3627,7281,20201216
20201213,경부선,석수,3126,2969,6095,20201216
20201213,경부선,관악,2762,2581,5343,20201216
20201213,경부선,안양,8289,7981,16270,20201216
20201213,경부선,명학,2380,2274,4654,20201216
20201213,경부선,금정,8533,8985,17518,20201216
20201213,경부선,군포,2169,2151,4320,20201216
20201213,경부선,의왕,2595,2628,5223,20201216
20201213,경부선,성균관대,4123,4340,8463,20201216
20201213,경부선,화서,2204,2165,4369,20201216
20201213,경부선,수원,18684,18267,36951,20201216
20201213,경부선,독산,3600,3701,7301,20201216
20201213,경부선,세류,1336,1381,2717,20201216
20201213,경부선,병점,5274,5813,11087,20201216
20201213,경부선,세마,917,863,1780,20201216
20201213,경부선,오산대,1193,1165,2358,20201216
20201213,경부선,오산,4906,5236,10142,20201216
20201213,경부선,진위,496,516,1012,20201216
20201213,경부선,송탄,2365,2528,4893,20201216
20201213,경부선,서정리,2564,4042,6606,20201216
20201213,경부선,지제,1334,1400,2734,20201216
20201213,경부선,평택,7009,7727,14736,20201216
20201213,경부선,성환,1654,1950,3604,20201216
20201213,경부선,직산,355,360,715,20201216
20201213,경부선,두정,2509,2814,5323,20201216
20201213,경부선,천안,3666,3538,7204,20201216
20201213,경부선,당정,1746,1707,3453,20201216
20201213,경부선,서동탄,426,372,798,20201216
20201213,경부선,광명,1396,977,2373,20201216
20201213,경원선,이촌(국립중앙박물관),1034,893,1927,20201216
20201213,경원선,서빙고,491,516,1007,20201216
20201213,경원선,한남,1258,1181,2439,20201216
20201213,경원선,옥수,26,13,39,20201216
20201213,경원선,응봉,578,491,1069,20201216
20201213,경원선,왕십리(성동구청),4645,5523,10168,20201216
20201213,경원선,청량리(서울시립대입구),7102,6808,13910,20201216
20201213,경원선,외대앞,6547,5831,12378,20201216
20201213,경원선,신이문,3370,3153,6523,20201216
20201213,경원선,석계,3016,3262,6278,20201216
20201213,경원선,광운대,3715,3538,7253,20201216
20201213,경원선,월계,2240,2117,4357,20201216
20201213,경원선,녹천,1739,1487,3226,20201216
20201213,경원선,방학,3498,3348,6846,20201216
20201213,경원선,도봉,2288,2144,4432,20201216
20201213,경원선,도봉산,5083,3293,8376,20201216
20201213,경원선,망월사,2664,2797,5461,20201216
20201213,경원선,회룡,4285,4246,8531,20201216
20201213,경원선,의정부,8318,8271,16589,20201216
20201213,경원선,가능,2567,2453,5020,20201216
20201213,경원선,녹양,1773,1610,3383,20201216
20201213,경원선,양주,2917,2827,5744,20201216
20201213,경원선,덕계,915,854,1769,20201216
20201213,경원선,덕정,2056,2117,4173,20201216
20201213,경원선,지행,2770,2651,5421,20201216
20201213,경원선,동두천중앙,1322,1267,2589,20201216
20201213,경원선,보산,890,912,1802,20201216
20201213,경원선,동두천,839,967,1806,20201216
20201213,경원선,소요산,2018,1775,3793,20201216
20201213,경의선,서울역,529,611,1140,20201216
20201213,경의선,신촌,290,255,545,20201216
20201213,경의선,효창공원앞,750,896,1646,20201216
20201213,경의선,공덕,1135,822,1957,20201216
20201213,경의선,서강대,662,644,1306,20201216
20201213,경의선,홍대입구,574,640,1214,20201216
20201213,경의선,가좌,1640,1608,3248,20201216
20201213,경의선,디지털미디어시티,780,707,1487,20201216
20201213,경의선,수색,489,553,1042,20201216
20201213,경의선,화전,427,439,866,20201216
20201213,경의선,강매,811,750,1561,20201216
20201213,경의선,행신,2483,2408,4891,20201216
20201213,경의선,능곡,1311,1318,2629,20201216
20201213,경의선,곡산,192,175,367,20201216
20201213,경의선,백마,1971,1864,3835,20201216
20201213,경의선,풍산,1995,1843,3838,20201216
20201213,경의선,일산,2958,2750,5708,20201216
20201213,경의선,탄현,2484,2224,4708,20201216
20201213,경의선,야당,2210,2034,4244,20201216
20201213,경의선,운정,2000,1902,3902,20201216
20201213,경의선,금릉,1541,1511,3052,20201216
20201213,경의선,금촌,2507,2714,5221,20201216
20201213,경의선,월롱,558,925,1483,20201216
20201213,경의선,파주,434,379,813,20201216
20201213,경의선,문산,2216,2148,4364,20201216
20201213,경의선,임진강,21,24,45,20201216
20201213,경인선,개봉,6952,6986,13938,20201216
20201213,경인선,오류동,3956,3752,7708,20201216
20201213,경인선,역곡,8629,8597,17226,20201216
20201213,경인선,부천,13063,12653,25716,20201216
20201213,경인선,송내,7873,7719,15592,20201216
20201213,경인선,부평,12988,13146,26134,20201216
20201213,경인선,백운,2475,2401,4876,20201216
20201213,경인선,동암,6078,5986,12064,20201216
20201213,경인선,주안,7410,6545,13955,20201216
20201213,경인선,제물포,3196,3128,6324,20201216
20201213,경인선,동인천,5175,5110,10285,20201216
20201213,경인선,인천,1486,1174,2660,20201216
20201213,경인선,구일,1723,1706,3429,20201216
20201213,경인선,소사,3715,3551,7266,20201216
20201213,경인선,부개,2881,2679,5560,20201216
20201213,경인선,간석,1917,1784,3701,20201216
20201213,경인선,도원,1002,1011,2013,20201216
20201213,경인선,온수(성공회대입구),1957,1909,3866,20201216
20201213,경인선,중동,2974,2785,5759,20201216
20201213,경인선,도화,1382,1370,2752,20201216
20201213,경춘선,신내,452,476,928,20201216
20201213,경춘선,갈매,834,723,1557,20201216
20201213,경춘선,별내,964,973,1937,20201216
20201213,경춘선,퇴계원,1224,1198,2422,20201216
20201213,경춘선,사릉,1059,1020,2079,20201216
20201213,경춘선,금곡,536,491,1027,20201216
20201213,경춘선,평내호평,1940,1888,3828,20201216
20201213,경춘선,천마산,696,625,1321,20201216
20201213,경춘선,마석,1553,1544,3097,20201216
20201213,경춘선,대성리,324,253,577,20201216
20201213,경춘선,청평,786,630,1416,20201216
20201213,경춘선,상천,192,183,375,20201216
20201213,경춘선,가평,880,708,1588,20201216
20201213,경춘선,굴봉산,83,81,164,20201216
20201213,경춘선,백양리,155,136,291,20201216
20201213,경춘선,강촌,333,276,609,20201216
20201213,경춘선,김유정,258,249,507,20201216
20201213,경춘선,남춘천,1359,1449,2808,20201216
20201213,경춘선,춘천,787,767,1554,20201216
20201213,공항철도 1호선,서울역,3806,3175,6981,20201216
20201213,공항철도 1호선,공덕,688,1048,1736,20201216
20201213,공항철도 1호선,홍대입구,3354,3290,6644,20201216
20201213,공항철도 1호선,디지털미디어시티,2240,2195,4435,20201216
20201213,공항철도 1호선,마곡나루(서울식물원),989,1065,2054,20201216
20201213,공항철도 1호선,김포공항,7166,4407,11573,20201216
20201213,공항철도 1호선,계양,2808,2793,5601,20201216
20201213,공항철도 1호선,검암,2292,2404,4696,20201216
20201213,공항철도 1호선,청라국제도시,1671,1591,3262,20201216
20201213,공항철도 1호선,운서,3083,3204,6287,20201216
20201213,공항철도 1호선,공항화물청사,849,922,1771,20201216
20201213,공항철도 1호선,인천공항1터미널,2413,2503,4916,20201216
20201213,공항철도 1호선,인천공항2터미널,1391,1312,2703,20201216
20201213,공항철도 1호선,영종,1331,1237,2568,20201216
20201213,과천선,선바위,1957,1911,3868,20201216
20201213,과천선,경마공원,506,501,1007,20201216
20201213,과천선,대공원,1299,1409,2708,20201216
20201213,과천선,과천,1800,1709,3509,20201216
20201213,과천선,정부과천청사,2232,2363,4595,20201216
20201213,과천선,인덕원,6536,6514,13050,20201216
20201213,과천선,평촌,3987,3924,7911,20201216
20201213,과천선,범계,8359,8046,16405,20201216
20201213,분당선,선릉,1894,2761,4655,20201216
20201213,분당선,한티,4238,4471,8709,20201216
20201213,분당선,도곡,1435,1505,2940,20201216
20201213,분당선,구룡,384,368,752,20201216
20201213,분당선,개포동,981,1066,2047,20201216
20201213,분당선,대모산입구,1187,1079,2266,20201216
20201213,분당선,수서,5490,5470,10960,20201216
20201213,분당선,수원,3354,2685,6039,20201216
20201213,분당선,서울숲,2114,2118,4232,20201216
20201213,분당선,압구정로데오,5742,6290,12032,20201216
20201213,분당선,강남구청,1890,2367,4257,20201216
20201213,분당선,선정릉,1512,1472,2984,20201216
20201213,분당선,가천대,15463,13872,29335,20201216
20201213,분당선,태평,6923,5839,12762,20201216
20201213,분당선,모란,7976,8221,16197,20201216
20201213,분당선,야탑,8265,8690,16955,20201216
20201213,분당선,서현,8013,8134,16147,20201216
20201213,분당선,수내,3880,3960,7840,20201216
20201213,분당선,정자,4415,4481,8896,20201216
20201213,분당선,미금,4442,4705,9147,20201216
20201213,분당선,오리,3489,3173,6662,20201216
20201213,분당선,이매,1656,1782,3438,20201216
20201213,분당선,보정,646,565,1211,20201216
20201213,분당선,죽전,4585,5252,9837,20201216
20201213,분당선,구성,1362,1435,2797,20201216
20201213,분당선,신갈,1178,1166,2344,20201216
20201213,분당선,기흥,3072,2982,6054,20201216
20201213,분당선,상갈,1763,1687,3450,20201216
20201213,분당선,청명,1152,1201,2353,20201216
20201213,분당선,영통,2468,2512,4980,20201216
20201213,분당선,망포,3555,3877,7432,20201216
20201213,분당선,매탄권선,1419,1409,2828,20201216
20201213,분당선,수원시청,4153,4095,8248,20201216
20201213,분당선,매교,793,807,1600,20201216
20201213,수인선,고색,983,953,1936,20201216
20201213,수인선,오목천,763,765,1528,20201216
20201213,수인선,어천,216,298,514,20201216
20201213,수인선,야목,78,78,156,20201216
20201213,수인선,사리,1285,1085,2370,20201216
20201213,수인선,달월,42,45,87,20201216
20201213,수인선,월곶,927,944,1871,20201216
20201213,수인선,소래포구,2229,2241,4470,20201216
20201213,수인선,인천논현,1775,1832,3607,20201216
20201213,수인선,호구포,1339,1370,2709,20201216
20201213,수인선,남동인더스파크,485,492,977,20201216
20201213,수인선,원인재,1679,1716,3395,20201216
20201213,수인선,연수,1883,1798,3681,20201216
20201213,수인선,송도,952,892,1844,20201216
20201213,수인선,인하대,1751,1750,3501,20201216
20201213,수인선,숭의,1189,1110,2299,20201216
20201213,수인선,신포,632,625,1257,20201216
20201213,수인선,인천,525,730,1255,20201216
20201213,안산선,산본,4929,5148,10077,20201216
20201213,안산선,대야미,1702,1607,3309,20201216
20201213,안산선,반월,1486,1496,2982,20201216
20201213,안산선,상록수,5903,5728,11631,20201216
20201213,안산선,한대앞,3080,3127,6207,20201216
20201213,안산선,중앙,6314,6179,12493,20201216
20201213,안산선,고잔,2763,2686,5449,20201216
20201213,안산선,초지,1406,1387,2793,20201216
20201213,안산선,안산,6968,6353,13321,20201216
20201213,안산선,신길온천,675,620,1295,20201216
20201213,안산선,정왕,3337,3590,6927,20201216
20201213,안산선,오이도,3246,3176,6422,20201216
20201213,안산선,수리산,1337,1251,2588,20201216
20201213,우이신설선,북한산우이,1382,1534,2916,20201216
20201213,우이신설선,솔밭공원,834,808,1642,20201216
20201213,우이신설선,4.19민주묘지,1102,1027,2129,20201216
20201213,우이신설선,가오리,1366,1305,2671,20201216
20201213,우이신설선,화계,1233,1132,2365,20201216
20201213,우이신설선,삼양,669,721,1390,20201216
20201213,우이신설선,삼양사거리,909,965,1874,20201216
20201213,우이신설선,솔샘,1622,1487,3109,20201216
20201213,우이신설선,북한산보국문,2135,1960,4095,20201216
20201213,우이신설선,정릉,1481,1377,2858,20201216
20201213,우이신설선,성신여대입구(돈암),1124,1308,2432,20201216
20201213,우이신설선,보문,555,595,1150,20201216
20201213,우이신설선,신설동,653,623,1276,20201216
20201213,일산선,원흥,2928,2791,5719,20201216
20201213,일산선,삼송,6177,6020,12197,20201216
20201213,일산선,원당,3730,3563,7293,20201216
20201213,일산선,화정,5580,5848,11428,20201216
20201213,일산선,대곡,576,468,1044,20201216
20201213,일산선,백석,3794,3697,7491,20201216
20201213,일산선,마두,2064,2085,4149,20201216
20201213,일산선,정발산,2847,2642,5489,20201216
20201213,일산선,주엽,2580,2540,5120,20201216
20201213,일산선,대화,4059,3732,7791,20201216
20201214,2호선,상왕십리,10703,10612,21315,20201217
20201214,2호선,왕십리(성동구청),11307,8877,20184,20201217
20201214,2호선,한양대,5404,5701,11105,20201217
20201214,2호선,뚝섬,15542,16898,32440,20201217
20201214,2호선,성수,27322,29613,56935,20201217
20201214,2호선,건대입구,22599,24205,46804,20201217
20201214,2호선,구의(광진구청),18636,18714,37350,20201217
20201214,2호선,강변(동서울터미널),22456,22154,44610,20201217
20201214,2호선,잠실나루,11031,10664,21695,20201217
20201214,2호선,잠실(송파구청),45172,45740,90912,20201217
20201214,2호선,잠실새내,14736,14658,29394,20201217
20201214,2호선,종합운동장,4993,5485,10478,20201217
20201214,2호선,삼성(무역센터),38234,38188,76422,20201217
20201214,2호선,선릉,46761,41338,88099,20201217
20201214,2호선,역삼,41759,44491,86250,20201217
20201214,2호선,강남,58587,57246,115833,20201217
20201214,2호선,교대(법원.검찰청),26748,29509,56257,20201217
20201214,2호선,서초,17273,17179,34452,20201217
20201214,2호선,방배,12661,13149,25810,20201217
20201214,2호선,사당,25849,28455,54304,20201217
20201214,2호선,낙성대(강감찬),21403,21230,42633,20201217
20201214,2호선,서울대입구(관악구청),36126,35140,71266,20201217
20201214,2호선,봉천,19423,18428,37851,20201217
20201214,2호선,신림,50035,49311,99346,20201217
20201214,2호선,신대방,21441,20877,42318,20201217
20201214,2호선,구로디지털단지,49936,50555,100491,20201217
20201214,2호선,대림(구로구청),20550,20804,41354,20201217
20201214,2호선,신도림,37071,35729,72800,20201217
20201214,2호선,문래,16883,17114,33997,20201217
20201214,2호선,영등포구청,19093,19339,38432,20201217
20201214,2호선,당산,14188,16751,30939,20201217
20201214,2호선,합정,20668,21263,41931,20201217
20201214,2호선,홍대입구,30948,31452,62400,20201217
20201214,2호선,신촌,21072,22004,43076,20201217
20201214,2호선,이대,8506,8789,17295,20201217
20201214,2호선,아현,7655,7603,15258,20201217
20201214,2호선,충정로(경기대입구),8318,8724,17042,20201217
20201214,2호선,용답,1951,2014,3965,20201217
20201214,2호선,신답,1235,1501,2736,20201217
20201214,2호선,신설동,2634,2512,5146,20201217
20201214,2호선,도림천,1171,1246,2417,20201217
20201214,2호선,양천구청,5250,5594,10844,20201217
20201214,2호선,신정네거리,7870,8155,16025,20201217
20201214,2호선,용두(동대문구청),1828,1961,3789,20201217
20201214,3호선,지축,2540,2546,5086,20201217
20201214,3호선,구파발,16130,15078,31208,20201217
20201214,3호선,연신내,29395,27565,56960,20201217
20201214,3호선,불광,12616,13386,26002,20201217
20201214,3호선,녹번,11895,11115,23010,20201217
20201214,3호선,홍제,13203,13009,26212,20201217
20201214,3호선,무악재,3075,3154,6229,20201217
20201214,3호선,독립문,5169,5364,10533,20201217
20201214,3호선,경복궁(정부서울청사),13235,12970,26205,20201217
20201214,3호선,안국,13580,13426,27006,20201217
20201214,3호선,종로3가,7689,8560,16249,20201217
20201214,3호선,을지로3가,8343,8546,16889,20201217
20201214,3호선,동대입구,5454,5745,11199,20201217
20201214,3호선,약수,10103,9928,20031,20201217
20201214,3호선,금호,6153,6059,12212,20201217
20201214,3호선,옥수,6469,6952,13421,20201217
20201214,3호선,압구정,24002,25490,49492,20201217
20201214,3호선,신사,22638,23484,46122,20201217
20201214,3호선,잠원,3570,3636,7206,20201217
20201214,3호선,고속터미널,27265,25549,52814,20201217
20201214,3호선,교대(법원.검찰청),10875,7356,18231,20201217
20201214,3호선,남부터미널(예술의전당),22357,23196,45553,20201217
20201214,3호선,양재(서초구청),30654,33248,63902,20201217
20201214,3호선,매봉,9996,9364,19360,20201217
20201214,3호선,도곡,4216,4286,8502,20201217
20201214,3호선,대치,7554,7524,15078,20201217
20201214,3호선,학여울,1307,1358,2665,20201217
20201214,3호선,대청,7634,7001,14635,20201217
20201214,3호선,일원,7803,7707,15510,20201217
20201214,3호선,수서,12384,12693,25077,20201217
20201214,3호선,가락시장,7078,6781,13859,20201217
20201214,3호선,경찰병원,6403,6494,12897,20201217
20201214,3호선,오금,4947,4456,9403,20201217
20201214,4호선,수유(강북구청),27132,26953,54085,20201217
20201214,4호선,미아(서울사이버대학),11881,11734,23615,20201217
20201214,4호선,미아사거리,21943,21536,43479,20201217
20201214,4호선,길음,15572,15548,31120,20201217
20201214,4호선,성신여대입구(돈암),14004,13646,27650,20201217
20201214,4호선,한성대입구(삼선교),9928,9916,19844,20201217
20201214,4호선,혜화,21122,20704,41826,20201217
20201214,4호선,동대문,16008,16489,32497,20201217
20201214,4호선,동대문역사문화공원(DDP),11546,10796,22342,20201217
20201214,4호선,충무로,21934,22557,44491,20201217
20201214,4호선,명동,12833,13157,25990,20201217
20201214,4호선,회현(남대문시장),17350,17710,35060,20201217
20201214,4호선,서울역,8568,10784,19352,20201217
20201214,4호선,숙대입구(갈월),9909,9620,19529,20201217
20201214,4호선,삼각지,3550,3802,7352,20201217
20201214,4호선,신용산,11361,11921,23282,20201217
20201214,4호선,이촌(국립중앙박물관),5080,5729,10809,20201217
20201214,4호선,동작(현충원),1673,1874,3547,20201217
20201214,4호선,총신대입구(이수),14088,15384,29472,20201217
20201214,4호선,사당,17441,14641,32082,20201217
20201214,4호선,남태령,838,763,1601,20201217
20201214,4호선,당고개,9818,8914,18732,20201217
20201214,4호선,상계,15212,14247,29459,20201217
20201214,4호선,노원,13868,15318,29186,20201217
20201214,4호선,창동,19973,21401,41374,20201217
20201214,4호선,쌍문,24259,22337,46596,20201217
20201214,5호선,방화,5514,5284,10798,20201217
20201214,5호선,개화산,4078,3990,8068,20201217
20201214,5호선,김포공항,5217,5002,10219,20201217
20201214,5호선,송정,5178,4870,10048,20201217
20201214,5호선,마곡,7858,7508,15366,20201217
20201214,5호선,발산,14344,14385,28729,20201217
20201214,5호선,우장산,10343,10577,20920,20201217
20201214,5호선,화곡,23208,21916,45124,20201217
20201214,5호선,까치산,23135,22555,45690,20201217
20201214,5호선,신정(은행정),11569,9240,20809,20201217
20201214,5호선,목동,13278,14889,28167,20201217
20201214,5호선,오목교(목동운동장앞),16917,18229,35146,20201217
20201214,5호선,양평,6255,6347,12602,20201217
20201214,5호선,영등포구청,3335,3323,6658,20201217
20201214,5호선,영등포시장,7327,7587,14914,20201217
20201214,5호선,신길,3115,3648,6763,20201217
20201214,5호선,여의도,22069,22540,44609,20201217
20201214,5호선,여의나루,5621,5883,11504,20201217
20201214,5호선,마포,11317,11725,23042,20201217
20201214,5호선,공덕,11105,11964,23069,20201217
20201214,5호선,애오개,5233,5353,10586,20201217
20201214,5호선,충정로(경기대입구),4154,4308,8462,20201217
20201214,5호선,서대문,15792,15974,31766,20201217
20201214,5호선,광화문(세종문화회관),23876,24327,48203,20201217
20201214,5호선,종로3가,7038,6772,13810,20201217
20201214,5호선,을지로4가,4964,4981,9945,20201217
20201214,5호선,동대문역사문화공원(DDP),2653,2890,5543,20201217
20201214,5호선,청구,3264,3032,6296,20201217
20201214,5호선,신금호,4840,5066,9906,20201217
20201214,5호선,행당,6446,5838,12284,20201217
20201214,5호선,왕십리(성동구청),3474,3674,7148,20201217
20201214,5호선,마장,4406,4205,8611,20201217
20201214,5호선,답십리,13176,12315,25491,20201217
20201214,5호선,장한평,15042,14952,29994,20201217
20201214,5호선,군자(능동),8555,9212,17767,20201217
20201214,5호선,아차산(어린이대공원후문),10912,10957,21869,20201217
20201214,5호선,광나루(장신대),9615,8814,18429,20201217
20201214,5호선,천호(풍납토성),13336,13389,26725,20201217
20201214,5호선,강동,16120,15236,31356,20201217
20201214,5호선,길동,6156,6436,12592,20201217
20201214,5호선,굽은다리(강동구민회관앞),7469,7244,14713,20201217
20201214,5호선,명일,6524,6769,13293,20201217
20201214,5호선,고덕,6808,6762,13570,20201217
20201214,5호선,상일동,12675,11710,24385,20201217
20201214,5호선,둔촌동,6453,6570,13023,20201217
20201214,5호선,올림픽공원(한국체대),3261,2795,6056,20201217
20201214,5호선,방이,5185,5398,10583,20201217
20201214,5호선,오금,3082,3017,6099,20201217
20201214,5호선,개롱,5072,5354,10426,20201217
20201214,5호선,거여,6364,6203,12567,20201217
20201214,5호선,마천,4729,4827,9556,20201217
20201214,5호선,미사,10381,10491,20872,20201217
20201214,5호선,하남풍산,3891,3840,7731,20201217
20201214,6호선,응암,14177,14282,28459,20201217
20201214,6호선,역촌,3048,3512,6560,20201217
20201214,6호선,불광,3409,3527,6936,20201217
20201214,6호선,독바위,2270,2451,4721,20201217
20201214,6호선,연신내,1,0,1,20201217
20201214,6호선,구산,5818,4625,10443,20201217
20201214,6호선,새절(신사),10406,9867,20273,20201217
20201214,6호선,증산(명지대앞),8123,8108,16231,20201217
20201214,6호선,디지털미디어시티,11545,12656,24201,20201217
20201214,6호선,월드컵경기장(성산),3161,3305,6466,20201217
20201214,6호선,마포구청,11223,10255,21478,20201217
20201214,6호선,망원,9892,10749,20641,20201217
20201214,6호선,합정,8922,8752,17674,20201217
20201214,6호선,상수,5675,5938,11613,20201217
20201214,6호선,광흥창(서강),6809,6734,13543,20201217
20201214,6호선,대흥(서강대앞),5985,6240,12225,20201217
20201214,6호선,공덕,14372,14075,28447,20201217
20201214,6호선,효창공원앞,5597,5142,10739,20201217
20201214,6호선,삼각지,3968,3589,7557,20201217
20201214,6호선,녹사평(용산구청),3163,3072,6235,20201217
20201214,6호선,이태원,6089,6156,12245,20201217
20201214,6호선,한강진,4856,5478,10334,20201217
20201214,6호선,버티고개,1788,1713,3501,20201217
20201214,6호선,약수,2768,2801,5569,20201217
20201214,6호선,청구,3096,3326,6422,20201217
20201214,6호선,신당,6045,6626,12671,20201217
20201214,6호선,동묘앞,6275,6413,12688,20201217
20201214,6호선,창신,2806,2370,5176,20201217
20201214,6호선,보문,5723,5358,11081,20201217
20201214,6호선,안암(고대병원앞),7009,7026,14035,20201217
20201214,6호선,고려대(종암),5780,5782,11562,20201217
20201214,6호선,월곡(동덕여대),8956,8949,17905,20201217
20201214,6호선,상월곡(한국과학기술연구원),5059,4596,9655,20201217
20201214,6호선,돌곶이,6901,6611,13512,20201217
20201214,6호선,석계,9866,10318,20184,20201217
20201214,6호선,태릉입구,4077,4521,8598,20201217
20201214,6호선,화랑대(서울여대입구),9207,7375,16582,20201217
20201214,6호선,봉화산(서울의료원),7358,6886,14244,20201217
20201214,6호선,신내,1,0,1,20201217
20201214,7호선,장암,1904,643,2547,20201217
20201214,7호선,도봉산,7270,8340,15610,20201217
20201214,7호선,수락산,9789,9934,19723,20201217
20201214,7호선,마들,9890,9705,19595,20201217
20201214,7호선,노원,14562,14849,29411,20201217
20201214,7호선,중계,11411,10602,22013,20201217
20201214,7호선,하계,13826,13336,27162,20201217
20201214,7호선,공릉(서울과학기술대),8709,8849,17558,20201217
20201214,7호선,태릉입구,6234,5772,12006,20201217
20201214,7호선,먹골,8253,8097,16350,20201217
20201214,7호선,중화,9036,8985,18021,20201217
20201214,7호선,상봉(시외버스터미널),13357,12621,25978,20201217
20201214,7호선,면목,12584,12600,25184,20201217
20201214,7호선,사가정,13380,13578,26958,20201217
20201214,7호선,용마산(용마폭포공원),4894,4752,9646,20201217
20201214,7호선,중곡,8198,7771,15969,20201217
20201214,7호선,군자(능동),11572,9408,20980,20201217
20201214,7호선,어린이대공원(세종대),9519,9426,18945,20201217
20201214,7호선,건대입구,9424,9431,18855,20201217
20201214,7호선,뚝섬유원지,5213,5237,10450,20201217
20201214,7호선,청담,15785,17325,33110,20201217
20201214,7호선,강남구청,12709,13788,26497,20201217
20201214,7호선,학동,20840,21881,42721,20201217
20201214,7호선,논현,16350,17808,34158,20201217
20201214,7호선,반포,4512,4443,8955,20201217
20201214,7호선,고속터미널,11771,10051,21822,20201217
20201214,7호선,내방,11866,12070,23936,20201217
20201214,7호선,이수,11664,11542,23206,20201217
20201214,7호선,남성,9041,8517,17558,20201217
20201214,7호선,숭실대입구(살피재),9365,9696,19061,20201217
20201214,7호선,상도,7739,7587,15326,20201217
20201214,7호선,장승배기,7851,7696,15547,20201217
20201214,7호선,신대방삼거리,13454,13223,26677,20201217
20201214,7호선,보라매,7980,8029,16009,20201217
20201214,7호선,신풍,9391,9022,18413,20201217
20201214,7호선,대림(구로구청),6342,6372,12714,20201217
20201214,7호선,남구로,14363,15269,29632,20201217
20201214,7호선,가산디지털단지,41574,41635,83209,20201217
20201214,7호선,철산,17205,17454,34659,20201217
20201214,7호선,광명사거리,18567,18430,36997,20201217
20201214,7호선,천왕,9077,8664,17741,20201217
20201214,7호선,온수(성공회대입구),9134,8437,17571,20201217
20201214,7호선,까치울,6108,5982,12090,20201217
20201214,7호선,부천종합운동장,3885,3307,7192,20201217
20201214,7호선,춘의,8493,8456,16949,20201217
20201214,7호선,신중동,11523,11254,22777,20201217
20201214,7호선,부천시청,9828,9888,19716,20201217
20201214,7호선,상동,9349,9716,19065,20201217
20201214,7호선,삼산체육관,3871,3385,7256,20201217
20201214,7호선,굴포천,7202,7503,14705,20201217
20201214,7호선,부평구청,9689,8015,17704,20201217
20201214,8호선,암사,15341,13905,29246,20201217
20201214,8호선,천호(풍납토성),12021,13337,25358,20201217
20201214,8호선,강동구청,8588,9060,17648,20201217
20201214,8호선,몽촌토성(평화의문),4351,4496,8847,20201217
20201214,8호선,잠실(송파구청),10411,11560,21971,20201217
20201214,8호선,석촌,5836,6639,12475,20201217
20201214,8호선,송파,6164,6267,12431,20201217
20201214,8호선,가락시장,6260,7026,13286,20201217
20201214,8호선,문정,18556,19323,37879,20201217
20201214,8호선,장지,13476,13525,27001,20201217
20201214,8호선,복정,8037,7097,15134,20201217
20201214,8호선,산성,5419,5473,10892,20201217
20201214,8호선,남한산성입구(성남법원.검찰청),11050,10233,21283,20201217
20201214,8호선,단대오거리,8231,8074,16305,20201217
20201214,8호선,신흥,3720,3999,7719,20201217
20201214,8호선,수진,4265,3917,8182,20201217
20201214,8호선,모란,3766,2807,6573,20201217
20201214,9호선,개화,2032,1419,3451,20201217
20201214,9호선,김포공항,5519,6720,12239,20201217
20201214,9호선,공항시장,2272,2533,4805,20201217
20201214,9호선,신방화,5345,5520,10865,20201217
20201214,9호선,마곡나루(서울식물원),8137,8190,16327,20201217
20201214,9호선,양천향교,7509,7713,15222,20201217
20201214,9호선,가양,15904,15747,31651,20201217
20201214,9호선,등촌,8735,8784,17519,20201217
20201214,9호선,염창,13425,13458,26883,20201217
20201214,9호선,신목동,2960,2658,5618,20201217
20201214,9호선,선유도,6274,6155,12429,20201217
20201214,9호선,당산,13572,13615,27187,20201217
20201214,9호선,국회의사당,13457,13291,26748,20201217
20201214,9호선,여의도,18754,17972,36726,20201217
20201214,9호선,샛강,4379,4621,9000,20201217
20201214,9호선,노량진,17490,17166,34656,20201217
20201214,9호선,노들,3425,3120,6545,20201217
20201214,9호선,흑석(중앙대입구),5399,5727,11126,20201217
20201214,9호선,동작(현충원),1263,968,2231,20201217
20201214,9호선,구반포,1988,2081,4069,20201217
20201214,9호선,신반포,2251,2253,4504,20201217
20201214,9호선,고속터미널,7753,9460,17213,20201217
20201214,9호선,사평,2302,2399,4701,20201217
20201214,9호선,신논현,22226,21856,44082,20201217
20201214,9호선2~3단계,언주,8231,8197,16428,20201217
20201214,9호선2~3단계,선정릉,7379,7931,15310,20201217
20201214,9호선2~3단계,삼성중앙,5457,5499,10956,20201217
20201214,9호선2~3단계,봉은사,11182,11235,22417,20201217
20201214,9호선2~3단계,종합운동장,3154,3075,6229,20201217
20201214,9호선2~3단계,삼전,5072,5150,10222,20201217
20201214,9호선2~3단계,석촌고분,4438,4557,8995,20201217
20201214,9호선2~3단계,석촌,5635,5077,10712,20201217
20201214,9호선2~3단계,송파나루,3439,3570,7009,20201217
20201214,9호선2~3단계,한성백제,1721,1621,3342,20201217
20201214,9호선2~3단계,올림픽공원(한국체대),3937,3839,7776,20201217
20201214,9호선2~3단계,둔촌오륜,875,760,1635,20201217
20201214,9호선2~3단계,중앙보훈병원,7810,6961,14771,20201217
20201214,경강선,판교,3494,3251,6745,20201217
20201214,경강선,이매,788,689,1477,20201217
20201214,경강선,삼동,1835,1767,3602,20201217
20201214,경강선,경기광주,5380,5114,10494,20201217
20201214,경강선,초월,2259,2291,4550,20201217
20201214,경강선,곤지암,1548,1542,3090,20201217
20201214,경강선,신둔도예촌,884,824,1708,20201217
20201214,경강선,이천,1724,1767,3491,20201217
20201214,경강선,부발,1309,1330,2639,20201217
20201214,경강선,세종대왕릉,187,167,354,20201217
20201214,경강선,여주,1188,1178,2366,20201217
20201214,경부선,서울역,3490,1096,4586,20201217
20201214,경부선,남영,7522,7848,15370,20201217
20201214,경부선,용산,22529,22799,45328,20201217
20201214,경부선,노량진,5433,6170,11603,20201217
20201214,경부선,대방,10132,10598,20730,20201217
20201214,경부선,영등포,27150,27861,55011,20201217
20201214,경부선,신도림,3151,3062,6213,20201217
20201214,경부선,신길,7669,6429,14098,20201217
20201214,경부선,구로,15368,15290,30658,20201217
20201214,경부선,가산디지털단지,14653,17728,32381,20201217
20201214,경부선,금천구청,9353,9254,18607,20201217
20201214,경부선,석수,8339,7237,15576,20201217
20201214,경부선,관악,5576,5194,10770,20201217
20201214,경부선,안양,16753,16851,33604,20201217
20201214,경부선,명학,7877,7899,15776,20201217
20201214,경부선,금정,20730,21651,42381,20201217
20201214,경부선,군포,6544,6722,13266,20201217
20201214,경부선,의왕,7060,7023,14083,20201217
20201214,경부선,성균관대,10352,10424,20776,20201217
20201214,경부선,화서,5670,5494,11164,20201217
20201214,경부선,수원,23180,24229,47409,20201217
20201214,경부선,독산,14561,15591,30152,20201217
20201214,경부선,세류,2339,2136,4475,20201217
20201214,경부선,병점,9844,9663,19507,20201217
20201214,경부선,세마,1917,1763,3680,20201217
20201214,경부선,오산대,2579,2450,5029,20201217
20201214,경부선,오산,7274,7413,14687,20201217
20201214,경부선,진위,1234,1078,2312,20201217
20201214,경부선,송탄,3178,3133,6311,20201217
20201214,경부선,서정리,5006,4944,9950,20201217
20201214,경부선,지제,2197,2035,4232,20201217
20201214,경부선,평택,8363,8327,16690,20201217
20201214,경부선,성환,2772,2952,5724,20201217
20201214,경부선,직산,550,553,1103,20201217
20201214,경부선,두정,3774,3871,7645,20201217
20201214,경부선,천안,3423,3551,6974,20201217
20201214,경부선,당정,4834,4633,9467,20201217
20201214,경부선,서동탄,1216,973,2189,20201217
20201214,경부선,광명,2467,2118,4585,20201217
20201214,경원선,이촌(국립중앙박물관),2826,2214,5040,20201217
20201214,경원선,서빙고,1466,1328,2794,20201217
20201214,경원선,한남,3289,3155,6444,20201217
20201214,경원선,옥수,26,18,44,20201217
20201214,경원선,응봉,1307,1147,2454,20201217
20201214,경원선,왕십리(성동구청),9403,10955,20358,20201217
20201214,경원선,청량리(서울시립대입구),9491,10296,19787,20201217
20201214,경원선,외대앞,5127,5241,10368,20201217
20201214,경원선,신이문,6870,6382,13252,20201217
20201214,경원선,석계,6250,7237,13487,20201217
20201214,경원선,광운대,6770,6432,13202,20201217
20201214,경원선,월계,5031,4788,9819,20201217
20201214,경원선,녹천,3787,3265,7052,20201217
20201214,경원선,창동,2,0,2,20201217
20201214,경원선,방학,7396,7365,14761,20201217
20201214,경원선,도봉,4692,4494,9186,20201217
20201214,경원선,도봉산,5382,3030,8412,20201217
20201214,경원선,망월사,5407,5584,10991,20201217
20201214,경원선,회룡,9461,9251,18712,20201217
20201214,경원선,의정부,13429,13445,26874,20201217
20201214,경원선,가능,5073,4986,10059,20201217
20201214,경원선,녹양,3593,3513,7106,20201217
20201214,경원선,양주,5874,5456,11330,20201217
20201214,경원선,덕계,2046,1845,3891,20201217
20201214,경원선,덕정,4489,4438,8927,20201217
20201214,경원선,지행,4710,4586,9296,20201217
20201214,경원선,동두천중앙,2433,2251,4684,20201217
20201214,경원선,보산,1179,1085,2264,20201217
20201214,경원선,동두천,1457,1666,3123,20201217
20201214,경원선,소요산,1514,1240,2754,20201217
20201214,경의선,서울역,3208,4083,7291,20201217
20201214,경의선,신촌,614,785,1399,20201217
20201214,경의선,효창공원앞,2361,2650,5011,20201217
20201214,경의선,공덕,2452,2216,4668,20201217
20201214,경의선,서강대,1436,1357,2793,20201217
20201214,경의선,홍대입구,1051,1145,2196,20201217
20201214,경의선,가좌,4039,3731,7770,20201217
20201214,경의선,디지털미디어시티,1838,1785,3623,20201217
20201214,경의선,수색,1999,1989,3988,20201217
20201214,경의선,화전,1890,1734,3624,20201217
20201214,경의선,강매,2419,2097,4516,20201217
20201214,경의선,행신,6010,6082,12092,20201217
20201214,경의선,능곡,2896,2666,5562,20201217
20201214,경의선,곡산,421,401,822,20201217
20201214,경의선,백마,5171,4958,10129,20201217
20201214,경의선,풍산,3977,3703,7680,20201217
20201214,경의선,일산,7031,7093,14124,20201217
20201214,경의선,탄현,5786,5519,11305,20201217
20201214,경의선,야당,4545,4298,8843,20201217
20201214,경의선,운정,4846,4631,9477,20201217
20201214,경의선,금릉,3374,3238,6612,20201217
20201214,경의선,금촌,4628,4648,9276,20201217
20201214,경의선,월롱,1719,1728,3447,20201217
20201214,경의선,파주,1313,1089,2402,20201217
20201214,경의선,문산,3669,3613,7282,20201217
20201214,경의선,임진강,3,3,6,20201217
20201214,경인선,개봉,17244,17845,35089,20201217
20201214,경인선,오류동,9449,9040,18489,20201217
20201214,경인선,역곡,21817,21603,43420,20201217
20201214,경인선,부천,25101,25360,50461,20201217
20201214,경인선,송내,22172,22293,44465,20201217
20201214,경인선,부평,21965,22737,44702,20201217
20201214,경인선,백운,5531,5500,11031,20201217
20201214,경인선,동암,12219,12206,24425,20201217
20201214,경인선,주안,14369,13145,27514,20201217
20201214,경인선,제물포,8254,7768,16022,20201217
20201214,경인선,동인천,10287,9912,20199,20201217
20201214,경인선,인천,2212,1505,3717,20201217
20201214,경인선,구일,4787,5045,9832,20201217
20201214,경인선,소사,7870,7232,15102,20201217
20201214,경인선,부개,6775,6392,13167,20201217
20201214,경인선,간석,4491,4238,8729,20201217
20201214,경인선,도원,2268,2264,4532,20201217
20201214,경인선,온수(성공회대입구),5103,5113,10216,20201217
20201214,경인선,중동,7366,7007,14373,20201217
20201214,경인선,도화,3115,2927,6042,20201217
20201214,경춘선,신내,1213,1188,2401,20201217
20201214,경춘선,갈매,2386,2048,4434,20201217
20201214,경춘선,별내,2119,2002,4121,20201217
20201214,경춘선,퇴계원,2863,2602,5465,20201217
20201214,경춘선,사릉,2777,2707,5484,20201217
20201214,경춘선,금곡,1169,1085,2254,20201217
20201214,경춘선,평내호평,4556,4370,8926,20201217
20201214,경춘선,천마산,1257,1162,2419,20201217
20201214,경춘선,마석,2891,2778,5669,20201217
20201214,경춘선,대성리,293,252,545,20201217
20201214,경춘선,청평,1002,915,1917,20201217
20201214,경춘선,상천,154,160,314,20201217
20201214,경춘선,가평,963,943,1906,20201217
20201214,경춘선,굴봉산,74,70,144,20201217
20201214,경춘선,백양리,112,89,201,20201217
20201214,경춘선,강촌,213,261,474,20201217
20201214,경춘선,김유정,143,129,272,20201217
20201214,경춘선,남춘천,1564,1635,3199,20201217
20201214,경춘선,춘천,746,713,1459,20201217
20201214,공항철도 1호선,서울역,4826,4470,9296,20201217
20201214,공항철도 1호선,공덕,1633,2004,3637,20201217
20201214,공항철도 1호선,홍대입구,4891,5214,10105,20201217
20201214,공항철도 1호선,디지털미디어시티,11148,9998,21146,20201217
20201214,공항철도 1호선,마곡나루(서울식물원),5867,5575,11442,20201217
20201214,공항철도 1호선,김포공항,8128,5502,13630,20201217
20201214,공항철도 1호선,계양,7349,6871,14220,20201217
20201214,공항철도 1호선,검암,5674,5505,11179,20201217
20201214,공항철도 1호선,청라국제도시,5205,4791,9996,20201217
20201214,공항철도 1호선,운서,4404,4571,8975,20201217
20201214,공항철도 1호선,공항화물청사,2045,2301,4346,20201217
20201214,공항철도 1호선,인천공항1터미널,2746,2745,5491,20201217
20201214,공항철도 1호선,인천공항2터미널,1613,1577,3190,20201217
20201214,공항철도 1호선,영종,1967,1942,3909,20201217
20201214,과천선,선바위,6691,5911,12602,20201217
20201214,과천선,경마공원,737,696,1433,20201217
20201214,과천선,대공원,938,999,1937,20201217
20201214,과천선,과천,3902,3726,7628,20201217
20201214,과천선,정부과천청사,7453,7392,14845,20201217
20201214,과천선,인덕원,18809,19824,38633,20201217
20201214,과천선,평촌,14748,14702,29450,20201217
20201214,과천선,범계,19055,18482,37537,20201217
20201214,분당선,선릉,11354,16919,28273,20201217
20201214,분당선,한티,10106,10999,21105,20201217
20201214,분당선,도곡,5044,5179,10223,20201217
20201214,분당선,구룡,1223,1196,2419,20201217
20201214,분당선,개포동,2623,2760,5383,20201217
20201214,분당선,대모산입구,2831,2638,5469,20201217
20201214,분당선,수서,9732,10092,19824,20201217
20201214,분당선,수원,5682,4573,10255,20201217
20201214,분당선,서울숲,6168,6160,12328,20201217
20201214,분당선,압구정로데오,12090,13069,25159,20201217
20201214,분당선,강남구청,7406,8327,15733,20201217
20201214,분당선,선정릉,6716,7042,13758,20201217
20201214,분당선,가천대,5718,6726,12444,20201217
20201214,분당선,태평,10793,10683,21476,20201217
20201214,분당선,모란,16396,16656,33052,20201217
20201214,분당선,야탑,19803,20661,40464,20201217
20201214,분당선,서현,17956,18121,36077,20201217
20201214,분당선,수내,9906,9796,19702,20201217
20201214,분당선,정자,11914,12724,24638,20201217
20201214,분당선,미금,11695,12481,24176,20201217
20201214,분당선,오리,9101,7719,16820,20201217
20201214,분당선,이매,4030,3761,7791,20201217
20201214,분당선,보정,1713,1535,3248,20201217
20201214,분당선,죽전,9560,10370,19930,20201217
20201214,분당선,구성,3640,3790,7430,20201217
20201214,분당선,신갈,3403,3409,6812,20201217
20201214,분당선,기흥,7078,6839,13917,20201217
20201214,분당선,상갈,3893,3848,7741,20201217
20201214,분당선,청명,3177,3098,6275,20201217
20201214,분당선,영통,5686,5894,11580,20201217
20201214,분당선,망포,10702,10254,20956,20201217
20201214,분당선,매탄권선,3573,3372,6945,20201217
20201214,분당선,수원시청,8939,9321,18260,20201217
20201214,분당선,매교,2167,2247,4414,20201217
20201214,수인선,고색,2519,2543,5062,20201217
20201214,수인선,오목천,1610,1594,3204,20201217
20201214,수인선,어천,394,421,815,20201217
20201214,수인선,야목,127,99,226,20201217
20201214,수인선,사리,2632,2507,5139,20201217
20201214,수인선,달월,72,38,110,20201217
20201214,수인선,월곶,1862,1714,3576,20201217
20201214,수인선,소래포구,3185,3020,6205,20201217
20201214,수인선,인천논현,4132,4307,8439,20201217
20201214,수인선,호구포,2995,3189,6184,20201217
20201214,수인선,남동인더스파크,2059,2334,4393,20201217
20201214,수인선,원인재,3264,3366,6630,20201217
20201214,수인선,연수,3326,3226,6552,20201217
20201214,수인선,송도,1889,1707,3596,20201217
20201214,수인선,인하대,4164,3948,8112,20201217
20201214,수인선,숭의,3114,2866,5980,20201217
20201214,수인선,신포,1280,1235,2515,20201217
20201214,수인선,인천,719,1169,1888,20201217
20201214,안산선,산본,12112,12980,25092,20201217
20201214,안산선,대야미,3751,3474,7225,20201217
20201214,일산선,삼송,13757,13647,27404,20201217
20201214,일산선,원당,8611,8188,16799,20201217
20201214,일산선,화정,12631,13054,25685,20201217
20201214,일산선,대곡,1389,1037,2426,20201217
20201214,일산선,백석,7881,7966,15847,20201217
20201214,일산선,마두,5535,5724,11259,20201217
20201214,일산선,정발산,4975,4835,9810,20201217
20201214,일산선,주엽,6534,6521,13055,20201217
20201214,일산선,대화,10232,8090,18322,20201217
20201214,장항선,봉명,975,986,1961,20201217
20201214,장항선,쌍용(나사렛대),1605,1579,3184,20201217
20201214,장항선,아산,1943,1743,3686,20201217
20201214,장항선,배방,675,699,1374,20201217
20201214,장항선,온양온천,2725,2650,5375,20201217
20201214,장항선,신창(순천향대),763,795,1558,20201217
20201214,중앙선,회기,17049,16596,33645,20201217
20201214,중앙선,중랑,4335,4123,8458,20201217
20201214,중앙선,상봉(시외버스터미널),4454,4432,8886,20201217
20201214,중앙선,망우,5703,5668,11371,20201217
20201214,중앙선,양원,1261,1262,2523,20201217
20201214,중앙선,구리,10464,10449,20913,20201217
20201214,중앙선,도농,7759,7096,14855,20201217
20201214,중앙선,양정,574,494,1068,20201217
20201214,중앙선,덕소,4282,4239,8521,20201217
20201214,중앙선,도심,1949,1457,3406,20201217
20201214,중앙선,팔당,484,498,982,20201217
20201214,중앙선,운길산,392,314,706,20201217
20201214,중앙선,양수,1079,1111,2190,20201217
20201214,중앙선,신원,116,100,216,20201217
20201214,중앙선,국수,443,463,906,20201217
20201214,중앙선,아신,362,327,689,20201217
20201214,중앙선,오빈,182,166,348,20201217
20201214,중앙선,양평,1681,1619,3300,20201217
20201214,중앙선,원덕,189,163,352,20201217
20201214,중앙선,용문,1050,995,2045,20201217
20201214,중앙선,지평,39,29,68,20201217
20201214,9호선,증미,6006,6215,12221,20201217
20201214,분당선,복정,1,0,1,20201217
20201214,안산선,반월,3269,3215,6484,20201217
20201214,안산선,상록수,13495,13552,27047,20201217
20201214,안산선,한대앞,7053,6954,14007,20201217
20201214,안산선,중앙,12323,12414,24737,20201217
20201214,안산선,고잔,6715,6429,13144,20201217
20201214,안산선,초지,3475,3571,7046,20201217
20201214,안산선,안산,9910,9092,19002,20201217
20201214,안산선,신길온천,1264,1168,2432,20201217
20201214,안산선,정왕,7009,7589,14598,20201217
20201214,안산선,오이도,6370,6013,12383,20201217
20201214,안산선,수리산,3497,2879,6376,20201217
20201214,우이신설선,북한산우이,1641,1501,3142,20201217
20201214,1호선,서울역,30885,28604,59489,20201217
20201214,1호선,동묘앞,5355,5672,11027,20201217
20201214,1호선,시청,16813,16746,33559,20201217
20201214,1호선,종각,25949,25229,51178,20201217
20201214,1호선,종로3가,15881,14536,30417,20201217
20201214,1호선,종로5가,16635,16383,33018,20201217
20201214,1호선,동대문,8367,8006,16373,20201217
20201214,우이신설선,솔밭공원,1790,1828,3618,20201217
20201214,우이신설선,4.19민주묘지,2029,1963,3992,20201217
20201214,1호선,신설동,11153,11098,22251,20201217
20201214,1호선,제기동,12101,12361,24462,20201217
20201214,우이신설선,가오리,3125,3239,6364,20201217
20201214,우이신설선,화계,2731,2607,5338,20201217
20201214,우이신설선,삼양,1646,1820,3466,20201217
20201214,1호선,청량리(서울시립대입구),14849,14771,29620,20201217
20201214,우이신설선,삼양사거리,1883,1916,3799,20201217
20201214,우이신설선,솔샘,4578,4499,9077,20201217
20201214,우이신설선,북한산보국문,4332,4442,8774,20201217
20201214,우이신설선,정릉,3332,3312,6644,20201217
20201214,우이신설선,성신여대입구(돈암),2170,2309,4479,20201217
20201214,우이신설선,보문,1253,1281,2534,20201217
20201214,우이신설선,신설동,1746,1707,3453,20201217
20201214,일산선,원흥,7133,6882,14015,20201217
20201214,2호선,시청,19050,18453,37503,20201217
20201214,2호선,을지로입구,30046,30119,60165,20201217
20201214,2호선,을지로3가,16416,16063,32479,20201217
20201214,2호선,을지로4가,10917,10534,21451,20201217
20201214,2호선,동대문역사문화공원(DDP),8812,9713,18525,20201217
20201214,2호선,신당,10640,10929,21569,20201217
20201215,중앙선,지평,24,24,48,20201218
20201215,5호선,거여,6206,6025,12231,20201218
20201215,5호선,마천,4627,4714,9341,20201218
20201215,5호선,미사,10279,10153,20432,20201218
20201215,5호선,하남풍산,3778,3779,7557,20201218
20201215,6호선,응암,14164,14215,28379,20201218
20201215,6호선,역촌,3050,3498,6548,20201218
20201215,6호선,불광,3301,3453,6754,20201218
20201215,6호선,독바위,2254,2434,4688,20201218
20201215,6호선,구산,5755,4534,10289,20201218
20201215,6호선,새절(신사),10337,9730,20067,20201218
20201215,6호선,증산(명지대앞),7891,7904,15795,20201218
20201215,6호선,디지털미디어시티,11329,12423,23752,20201218
20201215,6호선,월드컵경기장(성산),2963,3202,6165,20201218
20201215,6호선,마포구청,11175,10230,21405,20201218
20201215,6호선,망원,10055,10919,20974,20201218
20201215,6호선,합정,8883,8699,17582,20201218
20201215,6호선,상수,5472,5779,11251,20201218
20201215,6호선,광흥창(서강),7039,6813,13852,20201218
20201215,6호선,대흥(서강대앞),5819,6071,11890,20201218
20201215,6호선,공덕,14297,13753,28050,20201218
20201215,6호선,효창공원앞,5502,5184,10686,20201218
20201215,6호선,삼각지,4146,3795,7941,20201218
20201215,6호선,녹사평(용산구청),3043,2996,6039,20201218
20201215,6호선,이태원,6022,6165,12187,20201218
20201215,6호선,한강진,5196,5830,11026,20201218
20201215,6호선,버티고개,1655,1660,3315,20201218
20201215,6호선,약수,2705,2705,5410,20201218
20201215,6호선,청구,3168,3372,6540,20201218
20201215,6호선,신당,6309,6397,12706,20201218
20201215,6호선,동묘앞,6045,6225,12270,20201218
20201215,6호선,창신,2824,2331,5155,20201218
20201215,6호선,보문,5729,5364,11093,20201218
20201215,6호선,안암(고대병원앞),7148,7086,14234,20201218
20201215,6호선,고려대(종암),5812,5717,11529,20201218
20201215,6호선,월곡(동덕여대),8525,8603,17128,20201218
20201215,6호선,상월곡(한국과학기술연구원),4917,4471,9388,20201218
20201215,6호선,돌곶이,6800,6425,13225,20201218
20201215,6호선,석계,9751,10204,19955,20201218
20201215,6호선,태릉입구,4168,4473,8641,20201218
20201215,6호선,화랑대(서울여대입구),8970,7154,16124,20201218
20201215,6호선,봉화산(서울의료원),7271,6812,14083,20201218
20201215,7호선,장암,1838,674,2512,20201218
20201215,7호선,도봉산,7085,8193,15278,20201218
20201215,7호선,수락산,9865,9986,19851,20201218
20201215,7호선,마들,9683,9503,19186,20201218
20201215,7호선,노원,14526,14829,29355,20201218
20201215,7호선,중계,11224,10445,21669,20201218
20201215,7호선,하계,13787,13234,27021,20201218
20201215,7호선,공릉(서울과학기술대),8776,8866,17642,20201218
20201215,7호선,태릉입구,6190,5746,11936,20201218
20201215,7호선,먹골,8103,8037,16140,20201218
20201215,7호선,중화,8968,8847,17815,20201218
20201215,7호선,상봉(시외버스터미널),13320,12622,25942,20201218
20201215,7호선,면목,12698,12699,25397,20201218
20201215,7호선,사가정,13279,13345,26624,20201218
20201215,7호선,용마산(용마폭포공원),4811,4726,9537,20201218
20201215,7호선,중곡,8233,7861,16094,20201218
20201215,7호선,군자(능동),11549,9402,20951,20201218
20201215,7호선,어린이대공원(세종대),9090,9011,18101,20201218
20201215,7호선,건대입구,9416,9431,18847,20201218
20201215,7호선,뚝섬유원지,5274,5225,10499,20201218
20201215,7호선,청담,16193,17710,33903,20201218
20201215,7호선,강남구청,13099,14169,27268,20201218
20201215,7호선,학동,20889,21960,42849,20201218
20201215,7호선,논현,16384,17574,33958,20201218
20201215,7호선,반포,4495,4385,8880,20201218
20201215,7호선,고속터미널,10967,9712,20679,20201218
20201215,7호선,내방,11810,11991,23801,20201218
20201215,7호선,이수,11527,11509,23036,20201218
20201215,7호선,남성,9028,8584,17612,20201218
20201215,7호선,숭실대입구(살피재),9319,9451,18770,20201218
20201215,7호선,상도,7764,7679,15443,20201218
20201215,7호선,장승배기,7673,7631,15304,20201218
20201215,7호선,신대방삼거리,13300,13057,26357,20201218
20201215,7호선,보라매,7875,7763,15638,20201218
20201215,7호선,신풍,9297,9095,18392,20201218
20201215,7호선,대림(구로구청),6219,6244,12463,20201218
20201215,7호선,남구로,14010,14887,28897,20201218
20201215,7호선,가산디지털단지,41005,40820,81825,20201218
20201215,7호선,철산,16874,17201,34075,20201218
20201215,7호선,광명사거리,18196,18212,36408,20201218
20201215,7호선,천왕,8701,8345,17046,20201218
20201215,7호선,온수(성공회대입구),9141,8399,17540,20201218
20201215,7호선,까치울,6150,5977,12127,20201218
20201215,7호선,부천종합운동장,3808,3273,7081,20201218
20201215,7호선,춘의,8459,8600,17059,20201218
20201215,7호선,신중동,11561,11283,22844,20201218
20201215,7호선,부천시청,9708,9751,19459,20201218
20201215,7호선,상동,9206,9639,18845,20201218
20201215,7호선,삼산체육관,3790,3367,7157,20201218
20201215,7호선,굴포천,6818,7315,14133,20201218
20201215,7호선,부평구청,9421,7772,17193,20201218
20201215,8호선,암사,15150,13658,28808,20201218
20201215,8호선,천호(풍납토성),12330,13562,25892,20201218
20201215,8호선,강동구청,8484,9049,17533,20201218
20201215,8호선,몽촌토성(평화의문),4260,4439,8699,20201218
20201215,8호선,잠실(송파구청),10380,11537,21917,20201218
20201215,8호선,석촌,5893,6686,12579,20201218
20201215,8호선,송파,6129,6180,12309,20201218
20201215,8호선,가락시장,6260,6842,13102,20201218
20201215,8호선,문정,18398,19141,37539,20201218
20201215,8호선,장지,13713,13523,27236,20201218
20201215,8호선,복정,8181,7228,15409,20201218
20201215,8호선,산성,5361,5338,10699,20201218
20201215,8호선,남한산성입구(성남법원.검찰청),10819,10003,20822,20201218
20201215,8호선,단대오거리,8147,7933,16080,20201218
20201215,8호선,신흥,3528,3843,7371,20201218
20201215,8호선,수진,4017,3623,7640,20201218
20201215,8호선,모란,3406,2508,5914,20201218
20201215,9호선,개화,2017,1435,3452,20201218
20201215,9호선,김포공항,5122,6209,11331,20201218
20201215,9호선,공항시장,2203,2482,4685,20201218
20201215,9호선,신방화,5193,5214,10407,20201218
20201215,9호선,마곡나루(서울식물원),8170,8038,16208,20201218
20201215,9호선,양천향교,7343,7740,15083,20201218
20201215,9호선,가양,15592,15357,30949,20201218
20201215,9호선,증미,6015,6142,12157,20201218
20201215,9호선,등촌,8598,8742,17340,20201218
20201215,9호선,염창,13198,13400,26598,20201218
20201215,9호선,신목동,2982,2736,5718,20201218
20201215,9호선,선유도,6324,6077,12401,20201218
20201215,9호선,당산,13657,13515,27172,20201218
20201215,9호선,국회의사당,13563,13333,26896,20201218
20201215,9호선,여의도,18536,17638,36174,20201218
20201215,9호선,샛강,4459,4555,9014,20201218
20201215,9호선,노량진,17726,16911,34637,20201218
20201215,9호선,노들,3423,3058,6481,20201218
20201215,9호선,흑석(중앙대입구),5417,5837,11254,20201218
20201215,9호선,동작(현충원),1270,991,2261,20201218
20201215,9호선,구반포,1967,2013,3980,20201218
20201215,9호선,신반포,2238,2189,4427,20201218
20201215,9호선,고속터미널,7478,9212,16690,20201218
20201215,9호선,사평,2262,2354,4616,20201218
20201215,9호선,신논현,22182,21824,44006,20201218
20201215,9호선2~3단계,언주,8155,8215,16370,20201218
20201215,9호선2~3단계,선정릉,7269,7816,15085,20201218
20201215,9호선2~3단계,삼성중앙,5415,5614,11029,20201218
20201215,9호선2~3단계,봉은사,11408,11275,22683,20201218
20201215,9호선2~3단계,종합운동장,3171,3148,6319,20201218
20201215,9호선2~3단계,삼전,5048,5176,10224,20201218
20201215,9호선2~3단계,석촌고분,4470,4547,9017,20201218
20201215,9호선2~3단계,석촌,5679,5018,10697,20201218
20201215,9호선2~3단계,송파나루,3426,3599,7025,20201218
20201215,9호선2~3단계,한성백제,1817,1612,3429,20201218
20201215,9호선2~3단계,올림픽공원(한국체대),3863,3819,7682,20201218
20201215,9호선2~3단계,둔촌오륜,905,718,1623,20201218
20201215,9호선2~3단계,중앙보훈병원,7949,7062,15011,20201218
20201215,경강선,판교,3328,3136,6464,20201218
20201215,경강선,이매,716,641,1357,20201218
20201215,경강선,삼동,1774,1713,3487,20201218
20201215,경강선,경기광주,5124,4977,10101,20201218
20201215,경강선,초월,2162,2200,4362,20201218
20201215,경강선,곤지암,1484,1470,2954,20201218
20201215,경강선,신둔도예촌,844,791,1635,20201218
20201215,경강선,이천,1599,1747,3346,20201218
20201215,경강선,부발,1181,1117,2298,20201218
20201215,경강선,세종대왕릉,179,162,341,20201218
20201215,경강선,여주,1087,1100,2187,20201218
20201215,경부선,서울역,2819,1010,3829,20201218
20201215,경부선,남영,7437,7865,15302,20201218
20201215,경부선,용산,21249,21740,42989,20201218
20201215,경부선,노량진,5730,6156,11886,20201218
20201215,경부선,대방,9942,10431,20373,20201218
20201215,경부선,영등포,26335,26803,53138,20201218
20201215,경부선,신도림,3170,3129,6299,20201218
20201215,경부선,신길,7350,6268,13618,20201218
20201215,경부선,구로,15132,15377,30509,20201218
20201215,경부선,가산디지털단지,14335,17139,31474,20201218
20201215,경부선,금천구청,9107,9138,18245,20201218
20201215,경부선,석수,8396,7084,15480,20201218
20201215,경부선,관악,5519,5154,10673,20201218
20201215,경부선,안양,16073,16204,32277,20201218
20201215,경부선,명학,7723,7741,15464,20201218
20201215,경부선,금정,20568,21133,41701,20201218
20201215,경부선,군포,6548,6625,13173,20201218
20201215,경부선,의왕,6928,6918,13846,20201218
20201215,경부선,성균관대,9924,9912,19836,20201218
20201215,경부선,화서,5579,5475,11054,20201218
20201215,경부선,수원,21962,23270,45232,20201218
20201215,경부선,독산,14259,15310,29569,20201218
20201215,경부선,세류,2216,2082,4298,20201218
20201215,경부선,병점,9507,9505,19012,20201218
20201215,경부선,세마,1811,1719,3530,20201218
20201215,경부선,오산대,2574,2439,5013,20201218
20201215,경부선,오산,7068,6974,14042,20201218
20201215,경부선,진위,1211,1091,2302,20201218
20201215,경부선,송탄,3003,2828,5831,20201218
20201215,경부선,서정리,4794,4603,9397,20201218
20201215,경부선,지제,2059,1966,4025,20201218
20201215,경부선,평택,7782,7773,15555,20201218
20201215,경부선,성환,2546,2515,5061,20201218
20201215,경부선,직산,488,488,976,20201218
20201215,경부선,두정,3678,3679,7357,20201218
20201215,경부선,천안,3216,3397,6613,20201218
20201215,경부선,당정,4741,4498,9239,20201218
20201215,경부선,서동탄,1136,935,2071,20201218
20201215,경부선,광명,2147,1935,4082,20201218
20201215,경원선,이촌(국립중앙박물관),2723,2134,4857,20201218
20201215,경원선,서빙고,1392,1307,2699,20201218
20201215,경원선,한남,3169,3030,6199,20201218
20201215,경원선,옥수,32,20,52,20201218
20201215,경원선,응봉,1324,1139,2463,20201218
20201215,경원선,왕십리(성동구청),9228,10731,19959,20201218
20201215,경원선,청량리(서울시립대입구),9438,10340,19778,20201218
20201215,경원선,외대앞,5113,5150,10263,20201218
20201215,경원선,신이문,6718,6321,13039,20201218
20201215,경원선,석계,6169,7029,13198,20201218
20201215,경원선,광운대,6636,6349,12985,20201218
20201215,경원선,월계,4836,4594,9430,20201218
20201215,경원선,녹천,3743,3175,6918,20201218
20201215,경원선,방학,7231,7158,14389,20201218
20201215,경원선,도봉,4683,4550,9233,20201218
20201215,경원선,도봉산,5435,3040,8475,20201218
20201215,경원선,망월사,5345,5633,10978,20201218
20201215,경원선,회룡,9353,9306,18659,20201218
20201215,경원선,의정부,13269,13274,26543,20201218
20201215,경원선,가능,5008,4914,9922,20201218
20201215,경원선,녹양,3550,3392,6942,20201218
20201215,경원선,양주,5413,5176,10589,20201218
20201215,경원선,덕계,1956,1840,3796,20201218
20201215,경원선,덕정,4335,4351,8686,20201218
20201215,경원선,지행,4649,4545,9194,20201218
20201215,경원선,동두천중앙,2361,2273,4634,20201218
20201215,경원선,보산,1123,1048,2171,20201218
20201215,경원선,동두천,1380,1601,2981,20201218
20201215,경원선,소요산,1525,1232,2757,20201218
20201215,경의선,서울역,3089,3815,6904,20201218
20201215,경의선,신촌,629,734,1363,20201218
20201215,경의선,효창공원앞,2278,2568,4846,20201218
20201215,경의선,공덕,2472,2153,4625,20201218
20201215,경의선,서강대,1387,1272,2659,20201218
20201215,경의선,홍대입구,1036,1118,2154,20201218
20201215,경의선,가좌,3959,3647,7606,20201218
20201215,경의선,디지털미디어시티,1785,1745,3530,20201218
20201215,경의선,수색,1834,1955,3789,20201218
20201215,경의선,화전,1483,1391,2874,20201218
20201215,경의선,강매,2331,1988,4319,20201218
20201215,경의선,행신,5721,5733,11454,20201218
20201215,경의선,능곡,2760,2558,5318,20201218
20201215,경의선,곡산,413,413,826,20201218
20201215,경의선,백마,4947,4818,9765,20201218
20201215,경의선,풍산,3853,3581,7434,20201218
20201215,경의선,일산,6815,6928,13743,20201218
20201215,경의선,탄현,5515,5448,10963,20201218
20201215,경의선,야당,4405,4142,8547,20201218
20201215,경의선,운정,4698,4437,9135,20201218
20201215,경의선,금릉,3211,3125,6336,20201218
20201215,경의선,금촌,4473,4499,8972,20201218
20201215,경의선,월롱,1675,1590,3265,20201218
20201215,경의선,파주,880,661,1541,20201218
20201215,경의선,문산,3554,3506,7060,20201218
20201215,경의선,임진강,5,5,10,20201218
20201215,경인선,개봉,16782,17468,34250,20201218
20201215,경인선,오류동,9240,8870,18110,20201218
20201215,경인선,역곡,21234,21328,42562,20201218
20201215,경인선,부천,24630,24941,49571,20201218
20201215,경인선,송내,21536,21486,43022,20201218
20201215,경인선,부평,21346,22120,43466,20201218
20201215,경인선,백운,5371,5433,10804,20201218
20201215,경인선,동암,11910,12088,23998,20201218
20201215,경인선,주안,13931,12765,26696,20201218
20201215,경인선,제물포,7757,7466,15223,20201218
20201215,경인선,동인천,10122,9717,19839,20201218
20201215,경인선,인천,2156,1552,3708,20201218
20201215,경인선,구일,4648,4905,9553,20201218
20201215,경인선,소사,7704,7143,14847,20201218
20201215,경인선,부개,6509,6268,12777,20201218
20201215,경인선,간석,4353,4175,8528,20201218
20201215,경인선,도원,2020,2130,4150,20201218
20201215,경인선,온수(성공회대입구),5167,5109,10276,20201218
20201215,경인선,중동,7226,7014,14240,20201218
20201215,경인선,도화,3116,2876,5992,20201218
20201215,경춘선,신내,1123,1117,2240,20201218
20201215,경춘선,갈매,2389,2039,4428,20201218
20201215,경춘선,별내,2108,2016,4124,20201218
20201215,경춘선,퇴계원,2819,2604,5423,20201218
20201215,경춘선,사릉,2646,2611,5257,20201218
20201215,경춘선,금곡,1157,1079,2236,20201218
20201215,경춘선,평내호평,4426,4399,8825,20201218
20201215,경춘선,천마산,1212,1138,2350,20201218
20201215,경춘선,마석,2703,2693,5396,20201218
20201215,경춘선,대성리,317,272,589,20201218
20201215,경춘선,청평,825,807,1632,20201218
20201215,경춘선,상천,126,124,250,20201218
20201215,경춘선,가평,894,849,1743,20201218
20201215,경춘선,굴봉산,46,48,94,20201218
20201215,경춘선,백양리,113,101,214,20201218
20201215,경춘선,강촌,253,226,479,20201218
20201215,경춘선,김유정,143,129,272,20201218
20201215,경춘선,남춘천,1377,1481,2858,20201218
20201215,경춘선,춘천,674,642,1316,20201218
20201215,공항철도 1호선,서울역,4411,4065,8476,20201218
20201215,공항철도 1호선,공덕,1570,2022,3592,20201218
20201215,공항철도 1호선,홍대입구,4977,5081,10058,20201218
20201215,공항철도 1호선,디지털미디어시티,10878,9712,20590,20201218
20201215,공항철도 1호선,마곡나루(서울식물원),5582,5330,10912,20201218
20201215,공항철도 1호선,김포공항,6841,4928,11769,20201218
20201215,공항철도 1호선,계양,7221,6767,13988,20201218
20201215,공항철도 1호선,검암,5689,5555,11244,20201218
20201215,공항철도 1호선,청라국제도시,5103,4690,9793,20201218
20201215,공항철도 1호선,운서,4514,4570,9084,20201218
20201215,공항철도 1호선,공항화물청사,2093,2288,4381,20201218
20201215,공항철도 1호선,인천공항1터미널,2948,3149,6097,20201218
20201215,공항철도 1호선,인천공항2터미널,1721,1665,3386,20201218
20201215,공항철도 1호선,영종,1912,1881,3793,20201218
20201215,과천선,선바위,6619,5957,12576,20201218
20201215,과천선,대공원,1080,1160,2240,20201218
20201215,과천선,과천,3915,3686,7601,20201218
20201215,과천선,정부과천청사,7474,7527,15001,20201218
20201215,과천선,인덕원,18593,19378,37971,20201218
20201215,과천선,평촌,14549,14527,29076,20201218
20201215,과천선,범계,18842,18477,37319,20201218
20201215,분당선,선릉,11148,16229,27377,20201218
20201215,분당선,한티,10280,10982,21262,20201218
20201215,분당선,도곡,4914,4948,9862,20201218
20201215,분당선,구룡,1211,1184,2395,20201218
20201215,분당선,개포동,2617,2742,5359,20201218
20201215,분당선,대모산입구,2749,2545,5294,20201218
20201215,분당선,수서,9211,9671,18882,20201218
20201215,분당선,수원,5468,4425,9893,20201218
20201215,분당선,서울숲,6244,6270,12514,20201218
20201215,분당선,압구정로데오,13228,14344,27572,20201218
20201215,분당선,강남구청,7370,8452,15822,20201218
20201215,분당선,선정릉,6442,6849,13291,20201218
20201215,분당선,가천대,5522,6369,11891,20201218
20201215,분당선,태평,10627,10459,21086,20201218
20201215,분당선,모란,15340,15293,30633,20201218
20201215,분당선,야탑,19164,19985,39149,20201218
20201215,분당선,서현,17419,17650,35069,20201218
20201215,분당선,수내,9655,9709,19364,20201218
20201215,분당선,정자,11766,12300,24066,20201218
20201215,분당선,미금,11557,12124,23681,20201218
20201215,분당선,오리,8951,7591,16542,20201218
20201215,분당선,이매,3786,3521,7307,20201218
20201215,분당선,보정,1654,1416,3070,20201218
20201215,분당선,죽전,9401,10449,19850,20201218
20201215,분당선,구성,3561,3750,7311,20201218
20201215,분당선,신갈,3281,3228,6509,20201218
20201215,분당선,기흥,6964,6737,13701,20201218
20201215,분당선,상갈,3870,3849,7719,20201218
20201215,분당선,청명,3120,3012,6132,20201218
20201215,분당선,영통,5523,5721,11244,20201218
20201215,분당선,망포,10242,9973,20215,20201218
20201215,분당선,매탄권선,3378,3513,6891,20201218
20201215,분당선,수원시청,8707,9159,17866,20201218
20201215,분당선,매교,1954,2046,4000,20201218
20201215,수인선,고색,2473,2436,4909,20201218
20201215,수인선,오목천,1546,1559,3105,20201218
20201215,수인선,어천,405,370,775,20201218
20201215,수인선,야목,139,95,234,20201218
20201215,수인선,사리,2435,2294,4729,20201218
20201215,수인선,달월,74,47,121,20201218
20201215,수인선,월곶,1780,1724,3504,20201218
20201215,수인선,소래포구,3108,2925,6033,20201218
20201215,수인선,인천논현,3958,4187,8145,20201218
20201215,수인선,호구포,2906,3058,5964,20201218
20201215,수인선,남동인더스파크,2129,2396,4525,20201218
20201215,수인선,원인재,3331,3354,6685,20201218
20201215,수인선,연수,3134,3137,6271,20201218
20201215,수인선,송도,1810,1628,3438,20201218
20201215,수인선,인하대,4071,3910,7981,20201218
20201215,수인선,숭의,3003,2801,5804,20201218
20201215,수인선,신포,1220,1233,2453,20201218
20201215,수인선,인천,713,1222,1935,20201218
20201215,안산선,산본,11862,11386,23248,20201218
20201215,안산선,대야미,3782,3395,7177,20201218
20201215,안산선,반월,3287,3254,6541,20201218
20201215,안산선,상록수,12672,12720,25392,20201218
20201215,안산선,한대앞,6570,6672,13242,20201218
20201215,안산선,중앙,11568,12029,23597,20201218
20201215,안산선,고잔,6548,6331,12879,20201218
20201215,안산선,초지,3471,3546,7017,20201218
20201215,안산선,안산,9629,8600,18229,20201218
20201215,안산선,신길온천,1282,1167,2449,20201218
20201215,안산선,정왕,6131,6719,12850,20201218
20201215,안산선,오이도,6152,5830,11982,20201218
20201215,안산선,수리산,3374,2860,6234,20201218
20201215,우이신설선,북한산우이,2054,1815,3869,20201218
20201215,우이신설선,솔밭공원,1808,1829,3637,20201218
20201215,우이신설선,4.19민주묘지,1983,1796,3779,20201218
20201215,우이신설선,가오리,3113,3207,6320,20201218
20201215,우이신설선,화계,2671,2606,5277,20201218
20201215,우이신설선,삼양,1624,1790,3414,20201218
20201215,우이신설선,삼양사거리,1830,1930,3760,20201218
20201215,우이신설선,솔샘,4423,4314,8737,20201218
20201215,우이신설선,북한산보국문,4422,4439,8861,20201218
20201215,우이신설선,정릉,3254,3320,6574,20201218
20201215,우이신설선,성신여대입구(돈암),2209,2353,4562,20201218
20201215,5호선,개롱,4910,5158,10068,20201218
20201215,5호선,오금,3029,2989,6018,20201218
20201215,5호선,방이,5269,5440,10709,20201218
20201215,5호선,올림픽공원(한국체대),3047,2636,5683,20201218
20201215,5호선,둔촌동,6453,6553,13006,20201218
20201215,5호선,상일동,12315,11313,23628,20201218
20201215,5호선,고덕,6719,6683,13402,20201218
20201215,5호선,명일,6350,6691,13041,20201218
20201215,5호선,굽은다리(강동구민회관앞),7280,7110,14390,20201218
20201215,5호선,길동,6193,6540,12733,20201218
20201215,5호선,강동,15870,14767,30637,20201218
20201215,5호선,천호(풍납토성),13448,13522,26970,20201218
20201215,5호선,광나루(장신대),9692,8803,18495,20201218
20201215,5호선,아차산(어린이대공원후문),10787,10761,21548,20201218
20201215,5호선,군자(능동),8571,9237,17808,20201218
20201215,5호선,장한평,15219,15044,30263,20201218
20201215,5호선,답십리,12881,11899,24780,20201218
20201215,5호선,마장,4320,4159,8479,20201218
20201215,5호선,왕십리(성동구청),3398,3508,6906,20201218
20201215,5호선,행당,6317,5809,12126,20201218
20201215,5호선,신금호,4793,4988,9781,20201218
20201215,5호선,청구,3267,3076,6343,20201218
20201215,5호선,동대문역사문화공원(DDP),2503,2822,5325,20201218
20201215,5호선,을지로4가,4864,4915,9779,20201218
20201215,5호선,종로3가,7088,6847,13935,20201218
20201215,5호선,광화문(세종문화회관),23903,24681,48584,20201218
20201215,5호선,서대문,15843,15931,31774,20201218
20201215,5호선,충정로(경기대입구),4246,4251,8497,20201218
20201215,5호선,애오개,5199,5347,10546,20201218
20201215,5호선,공덕,11060,11841,22901,20201218
20201215,5호선,마포,11255,11517,22772,20201218
20201215,5호선,여의나루,5550,5632,11182,20201218
20201215,5호선,여의도,21753,22423,44176,20201218
20201215,5호선,신길,3211,3597,6808,20201218
20201215,5호선,영등포시장,7274,7552,14826,20201218
20201215,5호선,영등포구청,3259,3398,6657,20201218
20201215,5호선,양평,6154,6375,12529,20201218
20201215,5호선,오목교(목동운동장앞),16446,17723,34169,20201218
20201215,5호선,목동,13392,14858,28250,20201218
20201215,5호선,신정(은행정),11451,9143,20594,20201218
20201215,5호선,까치산,22883,22132,45015,20201218
20201215,5호선,화곡,22742,21704,44446,20201218
20201215,5호선,우장산,10303,10488,20791,20201218
20201215,5호선,발산,14074,14227,28301,20201218
20201215,5호선,마곡,7488,7294,14782,20201218
20201215,5호선,송정,5207,4847,10054,20201218
20201215,5호선,김포공항,4919,4645,9564,20201218
20201215,5호선,개화산,4114,3874,7988,20201218
20201215,5호선,방화,5157,5043,10200,20201218
20201215,4호선,쌍문,23993,22378,46371,20201218
20201215,4호선,창동,19448,21097,40545,20201218
20201215,4호선,노원,13727,15193,28920,20201218
20201215,4호선,상계,15166,14222,29388,20201218
20201215,4호선,당고개,9784,9068,18852,20201218
20201215,4호선,남태령,836,727,1563,20201218
20201215,4호선,사당,17581,14607,32188,20201218
20201215,4호선,총신대입구(이수),14291,15496,29787,20201218
20201215,4호선,동작(현충원),1609,1724,3333,20201218
20201215,4호선,이촌(국립중앙박물관),5005,5770,10775,20201218
20201215,4호선,신용산,11194,11655,22849,20201218
20201215,4호선,삼각지,3561,3787,7348,20201218
20201215,4호선,숙대입구(갈월),9699,9532,19231,20201218
20201215,4호선,서울역,8636,10535,19171,20201218
20201215,4호선,회현(남대문시장),17561,18046,35607,20201218
20201215,4호선,명동,12885,13154,26039,20201218
20201215,4호선,충무로,22205,22745,44950,20201218
20201215,4호선,동대문역사문화공원(DDP),11467,10744,22211,20201218
20201215,4호선,동대문,15920,16393,32313,20201218
20201215,4호선,혜화,21333,20802,42135,20201218
20201215,4호선,한성대입구(삼선교),9863,9916,19779,20201218
20201215,4호선,성신여대입구(돈암),14230,13652,27882,20201218
20201215,4호선,길음,15470,15384,30854,20201218
20201215,4호선,미아사거리,21842,21534,43376,20201218
20201215,4호선,미아(서울사이버대학),11874,11748,23622,20201218
20201215,4호선,수유(강북구청),27181,26919,54100,20201218
20201215,3호선,오금,4987,4431,9418,20201218
20201215,3호선,경찰병원,6231,6326,12557,20201218
20201215,3호선,가락시장,6973,6818,13791,20201218
20201215,3호선,수서,11698,12168,23866,20201218
20201215,3호선,일원,7579,7554,15133,20201218
20201215,3호선,대청,7660,7020,14680,20201218
20201215,3호선,학여울,1227,1287,2514,20201218
20201215,3호선,대치,7539,7560,15099,20201218
20201215,3호선,도곡,4152,4158,8310,20201218
20201215,3호선,매봉,9988,9525,19513,20201218
20201215,3호선,양재(서초구청),30765,32737,63502,20201218
20201215,3호선,남부터미널(예술의전당),21968,22495,44463,20201218
20201215,3호선,교대(법원.검찰청),10594,7337,17931,20201218
20201215,3호선,고속터미널,26161,25182,51343,20201218
20201215,3호선,잠원,3526,3506,7032,20201218
20201215,3호선,신사,22936,23683,46619,20201218
20201215,3호선,압구정,24076,25459,49535,20201218
20201215,3호선,옥수,6508,6913,13421,20201218
20201215,3호선,금호,6116,5946,12062,20201218
20201215,3호선,약수,9894,9723,19617,20201218
20201215,3호선,동대입구,5658,5771,11429,20201218
20201215,3호선,을지로3가,8384,8587,16971,20201218
20201215,3호선,종로3가,7848,8630,16478,20201218
20201215,3호선,안국,13868,13598,27466,20201218
20201215,3호선,경복궁(정부서울청사),13165,12797,25962,20201218
20201215,3호선,독립문,5092,5401,10493,20201218
20201215,3호선,무악재,2963,3045,6008,20201218
20201215,3호선,홍제,13277,13081,26358,20201218
20201215,3호선,녹번,11979,11200,23179,20201218
20201215,3호선,불광,12538,13181,25719,20201218
20201215,3호선,연신내,29271,27630,56901,20201218
20201215,3호선,구파발,15914,14918,30832,20201218
20201215,3호선,지축,2506,2516,5022,20201218
20201215,2호선,용두(동대문구청),1799,1863,3662,20201218
20201215,2호선,신정네거리,7640,8114,15754,20201218
20201215,2호선,양천구청,5099,5520,10619,20201218
20201215,2호선,도림천,1180,1217,2397,20201218
20201215,2호선,신설동,2467,2491,4958,20201218
20201215,2호선,신답,1263,1461,2724,20201218
20201215,2호선,용답,1946,1981,3927,20201218
20201215,2호선,충정로(경기대입구),8117,8514,16631,20201218
20201215,2호선,아현,7607,7541,15148,20201218
20201215,2호선,이대,8418,8727,17145,20201218
20201215,2호선,신촌,21456,22284,43740,20201218
20201215,2호선,홍대입구,31001,31935,62936,20201218
20201215,2호선,합정,21054,21660,42714,20201218
20201215,2호선,당산,14275,16633,30908,20201218
20201215,2호선,영등포구청,19176,19164,38340,20201218
20201215,2호선,문래,16906,17162,34068,20201218
20201215,2호선,신도림,36714,35353,72067,20201218
20201215,2호선,대림(구로구청),20041,20384,40425,20201218
20201215,2호선,구로디지털단지,49508,49873,99381,20201218
20201215,2호선,신대방,21067,20746,41813,20201218
20201215,2호선,신림,50327,49325,99652,20201218
20201215,2호선,봉천,19332,18220,37552,20201218
20201215,2호선,서울대입구(관악구청),36000,34889,70889,20201218
20201215,2호선,낙성대(강감찬),21281,20870,42151,20201218
20201215,2호선,사당,26112,28314,54426,20201218
20201215,2호선,방배,14425,14870,29295,20201218
20201215,2호선,서초,17274,16860,34134,20201218
20201215,2호선,교대(법원.검찰청),26829,29238,56067,20201218
20201215,2호선,강남,59059,57443,116502,20201218
20201215,2호선,역삼,41397,44078,85475,20201218
20201215,2호선,선릉,45585,40439,86024,20201218
20201215,2호선,삼성(무역센터),38243,38076,76319,20201218
20201215,2호선,종합운동장,4907,5446,10353,20201218
20201215,2호선,잠실새내,14847,14527,29374,20201218
20201215,2호선,잠실(송파구청),46007,46120,92127,20201218
20201215,2호선,잠실나루,11043,10776,21819,20201218
20201215,2호선,강변(동서울터미널),21456,21208,42664,20201218
20201215,2호선,구의(광진구청),18786,18637,37423,20201218
20201215,2호선,건대입구,22697,24356,47053,20201218
20201215,2호선,성수,27521,29913,57434,20201218
20201215,2호선,뚝섬,15919,17310,33229,20201218
20201215,2호선,한양대,5717,5977,11694,20201218
20201215,2호선,왕십리(성동구청),11438,9008,20446,20201218
20201215,2호선,상왕십리,10837,10638,21475,20201218
20201215,2호선,신당,10610,10941,21551,20201218
20201215,2호선,동대문역사문화공원(DDP),8620,9517,18137,20201218
20201215,2호선,을지로4가,10833,10494,21327,20201218
20201215,2호선,을지로3가,16456,16051,32507,20201218
20201215,2호선,을지로입구,30455,30847,61302,20201218
20201215,2호선,시청,19263,18790,38053,20201218
20201215,1호선,청량리(서울시립대입구),14676,14657,29333,20201218
20201215,1호선,제기동,11776,11883,23659,20201218
20201215,1호선,신설동,11004,10813,21817,20201218
20201215,1호선,동대문,8282,7824,16106,20201218
20201215,1호선,종로5가,16662,16284,32946,20201218
20201215,1호선,종로3가,15718,14319,30037,20201218
20201215,1호선,종각,25964,25022,50986,20201218
20201215,1호선,시청,16773,16718,33491,20201218
20201215,1호선,동묘앞,5369,5560,10929,20201218
20201215,1호선,서울역,29852,27710,57562,20201218
20201215,과천선,경마공원,783,777,1560,20201218
20201215,우이신설선,보문,1216,1295,2511,20201218
20201215,우이신설선,신설동,1826,1718,3544,20201218
20201215,일산선,원흥,7011,6667,13678,20201218
20201215,일산선,지축,1,0,1,20201218
20201215,일산선,삼송,13347,13403,26750,20201218
20201215,일산선,원당,8378,8057,16435,20201218
20201215,일산선,화정,12444,13102,25546,20201218
20201215,일산선,대곡,1268,914,2182,20201218
20201215,일산선,백석,7833,7934,15767,20201218
20201215,일산선,마두,5415,5645,11060,20201218
20201215,일산선,정발산,4982,4806,9788,20201218
20201215,일산선,주엽,6329,6324,12653,20201218
20201215,일산선,대화,9969,7954,17923,20201218
20201215,장항선,봉명,982,964,1946,20201218
20201215,장항선,쌍용(나사렛대),1479,1297,2776,20201218
20201215,장항선,아산,1757,1673,3430,20201218
20201215,장항선,배방,669,636,1305,20201218
20201215,장항선,온양온천,2392,2452,4844,20201218
20201215,장항선,신창(순천향대),846,833,1679,20201218
20201215,중앙선,회기,16822,16289,33111,20201218
20201215,중앙선,중랑,4201,4049,8250,20201218
20201215,중앙선,상봉(시외버스터미널),4306,4312,8618,20201218
20201215,중앙선,망우,5604,5616,11220,20201218
20201215,중앙선,양원,1234,1273,2507,20201218
20201215,중앙선,구리,10167,10356,20523,20201218
20201215,중앙선,도농,7486,6764,14250,20201218
20201215,중앙선,양정,596,520,1116,20201218
20201215,중앙선,덕소,4145,4194,8339,20201218
20201215,중앙선,도심,1821,1388,3209,20201218
20201215,중앙선,팔당,502,482,984,20201218
20201215,중앙선,운길산,393,340,733,20201218
20201215,중앙선,양수,1027,1026,2053,20201218
20201215,중앙선,신원,114,105,219,20201218
20201215,중앙선,국수,419,427,846,20201218
20201215,중앙선,아신,336,337,673,20201218
20201215,중앙선,오빈,191,190,381,20201218
20201215,중앙선,양평,1497,1435,2932,20201218
20201215,중앙선,원덕,186,182,368,20201218
20201215,중앙선,용문,991,1021,2012,20201218
20201216,2호선,신당,10609,10999,21608,20201219
20201216,2호선,상왕십리,10651,10432,21083,20201219
20201216,2호선,왕십리(성동구청),11367,8976,20343,20201219
20201216,2호선,한양대,5929,6043,11972,20201219
20201216,2호선,뚝섬,16042,17328,33370,20201219
20201216,2호선,성수,27484,30020,57504,20201219
20201216,2호선,건대입구,22585,24094,46679,20201219
20201216,2호선,구의(광진구청),18515,18547,37062,20201219
20201216,2호선,강변(동서울터미널),21121,20804,41925,20201219
20201216,2호선,잠실나루,10711,10323,21034,20201219
20201216,2호선,잠실(송파구청),44188,44351,88539,20201219
20201216,2호선,잠실새내,14706,14513,29219,20201219
20201216,2호선,종합운동장,4934,5423,10357,20201219
20201216,2호선,삼성(무역센터),37748,37978,75726,20201219
20201216,2호선,선릉,45432,40321,85753,20201219
20201216,2호선,역삼,40728,43777,84505,20201219
20201216,2호선,강남,57753,55741,113494,20201219
20201216,2호선,교대(법원.검찰청),26434,29358,55792,20201219
20201216,2호선,서초,17013,16815,33828,20201219
20201216,2호선,방배,13903,14238,28141,20201219
20201216,2호선,사당,25913,28301,54214,20201219
20201216,2호선,낙성대(강감찬),21195,20599,41794,20201219
20201216,2호선,서울대입구(관악구청),35459,34372,69831,20201219
20201216,안산선,상록수,12605,12768,25373,20201219
20201216,안산선,한대앞,6569,6601,13170,20201219
20201216,안산선,중앙,11589,12092,23681,20201219
20201216,안산선,고잔,6520,6204,12724,20201219
20201216,안산선,초지,3361,3479,6840,20201219
20201216,안산선,안산,9650,8602,18252,20201219
20201216,안산선,신길온천,1221,1137,2358,20201219
20201216,안산선,정왕,7602,8018,15620,20201219
20201216,안산선,오이도,6219,6082,12301,20201219
20201216,수인선,연수,3263,3280,6543,20201219
20201216,수인선,송도,1819,1644,3463,20201219
20201216,수인선,인하대,4052,3855,7907,20201219
20201216,수인선,숭의,3000,2880,5880,20201219
20201216,수인선,신포,1188,1156,2344,20201219
20201216,수인선,인천,722,1155,1877,20201219
20201216,안산선,산본,11859,10464,22323,20201219
20201216,안산선,대야미,3677,3406,7083,20201219
20201216,6호선,공덕,14015,13434,27449,20201219
20201216,안산선,반월,3182,3129,6311,20201219
20201216,중앙선,지평,27,20,47,20201219
20201216,중앙선,용문,857,879,1736,20201219
20201216,중앙선,원덕,180,159,339,20201219
20201216,중앙선,양평,1469,1469,2938,20201219
20201216,중앙선,오빈,205,177,382,20201219
20201216,중앙선,아신,321,307,628,20201219
20201216,중앙선,국수,399,435,834,20201219
20201216,중앙선,신원,122,104,226,20201219
20201216,중앙선,양수,1065,1051,2116,20201219
20201216,중앙선,운길산,369,314,683,20201219
20201216,중앙선,팔당,507,493,1000,20201219
20201216,중앙선,도심,1772,1363,3135,20201219
20201216,중앙선,덕소,4040,4159,8199,20201219
20201216,중앙선,양정,588,495,1083,20201219
20201216,중앙선,도농,7489,6851,14340,20201219
20201216,중앙선,구리,10115,10176,20291,20201219
20201216,중앙선,양원,1251,1225,2476,20201219
20201216,중앙선,망우,5502,5460,10962,20201219
20201216,중앙선,상봉(시외버스터미널),4370,4269,8639,20201219
20201216,중앙선,중랑,4172,4041,8213,20201219
20201216,중앙선,회기,17095,16479,33574,20201219
20201216,장항선,신창(순천향대),791,751,1542,20201219
20201216,장항선,온양온천,2302,2319,4621,20201219
20201216,장항선,배방,699,659,1358,20201219
20201216,장항선,아산,1801,1757,3558,20201219
20201216,장항선,쌍용(나사렛대),1406,1307,2713,20201219
20201216,장항선,봉명,980,975,1955,20201219
20201216,일산선,대화,9874,7983,17857,20201219
20201216,일산선,주엽,6232,6268,12500,20201219
20201216,일산선,정발산,4842,4779,9621,20201219
20201216,일산선,마두,5347,5627,10974,20201219
20201216,일산선,백석,7677,7686,15363,20201219
20201216,일산선,대곡,1306,946,2252,20201219
20201216,일산선,화정,12138,12655,24793,20201219
20201216,일산선,원당,8344,7948,16292,20201219
20201216,일산선,삼송,13378,13382,26760,20201219
20201216,일산선,원흥,6869,6651,13520,20201219
20201216,우이신설선,신설동,1838,1785,3623,20201219
20201216,우이신설선,보문,1147,1281,2428,20201219
20201216,우이신설선,성신여대입구(돈암),2158,2393,4551,20201219
20201216,우이신설선,정릉,3341,3191,6532,20201219
20201216,우이신설선,북한산보국문,4306,4302,8608,20201219
20201216,우이신설선,솔샘,4339,4158,8497,20201219
20201216,우이신설선,삼양사거리,1783,1865,3648,20201219
20201216,우이신설선,삼양,1602,1735,3337,20201219
20201216,우이신설선,화계,2633,2515,5148,20201219
20201216,우이신설선,가오리,3153,3147,6300,20201219
20201216,우이신설선,4.19민주묘지,1988,1801,3789,20201219
20201216,우이신설선,솔밭공원,1750,1717,3467,20201219
20201216,우이신설선,북한산우이,1740,1553,3293,20201219
20201216,안산선,수리산,3345,2757,6102,20201219
20201216,수인선,원인재,3250,3307,6557,20201219
20201216,수인선,남동인더스파크,2120,2340,4460,20201219
20201216,수인선,호구포,3006,3094,6100,20201219
20201216,수인선,인천논현,4031,4183,8214,20201219
20201216,수인선,소래포구,3008,2858,5866,20201219
20201216,수인선,월곶,1853,1652,3505,20201219
20201216,수인선,달월,70,35,105,20201219
20201216,수인선,사리,2464,2299,4763,20201219
20201216,수인선,야목,129,97,226,20201219
20201216,수인선,어천,390,365,755,20201219
20201216,수인선,오목천,1607,1614,3221,20201219
20201216,수인선,고색,2491,2416,4907,20201219
20201216,분당선,매교,2000,2055,4055,20201219
20201216,분당선,수원시청,8679,9064,17743,20201219
20201216,분당선,매탄권선,3393,3262,6655,20201219
20201216,분당선,망포,10259,9864,20123,20201219
20201216,분당선,영통,5444,5639,11083,20201219
20201216,분당선,청명,3068,3009,6077,20201219
20201216,분당선,상갈,3895,3737,7632,20201219
20201216,분당선,기흥,6794,6630,13424,20201219
20201216,분당선,신갈,3296,3241,6537,20201219
20201216,분당선,구성,3475,3678,7153,20201219
20201216,분당선,죽전,9348,10303,19651,20201219
20201216,분당선,보정,1651,1414,3065,20201219
20201216,분당선,이매,3883,3675,7558,20201219
20201216,분당선,오리,8878,7498,16376,20201219
20201216,분당선,미금,11592,12199,23791,20201219
20201216,분당선,정자,11666,12297,23963,20201219
20201216,분당선,수내,9648,9705,19353,20201219
20201216,분당선,서현,17379,17629,35008,20201219
20201216,분당선,야탑,19444,20314,39758,20201219
20201216,분당선,모란,15066,15109,30175,20201219
20201216,분당선,태평,10442,10317,20759,20201219
20201216,분당선,가천대,5427,6252,11679,20201219
20201216,분당선,선정릉,6563,6903,13466,20201219
20201216,분당선,강남구청,7329,8382,15711,20201219
20201216,분당선,압구정로데오,13074,13976,27050,20201219
20201216,분당선,서울숲,6211,6269,12480,20201219
20201216,분당선,수원,5572,4721,10293,20201219
20201216,분당선,수서,9215,9727,18942,20201219
20201216,분당선,대모산입구,2747,2609,5356,20201219
20201216,분당선,개포동,2632,2749,5381,20201219
20201216,분당선,구룡,1148,1143,2291,20201219
20201216,분당선,도곡,4949,5003,9952,20201219
20201216,분당선,한티,10092,10768,20860,20201219
20201216,분당선,선릉,11131,16117,27248,20201219
20201216,과천선,범계,19005,18448,37453,20201219
20201216,과천선,평촌,14125,14033,28158,20201219
20201216,과천선,인덕원,18340,19176,37516,20201219
20201216,과천선,정부과천청사,7303,7195,14498,20201219
20201216,과천선,과천,3827,3580,7407,20201219
20201216,과천선,대공원,1119,1229,2348,20201219
20201216,과천선,경마공원,971,983,1954,20201219
20201216,과천선,선바위,6552,5924,12476,20201219
20201216,공항철도 1호선,영종,1918,1930,3848,20201219
20201216,공항철도 1호선,인천공항2터미널,1732,1644,3376,20201219
20201216,공항철도 1호선,인천공항1터미널,2796,3089,5885,20201219
20201216,공항철도 1호선,공항화물청사,2082,2259,4341,20201219
20201216,공항철도 1호선,운서,4377,4425,8802,20201219
20201216,공항철도 1호선,청라국제도시,4941,4545,9486,20201219
20201216,공항철도 1호선,검암,5601,5464,11065,20201219
20201216,공항철도 1호선,계양,7154,6704,13858,20201219
20201216,공항철도 1호선,김포공항,6828,4853,11681,20201219
20201216,공항철도 1호선,마곡나루(서울식물원),5478,5173,10651,20201219
20201216,공항철도 1호선,디지털미디어시티,10954,9708,20662,20201219
20201216,공항철도 1호선,홍대입구,4981,5274,10255,20201219
20201216,공항철도 1호선,공덕,1614,1974,3588,20201219
20201216,공항철도 1호선,서울역,4538,3986,8524,20201219
20201216,경춘선,춘천,649,634,1283,20201219
20201216,경춘선,남춘천,1460,1434,2894,20201219
20201216,경춘선,김유정,129,146,275,20201219
20201216,경춘선,강촌,200,217,417,20201219
20201216,경춘선,백양리,106,136,242,20201219
20201216,경춘선,굴봉산,38,42,80,20201219
20201216,경춘선,가평,873,884,1757,20201219
20201216,경춘선,상천,147,140,287,20201219
20201216,경춘선,청평,891,912,1803,20201219
20201216,경춘선,대성리,303,277,580,20201219
20201216,경춘선,마석,2686,2557,5243,20201219
20201216,경춘선,천마산,1192,1099,2291,20201219
20201216,경춘선,평내호평,4359,4311,8670,20201219
20201216,경춘선,금곡,1093,1069,2162,20201219
20201216,경춘선,사릉,2596,2545,5141,20201219
20201216,2호선,봉천,19254,18100,37354,20201219
20201216,경춘선,퇴계원,2773,2503,5276,20201219
20201216,5호선,청구,3256,3026,6282,20201219
20201216,경춘선,별내,2010,1946,3956,20201219
20201216,경춘선,갈매,2331,2031,4362,20201219
20201216,경춘선,신내,1101,1105,2206,20201219
20201216,경인선,도화,3033,2836,5869,20201219
20201216,경인선,중동,7164,6929,14093,20201219
20201216,경인선,온수(성공회대입구),5046,4992,10038,20201219
20201216,경인선,도원,2052,2051,4103,20201219
20201216,경인선,간석,4334,4108,8442,20201219
20201216,경인선,부개,6557,6306,12863,20201219
20201216,경인선,소사,7707,7178,14885,20201219
20201216,경인선,구일,4567,4738,9305,20201219
20201216,경인선,인천,2209,1514,3723,20201219
20201216,경인선,동인천,10117,9770,19887,20201219
20201216,경인선,제물포,7812,7462,15274,20201219
20201216,경인선,주안,14157,12985,27142,20201219
20201216,경인선,동암,11759,11957,23716,20201219
20201216,경인선,백운,5371,5339,10710,20201219
20201216,경인선,부평,21489,22637,44126,20201219
20201216,경인선,송내,21601,21730,43331,20201219
20201216,경인선,부천,25105,25291,50396,20201219
20201216,경인선,역곡,21301,21287,42588,20201219
20201216,경인선,오류동,9098,8896,17994,20201219
20201216,경인선,개봉,16726,17399,34125,20201219
20201216,경의선,임진강,6,5,11,20201219
20201216,경의선,문산,3425,3409,6834,20201219
20201216,경의선,파주,762,605,1367,20201219
20201216,경의선,월롱,1655,1499,3154,20201219
20201216,경의선,금촌,4465,4570,9035,20201219
20201216,경의선,금릉,3106,2975,6081,20201219
20201216,경의선,운정,4615,4416,9031,20201219
20201216,경의선,야당,4306,4152,8458,20201219
20201216,경의선,탄현,5477,5437,10914,20201219
20201216,경의선,일산,6594,6732,13326,20201219
20201216,경의선,풍산,3842,3634,7476,20201219
20201216,경의선,백마,4887,4762,9649,20201219
20201216,경의선,곡산,383,386,769,20201219
20201216,경의선,능곡,2719,2518,5237,20201219
20201216,경의선,행신,5703,5834,11537,20201219
20201216,경의선,강매,2291,1993,4284,20201219
20201216,경의선,화전,1537,1395,2932,20201219
20201216,경의선,수색,1897,1974,3871,20201219
20201216,경의선,디지털미디어시티,1786,1764,3550,20201219
20201216,경의선,가좌,3833,3570,7403,20201219
20201216,경의선,홍대입구,1013,1127,2140,20201219
20201216,경의선,서강대,1395,1326,2721,20201219
20201216,경의선,공덕,2441,2175,4616,20201219
20201216,경의선,효창공원앞,2310,2551,4861,20201219
20201216,경의선,신촌,606,733,1339,20201219
20201216,경의선,서울역,3125,3794,6919,20201219
20201216,경원선,소요산,1469,1250,2719,20201219
20201216,경원선,동두천,1346,1501,2847,20201219
20201216,경원선,보산,1079,1022,2101,20201219
20201216,경원선,동두천중앙,2191,2095,4286,20201219
20201216,경원선,지행,4555,4448,9003,20201219
20201216,경원선,덕정,4175,4217,8392,20201219
20201216,경원선,덕계,2008,1857,3865,20201219
20201216,경원선,양주,5497,5108,10605,20201219
20201216,경원선,녹양,3420,3298,6718,20201219
20201216,경원선,가능,4727,4653,9380,20201219
20201216,경원선,의정부,13195,13337,26532,20201219
20201216,경원선,회룡,9341,9160,18501,20201219
20201216,경원선,망월사,5271,5430,10701,20201219
20201216,경원선,도봉산,5227,3034,8261,20201219
20201216,경원선,도봉,4599,4441,9040,20201219
20201216,경원선,방학,7275,7249,14524,20201219
20201216,경원선,창동,1,0,1,20201219
20201216,경원선,녹천,3721,3154,6875,20201219
20201216,경원선,월계,4721,4515,9236,20201219
20201216,경원선,광운대,6418,6102,12520,20201219
20201216,경원선,석계,6018,7090,13108,20201219
20201216,경원선,신이문,6817,6403,13220,20201219
20201216,경원선,외대앞,5240,5241,10481,20201219
20201216,경원선,청량리(서울시립대입구),9271,10082,19353,20201219
20201216,경원선,왕십리(성동구청),9423,10870,20293,20201219
20201216,경원선,응봉,1304,1112,2416,20201219
20201216,경원선,옥수,41,21,62,20201219
20201216,경원선,한남,3219,3038,6257,20201219
20201216,경원선,서빙고,1366,1253,2619,20201219
20201216,경원선,이촌(국립중앙박물관),2675,2093,4768,20201219
20201216,경부선,광명,2190,1973,4163,20201219
20201216,경부선,서동탄,1143,920,2063,20201219
20201216,경부선,당정,4797,4656,9453,20201219
20201216,경부선,천안,3140,3201,6341,20201219
20201216,경부선,두정,3792,3718,7510,20201219
20201216,경부선,직산,515,508,1023,20201219
20201216,경부선,성환,2594,2603,5197,20201219
20201216,경부선,평택,7654,7615,15269,20201219
20201216,경부선,지제,1975,1838,3813,20201219
20201216,경부선,서정리,4713,4619,9332,20201219
20201216,경부선,송탄,3008,2891,5899,20201219
20201216,경부선,진위,1245,1048,2293,20201219
20201216,경부선,오산,7021,7086,14107,20201219
20201216,경부선,오산대,2568,2401,4969,20201219
20201216,경부선,세마,1884,1708,3592,20201219
20201216,경부선,병점,9578,9469,19047,20201219
20201216,경부선,세류,2244,2087,4331,20201219
20201216,경부선,독산,14286,15254,29540,20201219
20201216,경부선,수원,21840,23103,44943,20201219
20201216,경부선,화서,5464,5524,10988,20201219
20201216,경부선,성균관대,10646,10578,21224,20201219
20201216,경부선,의왕,6875,6960,13835,20201219
20201216,경부선,군포,6433,6638,13071,20201219
20201216,경부선,금정,20641,21038,41679,20201219
20201216,경부선,명학,7686,7662,15348,20201219
20201216,경부선,안양,16119,16194,32313,20201219
20201216,경부선,관악,5446,5117,10563,20201219
20201216,경부선,석수,8247,7140,15387,20201219
20201216,경부선,금천구청,9067,9063,18130,20201219
20201216,경부선,가산디지털단지,14374,16999,31373,20201219
20201216,경부선,구로,15431,15554,30985,20201219
20201216,경부선,신길,7348,6097,13445,20201219
20201216,경부선,신도림,2992,2978,5970,20201219
20201216,경부선,영등포,26840,27212,54052,20201219
20201216,경부선,대방,9931,10347,20278,20201219
20201216,경부선,노량진,5581,6173,11754,20201219
20201216,경부선,용산,21219,21292,42511,20201219
20201216,경부선,남영,7547,7880,15427,20201219
20201216,경부선,서울역,2672,928,3600,20201219
20201216,경강선,여주,1133,1180,2313,20201219
20201216,경강선,세종대왕릉,174,160,334,20201219
20201216,경강선,부발,1169,1116,2285,20201219
20201216,경강선,이천,1577,1665,3242,20201219
20201216,경강선,신둔도예촌,830,748,1578,20201219
20201216,경강선,곤지암,1484,1451,2935,20201219
20201216,경강선,초월,2200,2171,4371,20201219
20201216,경강선,경기광주,5023,4933,9956,20201219
20201216,경강선,삼동,1745,1610,3355,20201219
20201216,경강선,이매,740,669,1409,20201219
20201216,경강선,판교,3326,3223,6549,20201219
20201216,9호선2~3단계,중앙보훈병원,7844,7050,14894,20201219
20201216,9호선2~3단계,둔촌오륜,882,758,1640,20201219
20201216,9호선2~3단계,올림픽공원(한국체대),3881,3923,7804,20201219
20201216,9호선2~3단계,한성백제,1773,1583,3356,20201219
20201216,9호선2~3단계,송파나루,3469,3632,7101,20201219
20201216,9호선2~3단계,석촌,5598,5141,10739,20201219
20201216,9호선2~3단계,석촌고분,4391,4557,8948,20201219
20201216,9호선2~3단계,삼전,5139,5072,10211,20201219
20201216,9호선2~3단계,종합운동장,3109,2987,6096,20201219
20201216,9호선2~3단계,봉은사,11295,11188,22483,20201219
20201216,9호선2~3단계,삼성중앙,5425,5571,10996,20201219
20201216,9호선2~3단계,선정릉,7329,7792,15121,20201219
20201216,9호선2~3단계,언주,7916,8026,15942,20201219
20201216,9호선,신논현,21963,21387,43350,20201219
20201216,9호선,사평,2262,2302,4564,20201219
20201216,9호선,고속터미널,7529,9258,16787,20201219
20201216,9호선,신반포,2206,2228,4434,20201219
20201216,9호선,구반포,1938,2001,3939,20201219
20201216,9호선,동작(현충원),1220,961,2181,20201219
20201216,9호선,흑석(중앙대입구),5456,5781,11237,20201219
20201216,9호선,노들,3309,2986,6295,20201219
20201216,9호선,노량진,17499,16791,34290,20201219
20201216,9호선,샛강,4266,4466,8732,20201219
20201216,9호선,여의도,18367,17693,36060,20201219
20201216,9호선,국회의사당,13722,13584,27306,20201219
20201216,9호선,당산,13465,13260,26725,20201219
20201216,9호선,선유도,6035,5986,12021,20201219
20201216,9호선,신목동,2858,2670,5528,20201219
20201216,9호선,염창,13136,13100,26236,20201219
20201216,9호선,등촌,8604,8614,17218,20201219
20201216,9호선,증미,5845,5951,11796,20201219
20201216,9호선,가양,15547,15308,30855,20201219
20201216,9호선,양천향교,7317,7681,14998,20201219
20201216,9호선,마곡나루(서울식물원),8035,8067,16102,20201219
20201216,9호선,신방화,5118,5205,10323,20201219
20201216,9호선,공항시장,2272,2521,4793,20201219
20201216,9호선,김포공항,5057,6287,11344,20201219
20201216,9호선,개화,1911,1429,3340,20201219
20201216,8호선,모란,3310,2437,5747,20201219
20201216,8호선,수진,4104,3750,7854,20201219
20201216,8호선,신흥,3570,3821,7391,20201219
20201216,8호선,단대오거리,8060,8042,16102,20201219
20201216,8호선,남한산성입구(성남법원.검찰청),10752,10007,20759,20201219
20201216,8호선,산성,5394,5446,10840,20201219
20201216,8호선,복정,8151,7007,15158,20201219
20201216,8호선,장지,13587,13516,27103,20201219
20201216,8호선,문정,18222,18956,37178,20201219
20201216,8호선,가락시장,6206,6886,13092,20201219
20201216,8호선,송파,6084,6112,12196,20201219
20201216,8호선,석촌,5850,6550,12400,20201219
20201216,8호선,잠실(송파구청),9883,10927,20810,20201219
20201216,8호선,몽촌토성(평화의문),4236,4442,8678,20201219
20201216,8호선,강동구청,8530,8951,17481,20201219
20201216,8호선,천호(풍납토성),12070,13368,25438,20201219
20201216,8호선,암사,15078,13553,28631,20201219
20201216,7호선,부평구청,9356,7843,17199,20201219
20201216,7호선,굴포천,6986,7371,14357,20201219
20201216,7호선,삼산체육관,3734,3318,7052,20201219
20201216,7호선,상동,9150,9594,18744,20201219
20201216,7호선,부천시청,9835,9856,19691,20201219
20201216,7호선,신중동,11458,11249,22707,20201219
20201216,7호선,춘의,8549,8498,17047,20201219
20201216,7호선,부천종합운동장,3768,3313,7081,20201219
20201216,7호선,까치울,6079,5940,12019,20201219
20201216,7호선,온수(성공회대입구),8939,8238,17177,20201219
20201216,7호선,천왕,8809,8392,17201,20201219
20201216,7호선,광명사거리,18094,18022,36116,20201219
20201216,7호선,철산,17043,17286,34329,20201219
20201216,7호선,가산디지털단지,40428,40339,80767,20201219
20201216,7호선,남구로,13871,14742,28613,20201219
20201216,7호선,대림(구로구청),6181,6090,12271,20201219
20201216,7호선,신풍,9169,8970,18139,20201219
20201216,7호선,보라매,7840,7696,15536,20201219
20201216,7호선,신대방삼거리,13264,12990,26254,20201219
20201216,7호선,장승배기,7754,7641,15395,20201219
20201216,7호선,상도,7888,7669,15557,20201219
20201216,7호선,숭실대입구(살피재),8894,9183,18077,20201219
20201216,7호선,남성,9019,8493,17512,20201219
20201216,7호선,이수,11542,11364,22906,20201219
20201216,7호선,내방,11861,11952,23813,20201219
20201216,7호선,고속터미널,10616,9643,20259,20201219
20201216,7호선,반포,4450,4357,8807,20201219
20201216,7호선,논현,15930,17257,33187,20201219
20201216,7호선,학동,20492,21528,42020,20201219
20201216,7호선,강남구청,13070,14148,27218,20201219
20201216,7호선,청담,15706,17266,32972,20201219
20201216,7호선,뚝섬유원지,5427,5400,10827,20201219
20201216,7호선,건대입구,9384,9448,18832,20201219
20201216,7호선,어린이대공원(세종대),9187,8929,18116,20201219
20201216,7호선,군자(능동),11485,9318,20803,20201219
20201216,7호선,중곡,8167,7737,15904,20201219
20201216,7호선,용마산(용마폭포공원),4870,4632,9502,20201219
20201216,7호선,사가정,13153,13189,26342,20201219
20201216,7호선,면목,12419,12398,24817,20201219
20201216,7호선,상봉(시외버스터미널),13188,12305,25493,20201219
20201216,7호선,중화,8787,8822,17609,20201219
20201216,7호선,먹골,8000,8025,16025,20201219
20201216,7호선,태릉입구,6321,5830,12151,20201219
20201216,7호선,공릉(서울과학기술대),8839,8809,17648,20201219
20201216,7호선,하계,13973,13474,27447,20201219
20201216,7호선,중계,11147,10230,21377,20201219
20201216,7호선,노원,14371,14680,29051,20201219
20201216,7호선,마들,9550,9389,18939,20201219
20201216,7호선,수락산,9729,9829,19558,20201219
20201216,7호선,도봉산,7138,8177,15315,20201219
20201216,7호선,장암,1811,629,2440,20201219
20201216,6호선,봉화산(서울의료원),7091,6722,13813,20201219
20201216,6호선,화랑대(서울여대입구),8826,6950,15776,20201219
20201216,6호선,태릉입구,4060,4385,8445,20201219
20201216,6호선,석계,9809,10046,19855,20201219
20201216,6호선,돌곶이,6839,6566,13405,20201219
20201216,6호선,상월곡(한국과학기술연구원),4910,4510,9420,20201219
20201216,6호선,월곡(동덕여대),8496,8526,17022,20201219
20201216,6호선,고려대(종암),5816,5799,11615,20201219
20201216,6호선,안암(고대병원앞),6950,6988,13938,20201219
20201216,6호선,보문,5705,5315,11020,20201219
20201216,6호선,창신,2838,2290,5128,20201219
20201216,6호선,동묘앞,6159,6306,12465,20201219
20201216,6호선,신당,6124,6553,12677,20201219
20201216,6호선,청구,3103,3324,6427,20201219
20201216,6호선,약수,2729,2784,5513,20201219
20201216,6호선,버티고개,1767,1694,3461,20201219
20201216,6호선,한강진,5158,5677,10835,20201219
20201216,6호선,이태원,5974,6157,12131,20201219
20201216,6호선,녹사평(용산구청),3109,3090,6199,20201219
20201216,6호선,삼각지,3956,3582,7538,20201219
20201216,6호선,효창공원앞,5507,5112,10619,20201219
20201216,6호선,대흥(서강대앞),5838,6100,11938,20201219
20201216,6호선,광흥창(서강),6882,6616,13498,20201219
20201216,6호선,상수,5619,5984,11603,20201219
20201216,6호선,합정,9069,8864,17933,20201219
20201216,6호선,망원,10123,11096,21219,20201219
20201216,6호선,마포구청,11043,10087,21130,20201219
20201216,6호선,월드컵경기장(성산),2908,3089,5997,20201219
20201216,6호선,디지털미디어시티,11074,12300,23374,20201219
20201216,6호선,증산(명지대앞),7967,7919,15886,20201219
20201216,6호선,새절(신사),10252,9871,20123,20201219
20201216,6호선,구산,5801,4524,10325,20201219
20201216,6호선,연신내,1,0,1,20201219
20201216,6호선,독바위,2238,2433,4671,20201219
20201216,6호선,불광,3429,3510,6939,20201219
20201216,6호선,역촌,3018,3510,6528,20201219
20201216,6호선,응암,13960,14082,28042,20201219
20201216,5호선,하남풍산,3726,3797,7523,20201219
20201216,5호선,미사,10178,10292,20470,20201219
20201216,5호선,마천,4634,4647,9281,20201219
20201216,2호선,구로디지털단지,48783,49360,98143,20201219
20201216,2호선,대림(구로구청),19756,20316,40072,20201219
20201216,2호선,신도림,37003,35399,72402,20201219
20201216,2호선,문래,16790,17195,33985,20201219
20201216,2호선,영등포구청,18647,18995,37642,20201219
20201216,2호선,당산,14018,16635,30653,20201219
20201216,2호선,합정,21285,21806,43091,20201219
20201216,2호선,홍대입구,31036,31780,62816,20201219
20201216,2호선,신촌,21119,22014,43133,20201219
20201216,2호선,이대,8420,8667,17087,20201219
20201216,2호선,아현,7602,7395,14997,20201219
20201216,2호선,충정로(경기대입구),8175,8424,16599,20201219
20201216,2호선,용답,1957,1964,3921,20201219
20201216,2호선,신답,1255,1497,2752,20201219
20201216,2호선,신설동,2568,2657,5225,20201219
20201216,2호선,도림천,1226,1277,2503,20201219
20201216,2호선,양천구청,5079,5558,10637,20201219
20201216,2호선,신정네거리,7643,8078,15721,20201219
20201216,2호선,용두(동대문구청),1837,1954,3791,20201219
20201216,3호선,지축,2380,2368,4748,20201219
20201216,3호선,구파발,15475,14518,29993,20201219
20201216,3호선,연신내,29012,27310,56322,20201219
20201216,3호선,불광,12434,13246,25680,20201219
20201216,3호선,녹번,11909,10926,22835,20201219
20201216,3호선,홍제,13250,12746,25996,20201219
20201216,3호선,무악재,2982,3095,6077,20201219
20201216,3호선,독립문,5128,5371,10499,20201219
20201216,3호선,경복궁(정부서울청사),13352,12876,26228,20201219
20201216,3호선,안국,13624,13497,27121,20201219
20201216,3호선,종로3가,7705,8628,16333,20201219
20201216,3호선,을지로3가,8335,8496,16831,20201219
20201216,3호선,동대입구,5431,5714,11145,20201219
20201216,3호선,약수,9898,9713,19611,20201219
20201216,3호선,금호,6125,5872,11997,20201219
20201216,3호선,옥수,6386,6774,13160,20201219
20201216,3호선,압구정,23591,25001,48592,20201219
20201216,3호선,신사,22138,23102,45240,20201219
20201216,3호선,잠원,3433,3439,6872,20201219
20201216,3호선,고속터미널,26282,25342,51624,20201219
20201216,3호선,교대(법원.검찰청),10805,7266,18071,20201219
20201216,3호선,남부터미널(예술의전당),21667,22348,44015,20201219
20201216,3호선,양재(서초구청),30579,32850,63429,20201219
20201216,3호선,매봉,9873,9310,19183,20201219
20201216,3호선,도곡,4172,4122,8294,20201219
20201216,3호선,대치,7414,7440,14854,20201219
20201216,3호선,학여울,1246,1277,2523,20201219
20201216,3호선,대청,7155,6489,13644,20201219
20201216,3호선,일원,7509,7399,14908,20201219
20201216,3호선,수서,11723,12030,23753,20201219
20201216,3호선,가락시장,6889,6701,13590,20201219
20201216,3호선,경찰병원,6125,6156,12281,20201219
20201216,3호선,오금,4917,4352,9269,20201219
20201216,4호선,수유(강북구청),26877,26951,53828,20201219
20201216,4호선,미아(서울사이버대학),11755,11613,23368,20201219
20201216,4호선,미아사거리,21329,21148,42477,20201219
20201216,4호선,길음,15372,15273,30645,20201219
20201216,4호선,성신여대입구(돈암),14155,13705,27860,20201219
20201216,4호선,한성대입구(삼선교),10250,10179,20429,20201219
20201216,4호선,혜화,21292,20879,42171,20201219
20201216,4호선,동대문,16020,16370,32390,20201219
20201216,4호선,동대문역사문화공원(DDP),11170,10438,21608,20201219
20201216,4호선,충무로,22009,22456,44465,20201219
20201216,4호선,명동,12668,12880,25548,20201219
20201216,4호선,회현(남대문시장),17359,17949,35308,20201219
20201216,4호선,서울역,8413,10547,18960,20201219
20201216,4호선,숙대입구(갈월),9561,9404,18965,20201219
20201216,4호선,삼각지,3614,3792,7406,20201219
20201216,4호선,신용산,10776,11397,22173,20201219
20201216,4호선,이촌(국립중앙박물관),4851,5510,10361,20201219
20201216,4호선,동작(현충원),1593,1728,3321,20201219
20201216,4호선,총신대입구(이수),14095,15287,29382,20201219
20201216,4호선,사당,17484,14578,32062,20201219
20201216,4호선,남태령,766,655,1421,20201219
20201216,4호선,당고개,9696,8907,18603,20201219
20201216,4호선,상계,14999,14067,29066,20201219
20201216,4호선,노원,13679,15159,28838,20201219
20201216,4호선,창동,19636,21019,40655,20201219
20201216,4호선,쌍문,23811,22167,45978,20201219
20201216,5호선,방화,5145,4853,9998,20201219
20201216,5호선,개화산,4078,3932,8010,20201219
20201216,5호선,김포공항,4769,4751,9520,20201219
20201216,5호선,송정,5142,4867,10009,20201219
20201216,5호선,마곡,7559,7322,14881,20201219
20201216,5호선,발산,14096,14350,28446,20201219
20201216,5호선,우장산,10442,10483,20925,20201219
20201216,5호선,화곡,22644,21715,44359,20201219
20201216,5호선,까치산,22803,22228,45031,20201219
20201216,5호선,신정(은행정),11449,9159,20608,20201219
20201216,5호선,목동,13122,14582,27704,20201219
20201216,5호선,오목교(목동운동장앞),16640,17917,34557,20201219
20201216,5호선,양평,6252,6309,12561,20201219
20201216,5호선,영등포구청,3282,3211,6493,20201219
20201216,5호선,영등포시장,7183,7465,14648,20201219
20201216,5호선,신길,3116,3510,6626,20201219
20201216,5호선,여의도,21470,22038,43508,20201219
20201216,5호선,여의나루,5397,5537,10934,20201219
20201216,5호선,마포,11080,11507,22587,20201219
20201216,5호선,공덕,10818,11564,22382,20201219
20201216,5호선,애오개,5288,5397,10685,20201219
20201216,5호선,충정로(경기대입구),4060,4228,8288,20201219
20201216,5호선,서대문,15356,15594,30950,20201219
20201216,5호선,광화문(세종문화회관),23626,24129,47755,20201219
20201216,5호선,종로3가,7294,7072,14366,20201219
20201216,5호선,을지로4가,4934,4980,9914,20201219
20201216,5호선,동대문역사문화공원(DDP),2277,2478,4755,20201219
20201216,5호선,신금호,4758,4949,9707,20201219
20201216,5호선,행당,6324,5645,11969,20201219
20201216,5호선,왕십리(성동구청),3356,3631,6987,20201219
20201216,5호선,마장,4322,4161,8483,20201219
20201216,5호선,답십리,12844,11821,24665,20201219
20201216,5호선,장한평,14955,14990,29945,20201219
20201216,5호선,군자(능동),8588,9259,17847,20201219
20201216,5호선,아차산(어린이대공원후문),10732,10745,21477,20201219
20201216,5호선,광나루(장신대),9650,8776,18426,20201219
20201216,5호선,천호(풍납토성),13381,13521,26902,20201219
20201216,5호선,강동,15603,14586,30189,20201219
20201216,5호선,길동,6034,6338,12372,20201219
20201216,5호선,굽은다리(강동구민회관앞),7119,6981,14100,20201219
20201216,5호선,명일,6352,6621,12973,20201219
20201216,5호선,고덕,6589,6604,13193,20201219
20201216,5호선,상일동,12362,11260,23622,20201219
20201216,5호선,둔촌동,6364,6437,12801,20201219
20201216,5호선,올림픽공원(한국체대),3150,2605,5755,20201219
20201216,5호선,방이,5214,5408,10622,20201219
20201216,5호선,오금,2939,2891,5830,20201219
20201216,5호선,개롱,4875,5151,10026,20201219
20201216,5호선,거여,6173,5950,12123,20201219
20201216,2호선,신림,50157,49310,99467,20201219
20201216,2호선,신대방,20838,20411,41249,20201219
20201216,1호선,서울역,30082,27967,58049,20201219
20201216,1호선,동묘앞,5456,5655,11111,20201219
20201216,1호선,시청,16537,16553,33090,20201219
20201216,1호선,종각,25540,24679,50219,20201219
20201216,1호선,종로3가,15967,14500,30467,20201219
20201216,1호선,종로5가,16451,16409,32860,20201219
20201216,1호선,동대문,8392,7950,16342,20201219
20201216,1호선,신설동,11364,11135,22499,20201219
20201216,1호선,제기동,11901,12003,23904,20201219
20201216,1호선,청량리(서울시립대입구),14861,14791,29652,20201219
20201216,2호선,시청,19401,18611,38012,20201219
20201216,2호선,을지로입구,30440,30679,61119,20201219
20201216,2호선,을지로3가,16480,16128,32608,20201219
20201216,2호선,을지로4가,10657,10503,21160,20201219
20201216,2호선,동대문역사문화공원(DDP),8438,9339,17777,20201219
20201217,6호선,불광,3533,3575,7108,20201220
20201217,중앙선,신원,115,115,230,20201220
20201217,중앙선,양수,1051,1077,2128,20201220
20201217,중앙선,운길산,413,364,777,20201220
20201217,중앙선,팔당,529,572,1101,20201220
20201217,중앙선,도심,1822,1358,3180,20201220
20201217,중앙선,덕소,4259,4243,8502,20201220
20201217,중앙선,양정,588,474,1062,20201220
20201217,중앙선,도농,7473,6965,14438,20201220
20201217,중앙선,구리,10110,10297,20407,20201220
20201217,중앙선,양원,1228,1258,2486,20201220
20201217,중앙선,망우,5817,5704,11521,20201220
20201217,중앙선,상봉(시외버스터미널),4495,4441,8936,20201220
20201217,중앙선,중랑,4251,3994,8245,20201220
20201217,중앙선,회기,17805,17152,34957,20201220
20201217,장항선,신창(순천향대),810,777,1587,20201220
20201217,장항선,온양온천,2299,2367,4666,20201220
20201217,장항선,배방,740,688,1428,20201220
20201217,장항선,아산,1958,1806,3764,20201220
20201217,장항선,쌍용(나사렛대),1510,1367,2877,20201220
20201217,장항선,봉명,990,1003,1993,20201220
20201217,일산선,대화,9952,7959,17911,20201220
20201217,일산선,주엽,6276,6391,12667,20201220
20201217,일산선,정발산,4965,4902,9867,20201220
20201217,일산선,마두,5463,5681,11144,20201220
20201217,일산선,백석,7820,7926,15746,20201220
20201217,일산선,대곡,1297,929,2226,20201220
20201217,일산선,화정,12339,12874,25213,20201220
20201217,일산선,원당,8497,8059,16556,20201220
20201217,일산선,삼송,13719,13626,27345,20201220
20201217,일산선,원흥,7070,6752,13822,20201220
20201217,우이신설선,신설동,1829,1706,3535,20201220
20201217,우이신설선,보문,1174,1188,2362,20201220
20201217,우이신설선,성신여대입구(돈암),2138,2360,4498,20201220
20201217,우이신설선,정릉,3422,3256,6678,20201220
20201217,우이신설선,북한산보국문,4327,4370,8697,20201220
20201217,우이신설선,솔샘,4422,4242,8664,20201220
20201217,우이신설선,삼양사거리,1838,1859,3697,20201220
20201217,우이신설선,삼양,1661,1871,3532,20201220
20201217,우이신설선,화계,2613,2565,5178,20201220
20201217,우이신설선,가오리,3184,3222,6406,20201220
20201217,우이신설선,4.19민주묘지,2041,2025,4066,20201220
20201217,우이신설선,솔밭공원,1864,1895,3759,20201220
20201217,우이신설선,북한산우이,1918,1690,3608,20201220
20201217,안산선,수리산,3370,2754,6124,20201220
20201217,안산선,오이도,6304,6037,12341,20201220
20201217,안산선,정왕,7340,7713,15053,20201220
20201217,안산선,신길온천,1192,1139,2331,20201220
20201217,안산선,안산,9610,8491,18101,20201220
20201217,안산선,초지,3427,3482,6909,20201220
20201217,안산선,고잔,6681,6486,13167,20201220
20201217,안산선,중앙,11762,12077,23839,20201220
20201217,안산선,한대앞,6746,6741,13487,20201220
20201217,안산선,상록수,12676,12856,25532,20201220
20201217,안산선,반월,3216,3151,6367,20201220
20201217,안산선,대야미,3798,3480,7278,20201220
20201217,안산선,산본,12053,12749,24802,20201220
20201217,수인선,인천,710,1187,1897,20201220
20201217,수인선,신포,1257,1236,2493,20201220
20201217,수인선,숭의,3124,2943,6067,20201220
20201217,수인선,인하대,4154,4027,8181,20201220
20201217,수인선,송도,1834,1738,3572,20201220
20201217,수인선,연수,3256,3219,6475,20201220
20201217,수인선,원인재,3305,3378,6683,20201220
20201217,수인선,남동인더스파크,2085,2327,4412,20201220
20201217,수인선,호구포,3025,3156,6181,20201220
20201217,수인선,인천논현,4004,4235,8239,20201220
20201217,수인선,고색,2594,2533,5127,20201220
20201217,분당선,매교,2357,2348,4705,20201220
20201217,분당선,수원시청,8712,9262,17974,20201220
20201217,분당선,매탄권선,3420,3391,6811,20201220
20201217,분당선,망포,10541,10078,20619,20201220
20201217,분당선,영통,5700,5851,11551,20201220
20201217,분당선,청명,3177,3104,6281,20201220
20201217,분당선,상갈,3926,3808,7734,20201220
20201217,분당선,기흥,6866,6767,13633,20201220
20201217,분당선,신갈,3273,3332,6605,20201220
20201217,분당선,구성,3602,3863,7465,20201220
20201217,분당선,죽전,9706,10546,20252,20201220
20201217,분당선,보정,1821,1549,3370,20201220
20201217,분당선,이매,3879,3717,7596,20201220
20201217,분당선,오리,9259,7787,17046,20201220
20201217,분당선,미금,11518,12179,23697,20201220
20201217,분당선,정자,12086,12555,24641,20201220
20201217,분당선,수내,9732,9830,19562,20201220
20201217,분당선,서현,17677,17981,35658,20201220
20201217,분당선,야탑,19429,20211,39640,20201220
20201217,분당선,모란,15411,15491,30902,20201220
20201217,분당선,태평,10717,10544,21261,20201220
20201217,분당선,가천대,5446,6201,11647,20201220
20201217,분당선,선정릉,6503,7020,13523,20201220
20201217,분당선,강남구청,7104,8272,15376,20201220
20201217,분당선,압구정로데오,13428,14443,27871,20201220
20201217,분당선,서울숲,6161,6292,12453,20201220
20201217,분당선,수원,5615,4486,10101,20201220
20201217,분당선,수서,9413,9881,19294,20201220
20201217,분당선,대모산입구,2784,2615,5399,20201220
20201217,분당선,개포동,2671,2801,5472,20201220
20201217,분당선,구룡,1200,1205,2405,20201220
20201217,분당선,도곡,5028,5039,10067,20201220
20201217,분당선,한티,10070,10873,20943,20201220
20201217,분당선,선릉,10965,15926,26891,20201220
20201217,과천선,범계,18919,18399,37318,20201220
20201217,과천선,평촌,14495,14617,29112,20201220
20201217,과천선,인덕원,18536,19379,37915,20201220
20201217,과천선,정부과천청사,7524,7403,14927,20201220
20201217,과천선,과천,3827,3557,7384,20201220
20201217,과천선,대공원,1248,1322,2570,20201220
20201217,과천선,경마공원,1053,1052,2105,20201220
20201217,과천선,선바위,6772,6032,12804,20201220
20201217,공항철도 1호선,영종,1999,2037,4036,20201220
20201217,공항철도 1호선,인천공항2터미널,1677,1654,3331,20201220
20201217,공항철도 1호선,인천공항1터미널,2903,3272,6175,20201220
20201217,공항철도 1호선,공항화물청사,2142,2359,4501,20201220
20201217,공항철도 1호선,운서,4609,4631,9240,20201220
20201217,공항철도 1호선,청라국제도시,4997,4646,9643,20201220
20201217,공항철도 1호선,검암,5790,5612,11402,20201220
20201217,공항철도 1호선,계양,7166,6699,13865,20201220
20201217,공항철도 1호선,김포공항,7367,5278,12645,20201220
20201217,공항철도 1호선,마곡나루(서울식물원),5562,5298,10860,20201220
20201217,공항철도 1호선,디지털미디어시티,10834,9619,20453,20201220
20201217,공항철도 1호선,홍대입구,5262,5385,10647,20201220
20201217,공항철도 1호선,공덕,1618,2027,3645,20201220
20201217,공항철도 1호선,서울역,4712,4247,8959,20201220
20201217,경춘선,춘천,838,751,1589,20201220
20201217,경춘선,남춘천,1575,1660,3235,20201220
20201217,경춘선,김유정,131,143,274,20201220
20201217,경춘선,강촌,237,235,472,20201220
20201217,경춘선,백양리,121,122,243,20201220
20201217,경춘선,굴봉산,52,72,124,20201220
20201217,경춘선,가평,971,954,1925,20201220
20201217,경춘선,상천,120,126,246,20201220
20201217,경춘선,청평,950,984,1934,20201220
20201217,경춘선,대성리,310,270,580,20201220
20201217,경춘선,마석,2745,2646,5391,20201220
20201217,경춘선,천마산,1250,1174,2424,20201220
20201217,경춘선,평내호평,4398,4356,8754,20201220
20201217,경춘선,금곡,1138,1093,2231,20201220
20201217,경춘선,사릉,2680,2587,5267,20201220
20201217,경춘선,퇴계원,2803,2653,5456,20201220
20201217,경춘선,별내,2033,1984,4017,20201220
20201217,경춘선,갈매,2349,2025,4374,20201220
20201217,경춘선,신내,1154,1208,2362,20201220
20201217,경인선,도화,3125,2833,5958,20201220
20201217,경인선,중동,7333,7079,14412,20201220
20201217,경인선,온수(성공회대입구),5100,5085,10185,20201220
20201217,경인선,도원,2036,2136,4172,20201220
20201217,경인선,간석,4518,4296,8814,20201220
20201217,경인선,부개,6499,6253,12752,20201220
20201217,경인선,소사,7731,7402,15133,20201220
20201217,경인선,구일,4729,4943,9672,20201220
20201217,경인선,인천,2346,1647,3993,20201220
20201217,경인선,동인천,10285,9857,20142,20201220
20201217,경인선,제물포,7733,7414,15147,20201220
20201217,경인선,주안,14247,13247,27494,20201220
20201217,경인선,동암,11832,12066,23898,20201220
20201217,경인선,백운,5344,5418,10762,20201220
20201217,경인선,부평,21884,22798,44682,20201220
20201217,경인선,송내,21792,21799,43591,20201220
20201217,경인선,부천,25126,25340,50466,20201220
20201217,경인선,역곡,21639,21722,43361,20201220
20201217,경인선,오류동,9373,8930,18303,20201220
20201217,경인선,개봉,16839,17594,34433,20201220
20201217,경의선,임진강,3,1,4,20201220
20201217,경의선,문산,3515,3545,7060,20201220
20201217,경의선,파주,808,668,1476,20201220
20201217,경의선,월롱,1720,1523,3243,20201220
20201217,경의선,금촌,4462,4561,9023,20201220
20201217,경의선,금릉,3189,3151,6340,20201220
20201217,경의선,운정,4525,4339,8864,20201220
20201217,경의선,야당,4456,4285,8741,20201220
20201217,경의선,탄현,5550,5456,11006,20201220
20201217,경의선,일산,6769,6931,13700,20201220
20201217,경의선,풍산,4002,3665,7667,20201220
20201217,경의선,백마,4986,4883,9869,20201220
20201217,경의선,곡산,393,412,805,20201220
20201217,경의선,능곡,2836,2619,5455,20201220
20201217,경의선,행신,5922,5964,11886,20201220
20201217,경의선,강매,2300,2053,4353,20201220
20201217,경의선,화전,1428,1287,2715,20201220
20201217,경의선,수색,1906,2025,3931,20201220
20201217,경의선,디지털미디어시티,1842,1757,3599,20201220
20201217,경의선,가좌,4112,3737,7849,20201220
20201217,경의선,홍대입구,1062,1141,2203,20201220
20201217,경의선,서강대,1497,1379,2876,20201220
20201217,경의선,공덕,2636,2245,4881,20201220
20201217,경의선,효창공원앞,2294,2614,4908,20201220
20201217,경의선,신촌,633,759,1392,20201220
20201217,경의선,서울역,3202,3805,7007,20201220
20201217,경원선,소요산,1641,1394,3035,20201220
20201217,경원선,동두천,1446,1619,3065,20201220
20201217,경원선,보산,1174,1080,2254,20201220
20201217,경원선,동두천중앙,2266,2264,4530,20201220
20201217,경원선,지행,4655,4656,9311,20201220
20201217,경원선,덕정,4305,4272,8577,20201220
20201217,경원선,덕계,1996,1897,3893,20201220
20201217,경원선,양주,5615,5163,10778,20201220
20201217,경원선,녹양,3531,3426,6957,20201220
20201217,경원선,가능,4816,4826,9642,20201220
20201217,경원선,의정부,13182,13149,26331,20201220
20201217,경원선,회룡,9653,9499,19152,20201220
20201217,경원선,망월사,5453,5719,11172,20201220
20201217,경원선,도봉산,5594,3207,8801,20201220
20201217,경원선,도봉,4806,4624,9430,20201220
20201217,경원선,방학,7206,7189,14395,20201220
20201217,경원선,녹천,3801,3215,7016,20201220
20201217,경원선,월계,4971,4792,9763,20201220
20201217,경원선,광운대,6516,6071,12587,20201220
20201217,경원선,석계,6385,7137,13522,20201220
20201217,경원선,신이문,7020,6566,13586,20201220
20201217,경원선,외대앞,5357,5338,10695,20201220
20201217,경원선,청량리(서울시립대입구),9820,10621,20441,20201220
20201217,경원선,왕십리(성동구청),9830,11098,20928,20201220
20201217,경원선,응봉,1340,1135,2475,20201220
20201217,경원선,옥수,37,30,67,20201220
20201217,경원선,한남,3333,3137,6470,20201220
20201217,경원선,서빙고,1428,1269,2697,20201220
20201217,경원선,이촌(국립중앙박물관),2796,2179,4975,20201220
20201217,경부선,광명,2260,2022,4282,20201220
20201217,경부선,서동탄,1133,927,2060,20201220
20201217,경부선,당정,4810,4628,9438,20201220
20201217,경부선,천안,3304,3491,6795,20201220
20201217,경부선,두정,3637,3623,7260,20201220
20201217,경부선,직산,508,514,1022,20201220
20201217,경부선,성환,2672,2554,5226,20201220
20201217,경부선,평택,8001,7845,15846,20201220
20201217,경부선,지제,2046,1973,4019,20201220
20201217,경부선,서정리,4784,4508,9292,20201220
20201217,경부선,송탄,2988,2840,5828,20201220
20201217,경부선,진위,1198,1054,2252,20201220
20201217,경부선,오산,6965,6991,13956,20201220
20201217,경부선,오산대,2389,2364,4753,20201220
20201217,경부선,세마,1881,1736,3617,20201220
20201217,경부선,병점,9721,9614,19335,20201220
20201217,경부선,세류,2248,2087,4335,20201220
20201217,경부선,독산,14321,15325,29646,20201220
20201217,경부선,수원,22472,23794,46266,20201220
20201217,경부선,화서,5539,5470,11009,20201220
20201217,경부선,성균관대,10741,10702,21443,20201220
20201217,경부선,의왕,6989,6883,13872,20201220
20201217,경부선,군포,6462,6654,13116,20201220
20201217,경부선,금정,20445,21130,41575,20201220
20201217,경부선,명학,7731,7810,15541,20201220
20201217,경부선,안양,16503,16703,33206,20201220
20201217,경부선,관악,5700,5229,10929,20201220
20201217,경부선,석수,8242,7230,15472,20201220
20201217,경부선,금천구청,9220,9181,18401,20201220
20201217,경부선,가산디지털단지,14502,16953,31455,20201220
20201217,경부선,구로,15382,15592,30974,20201220
20201217,경부선,신길,7450,6195,13645,20201220
20201217,경부선,신도림,3196,3144,6340,20201220
20201217,경부선,영등포,28123,28751,56874,20201220
20201217,경부선,대방,10108,10463,20571,20201220
20201217,경부선,노량진,5856,6243,12099,20201220
20201217,경부선,용산,21888,22324,44212,20201220
20201217,경부선,남영,7456,7761,15217,20201220
20201217,경부선,서울역,3010,1042,4052,20201220
20201217,경강선,여주,1140,1098,2238,20201220
20201217,경강선,세종대왕릉,166,162,328,20201220
20201217,경강선,부발,1215,1096,2311,20201220
20201217,경강선,이천,1495,1593,3088,20201220
20201217,경강선,신둔도예촌,817,777,1594,20201220
20201217,경강선,곤지암,1502,1502,3004,20201220
20201217,경강선,초월,2189,2233,4422,20201220
20201217,경강선,경기광주,5015,4946,9961,20201220
20201217,경강선,삼동,1725,1642,3367,20201220
20201217,경강선,이매,714,645,1359,20201220
20201217,경강선,판교,3323,3195,6518,20201220
20201217,9호선2~3단계,중앙보훈병원,7868,6988,14856,20201220
20201217,9호선2~3단계,둔촌오륜,1036,862,1898,20201220
20201217,9호선2~3단계,올림픽공원(한국체대),3916,3862,7778,20201220
20201217,9호선2~3단계,한성백제,1836,1623,3459,20201220
20201217,9호선2~3단계,송파나루,3436,3674,7110,20201220
20201217,9호선2~3단계,석촌,5708,5139,10847,20201220
20201217,9호선2~3단계,석촌고분,4444,4450,8894,20201220
20201217,9호선2~3단계,삼전,5151,4984,10135,20201220
20201217,9호선2~3단계,종합운동장,2983,3024,6007,20201220
20201217,9호선2~3단계,봉은사,11658,11578,23236,20201220
20201217,9호선2~3단계,삼성중앙,5400,5584,10984,20201220
20201217,9호선2~3단계,선정릉,7283,7797,15080,20201220
20201217,9호선2~3단계,언주,8010,7927,15937,20201220
20201217,9호선,신논현,21994,21758,43752,20201220
20201217,9호선,사평,2389,2383,4772,20201220
20201217,9호선,고속터미널,7689,9799,17488,20201220
20201217,9호선,신반포,2281,2267,4548,20201220
20201217,9호선,구반포,1979,2105,4084,20201220
20201217,9호선,동작(현충원),1290,977,2267,20201220
20201217,9호선,흑석(중앙대입구),5589,5936,11525,20201220
20201217,9호선,노들,3312,2987,6299,20201220
20201217,9호선,노량진,17517,16844,34361,20201220
20201217,9호선,샛강,4370,4537,8907,20201220
20201217,9호선,여의도,18487,17678,36165,20201220
20201217,9호선,국회의사당,13277,13146,26423,20201220
20201217,9호선,당산,13485,13424,26909,20201220
20201217,9호선,선유도,6191,5973,12164,20201220
20201217,9호선,신목동,3029,2746,5775,20201220
20201217,9호선,염창,13286,13257,26543,20201220
20201217,9호선,등촌,8644,8716,17360,20201220
20201217,9호선,증미,5755,5944,11699,20201220
20201217,9호선,가양,15844,15569,31413,20201220
20201217,9호선,양천향교,7346,7562,14908,20201220
20201217,9호선,마곡나루(서울식물원),8148,8084,16232,20201220
20201217,9호선,신방화,5214,5072,10286,20201220
20201217,9호선,공항시장,2165,2451,4616,20201220
20201217,9호선,김포공항,5157,6922,12079,20201220
20201217,9호선,개화,1977,1385,3362,20201220
20201217,8호선,모란,3298,2359,5657,20201220
20201217,8호선,수진,3974,3616,7590,20201220
20201217,8호선,신흥,3580,3827,7407,20201220
20201217,8호선,단대오거리,8031,7966,15997,20201220
20201217,8호선,남한산성입구(성남법원.검찰청),10833,10026,20859,20201220
20201217,8호선,산성,5416,5434,10850,20201220
20201217,8호선,복정,8301,7193,15494,20201220
20201217,8호선,장지,13892,13727,27619,20201220
20201217,8호선,문정,18339,19198,37537,20201220
20201217,8호선,가락시장,6368,7104,13472,20201220
20201217,8호선,송파,6185,6119,12304,20201220
20201217,8호선,잠실(송파구청),10906,12180,23086,20201220
20201217,8호선,몽촌토성(평화의문),4338,4507,8845,20201220
20201217,8호선,강동구청,8373,8933,17306,20201220
20201217,8호선,천호(풍납토성),12315,13617,25932,20201220
20201217,8호선,암사,15126,13601,28727,20201220
20201217,7호선,부평구청,9338,7732,17070,20201220
20201217,7호선,굴포천,6848,7240,14088,20201220
20201217,7호선,삼산체육관,3788,3344,7132,20201220
20201217,7호선,상동,9149,9543,18692,20201220
20201217,7호선,부천시청,9730,9667,19397,20201220
20201217,7호선,신중동,11414,11140,22554,20201220
20201217,7호선,춘의,8526,8459,16985,20201220
20201217,7호선,부천종합운동장,3899,3375,7274,20201220
20201217,7호선,까치울,6113,5934,12047,20201220
20201217,7호선,온수(성공회대입구),8913,8235,17148,20201220
20201217,7호선,천왕,8821,8412,17233,20201220
20201217,7호선,광명사거리,18319,18290,36609,20201220
20201217,7호선,철산,17088,17373,34461,20201220
20201217,7호선,가산디지털단지,39867,40032,79899,20201220
20201217,7호선,남구로,13859,14817,28676,20201220
20201217,7호선,대림(구로구청),6112,6061,12173,20201220
20201217,7호선,신풍,9359,9057,18416,20201220
20201217,7호선,보라매,7639,7618,15257,20201220
20201217,7호선,신대방삼거리,13227,13057,26284,20201220
20201217,7호선,장승배기,7750,7651,15401,20201220
20201217,7호선,상도,7916,7772,15688,20201220
20201217,7호선,숭실대입구(살피재),9223,9497,18720,20201220
20201217,7호선,남성,9022,8466,17488,20201220
20201217,7호선,이수,11669,11452,23121,20201220
20201217,7호선,내방,11658,11809,23467,20201220
20201217,7호선,고속터미널,11156,9839,20995,20201220
20201217,7호선,반포,4678,4478,9156,20201220
20201217,7호선,논현,16028,17241,33269,20201220
20201217,7호선,학동,20301,21478,41779,20201220
20201217,7호선,강남구청,12998,14104,27102,20201220
20201217,7호선,청담,15804,17290,33094,20201220
20201217,7호선,뚝섬유원지,5655,5597,11252,20201220
20201217,7호선,건대입구,9279,9436,18715,20201220
20201217,7호선,어린이대공원(세종대),9313,9101,18414,20201220
20201217,7호선,군자(능동),11607,9310,20917,20201220
20201217,7호선,중곡,8254,7752,16006,20201220
20201217,7호선,용마산(용마폭포공원),4982,4779,9761,20201220
20201217,7호선,사가정,13318,13361,26679,20201220
20201217,7호선,면목,12670,12624,25294,20201220
20201217,7호선,상봉(시외버스터미널),13353,12788,26141,20201220
20201217,7호선,중화,8929,8875,17804,20201220
20201217,7호선,먹골,8240,8113,16353,20201220
20201217,7호선,태릉입구,6231,5866,12097,20201220
20201217,7호선,공릉(서울과학기술대),8889,8920,17809,20201220
20201217,7호선,하계,13774,13454,27228,20201220
20201217,7호선,중계,11299,10334,21633,20201220
20201217,7호선,노원,14520,15081,29601,20201220
20201217,7호선,마들,9868,9664,19532,20201220
20201217,7호선,수락산,9911,10056,19967,20201220
20201217,7호선,도봉산,7113,8435,15548,20201220
20201217,7호선,장암,1882,665,2547,20201220
20201217,6호선,봉화산(서울의료원),7101,6751,13852,20201220
20201217,6호선,화랑대(서울여대입구),8801,7012,15813,20201220
20201217,6호선,태릉입구,4131,4482,8613,20201220
20201217,6호선,석계,9784,10072,19856,20201220
20201217,6호선,돌곶이,6892,6497,13389,20201220
20201217,6호선,상월곡(한국과학기술연구원),4980,4518,9498,20201220
20201217,6호선,월곡(동덕여대),8737,8776,17513,20201220
20201217,6호선,고려대(종암),5978,5900,11878,20201220
20201217,6호선,안암(고대병원앞),7245,7120,14365,20201220
20201217,6호선,보문,5751,5407,11158,20201220
20201217,6호선,창신,2738,2214,4952,20201220
20201217,6호선,동묘앞,6268,6392,12660,20201220
20201217,6호선,신당,6099,6541,12640,20201220
20201217,6호선,청구,3095,3259,6354,20201220
20201217,6호선,약수,2783,2809,5592,20201220
20201217,6호선,버티고개,1731,1711,3442,20201220
20201217,6호선,한강진,5154,5710,10864,20201220
20201217,6호선,이태원,6177,6386,12563,20201220
20201217,6호선,녹사평(용산구청),3216,3172,6388,20201220
20201217,6호선,삼각지,4157,3689,7846,20201220
20201217,6호선,효창공원앞,5558,5112,10670,20201220
20201217,6호선,공덕,13926,13423,27349,20201220
20201217,6호선,대흥(서강대앞),5845,5989,11834,20201220
20201217,6호선,광흥창(서강),6791,6545,13336,20201220
20201217,6호선,상수,5692,6060,11752,20201220
20201217,6호선,합정,8998,8741,17739,20201220
20201217,6호선,망원,10389,11357,21746,20201220
20201217,6호선,마포구청,11264,10331,21595,20201220
20201217,6호선,월드컵경기장(성산),3209,3379,6588,20201220
20201217,6호선,디지털미디어시티,11079,12215,23294,20201220
20201217,6호선,증산(명지대앞),8084,8040,16124,20201220
20201217,6호선,새절(신사),10302,9683,19985,20201220
20201217,6호선,구산,5881,4497,10378,20201220
20201217,6호선,독바위,2267,2469,4736,20201220
20201217,중앙선,국수,464,425,889,20201220
20201217,6호선,응암,13915,14006,27921,20201220
20201217,5호선,하남풍산,3768,3794,7562,20201220
20201217,5호선,미사,10166,10135,20301,20201220
20201217,5호선,마천,4655,4707,9362,20201220
20201217,5호선,거여,6153,5986,12139,20201220
20201217,5호선,개롱,4905,5095,10000,20201220
20201217,5호선,오금,2962,2930,5892,20201220
20201217,5호선,방이,5134,5470,10604,20201220
20201217,5호선,올림픽공원(한국체대),3100,2715,5815,20201220
20201217,5호선,둔촌동,6557,6638,13195,20201220
20201217,5호선,상일동,12478,11347,23825,20201220
20201217,5호선,고덕,6695,6556,13251,20201220
20201217,5호선,명일,6333,6627,12960,20201220
20201217,5호선,굽은다리(강동구민회관앞),7379,6947,14326,20201220
20201217,5호선,길동,6060,6464,12524,20201220
20201217,5호선,강동,15718,14797,30515,20201220
20201217,5호선,천호(풍납토성),13629,13727,27356,20201220
20201217,5호선,광나루(장신대),9854,9047,18901,20201220
20201217,5호선,아차산(어린이대공원후문),10845,10848,21693,20201220
20201217,5호선,군자(능동),8654,9246,17900,20201220
20201217,5호선,장한평,15045,14971,30016,20201220
20201217,5호선,답십리,13196,12142,25338,20201220
20201217,5호선,마장,4379,4182,8561,20201220
20201217,5호선,왕십리(성동구청),3449,3692,7141,20201220
20201217,5호선,행당,6255,5668,11923,20201220
20201217,5호선,신금호,4868,5058,9926,20201220
20201217,5호선,청구,3340,3077,6417,20201220
20201217,5호선,동대문역사문화공원(DDP),2421,2759,5180,20201220
20201217,5호선,을지로4가,5028,5120,10148,20201220
20201217,5호선,종로3가,7212,7052,14264,20201220
20201217,5호선,광화문(세종문화회관),23482,24397,47879,20201220
20201217,5호선,서대문,14793,15155,29948,20201220
20201217,5호선,충정로(경기대입구),4054,4089,8143,20201220
20201217,5호선,애오개,5270,5249,10519,20201220
20201217,5호선,공덕,10826,11681,22507,20201220
20201217,5호선,마포,11090,11539,22629,20201220
20201217,5호선,여의나루,5582,5797,11379,20201220
20201217,5호선,여의도,21647,22227,43874,20201220
20201217,5호선,신길,3119,3528,6647,20201220
20201217,5호선,영등포시장,7360,7629,14989,20201220
20201217,5호선,영등포구청,3282,3401,6683,20201220
20201217,5호선,양평,6227,6317,12544,20201220
20201217,5호선,오목교(목동운동장앞),16790,17955,34745,20201220
20201217,5호선,목동,13178,14811,27989,20201220
20201217,5호선,신정(은행정),11462,9188,20650,20201220
20201217,5호선,까치산,23236,22429,45665,20201220
20201217,5호선,화곡,22804,21618,44422,20201220
20201217,5호선,우장산,10316,10371,20687,20201220
20201217,5호선,발산,14240,14242,28482,20201220
20201217,5호선,마곡,7409,7154,14563,20201220
20201217,5호선,송정,5229,4930,10159,20201220
20201217,5호선,김포공항,5090,5054,10144,20201220
20201217,5호선,개화산,4160,3936,8096,20201220
20201217,5호선,방화,5176,4988,10164,20201220
20201217,4호선,쌍문,24003,22178,46181,20201220
20201217,4호선,창동,20309,21656,41965,20201220
20201217,4호선,노원,13814,15609,29423,20201220
20201217,4호선,상계,15226,14095,29321,20201220
20201217,4호선,당고개,9664,8970,18634,20201220
20201217,4호선,남태령,838,712,1550,20201220
20201217,4호선,사당,17716,14648,32364,20201220
20201217,4호선,총신대입구(이수),14247,15504,29751,20201220
20201217,4호선,동작(현충원),1700,1865,3565,20201220
20201217,4호선,이촌(국립중앙박물관),5004,5683,10687,20201220
20201217,4호선,신용산,11242,11720,22962,20201220
20201217,4호선,삼각지,3630,3855,7485,20201220
20201217,4호선,숙대입구(갈월),9704,9606,19310,20201220
20201217,4호선,서울역,8357,10683,19040,20201220
20201217,4호선,회현(남대문시장),17475,18195,35670,20201220
20201217,4호선,명동,13452,13771,27223,20201220
20201217,4호선,충무로,22053,22697,44750,20201220
20201217,4호선,동대문역사문화공원(DDP),11350,10668,22018,20201220
20201217,4호선,동대문,16000,16563,32563,20201220
20201217,4호선,혜화,21215,20978,42193,20201220
20201217,4호선,한성대입구(삼선교),10280,10203,20483,20201220
20201217,4호선,성신여대입구(돈암),14500,13808,28308,20201220
20201217,4호선,길음,15436,15185,30621,20201220
20201217,4호선,미아사거리,21808,21452,43260,20201220
20201217,4호선,미아(서울사이버대학),12076,11872,23948,20201220
20201217,4호선,수유(강북구청),27025,26919,53944,20201220
20201217,3호선,오금,4798,4361,9159,20201220
20201217,3호선,경찰병원,6143,6319,12462,20201220
20201217,3호선,가락시장,6974,6875,13849,20201220
20201217,3호선,수서,11917,12275,24192,20201220
20201217,3호선,일원,7746,7624,15370,20201220
20201217,3호선,대청,7403,6823,14226,20201220
20201217,3호선,학여울,1361,1339,2700,20201220
20201217,3호선,대치,7487,7515,15002,20201220
20201217,3호선,도곡,4094,4294,8388,20201220
20201217,3호선,매봉,9902,9332,19234,20201220
20201217,3호선,양재(서초구청),30548,32775,63323,20201220
20201217,3호선,남부터미널(예술의전당),21849,22488,44337,20201220
20201217,3호선,교대(법원.검찰청),10827,7285,18112,20201220
20201217,3호선,고속터미널,26806,26323,53129,20201220
20201217,3호선,잠원,3536,3517,7053,20201220
20201217,3호선,신사,22362,23331,45693,20201220
20201217,3호선,압구정,23584,24846,48430,20201220
20201217,3호선,옥수,6665,6954,13619,20201220
20201217,3호선,금호,6368,6104,12472,20201220
20201217,3호선,약수,10052,9844,19896,20201220
20201217,3호선,동대입구,5423,5715,11138,20201220
20201217,3호선,충무로,2,0,2,20201220
20201217,3호선,을지로3가,8322,8574,16896,20201220
20201217,3호선,종로3가,7785,8689,16474,20201220
20201217,3호선,안국,13717,13775,27492,20201220
20201217,3호선,경복궁(정부서울청사),13389,12936,26325,20201220
20201217,3호선,독립문,5496,5720,11216,20201220
20201217,3호선,무악재,3030,3039,6069,20201220
20201217,3호선,홍제,13501,12999,26500,20201220
20201217,3호선,녹번,12056,11088,23144,20201220
20201217,3호선,불광,12675,13580,26255,20201220
20201217,3호선,연신내,29190,27525,56715,20201220
20201217,3호선,구파발,16079,15067,31146,20201220
20201217,3호선,지축,2457,2437,4894,20201220
20201217,2호선,용두(동대문구청),1870,2010,3880,20201220
20201217,2호선,신정네거리,7807,8110,15917,20201220
20201217,2호선,양천구청,5269,5609,10878,20201220
20201217,2호선,도림천,1193,1238,2431,20201220
20201217,2호선,신설동,2559,2570,5129,20201220
20201217,2호선,신답,1255,1465,2720,20201220
20201217,2호선,용답,2037,2075,4112,20201220
20201217,2호선,충정로(경기대입구),8072,8434,16506,20201220
20201217,2호선,아현,7681,7452,15133,20201220
20201217,2호선,이대,8467,8706,17173,20201220
20201217,2호선,신촌,21528,22203,43731,20201220
20201217,2호선,홍대입구,31505,32473,63978,20201220
20201217,2호선,합정,21532,22225,43757,20201220
20201217,2호선,당산,14393,16739,31132,20201220
20201217,2호선,영등포구청,19439,19558,38997,20201220
20201217,2호선,문래,16913,17259,34172,20201220
20201217,2호선,신도림,37898,36389,74287,20201220
20201217,2호선,대림(구로구청),19879,20190,40069,20201220
20201217,2호선,구로디지털단지,48935,49608,98543,20201220
20201217,2호선,신대방,21270,20855,42125,20201220
20201217,2호선,신림,50386,49042,99428,20201220
20201217,2호선,봉천,19327,18035,37362,20201220
20201217,2호선,서울대입구(관악구청),35895,34872,70767,20201220
20201217,2호선,낙성대(강감찬),21031,20567,41598,20201220
20201217,2호선,사당,26284,28864,55148,20201220
20201217,2호선,방배,12906,13445,26351,20201220
20201217,2호선,서초,17178,16860,34038,20201220
20201217,2호선,교대(법원.검찰청),26467,29419,55886,20201220
20201217,2호선,강남,58376,56739,115115,20201220
20201217,2호선,역삼,40756,43769,84525,20201220
20201217,2호선,선릉,44806,40344,85150,20201220
20201217,2호선,삼성(무역센터),38573,38561,77134,20201220
20201217,2호선,종합운동장,5036,5277,10313,20201220
20201217,2호선,잠실새내,14739,14641,29380,20201220
20201217,2호선,잠실(송파구청),46897,47011,93908,20201220
20201217,2호선,잠실나루,11218,10698,21916,20201220
20201217,2호선,강변(동서울터미널),21712,21287,42999,20201220
20201217,2호선,구의(광진구청),18852,18602,37454,20201220
20201217,2호선,건대입구,23277,24555,47832,20201220
20201217,2호선,성수,27371,29830,57201,20201220
20201217,2호선,뚝섬,15921,17461,33382,20201220
20201217,2호선,한양대,5639,5956,11595,20201220
20201217,2호선,왕십리(성동구청),11664,9176,20840,20201220
20201217,2호선,상왕십리,10971,10795,21766,20201220
20201217,2호선,신당,10950,11241,22191,20201220
20201217,2호선,동대문역사문화공원(DDP),8688,9549,18237,20201220
20201217,2호선,을지로4가,11045,10721,21766,20201220
20201217,2호선,을지로3가,16289,16222,32511,20201220
20201217,2호선,을지로입구,31091,31165,62256,20201220
20201217,2호선,시청,18908,18599,37507,20201220
20201217,1호선,청량리(서울시립대입구),15641,15849,31490,20201220
20201217,1호선,제기동,12950,13182,26132,20201220
20201217,1호선,신설동,11288,11084,22372,20201220
20201217,1호선,종로5가,16897,16924,33821,20201220
20201217,1호선,종로3가,16865,15202,32067,20201220
20201217,1호선,종각,25928,25026,50954,20201220
20201217,1호선,시청,16713,16623,33336,20201220
20201217,1호선,동묘앞,5885,6083,11968,20201220
20201217,1호선,동대문,8667,8192,16859,20201220
20201217,1호선,서울역,30470,28653,59123,20201220
20201217,6호선,역촌,3020,3564,6584,20201220
20201217,8호선,석촌,5819,6456,12275,20201220
20201217,수인선,오목천,1613,1536,3149,20201220
20201217,수인선,어천,401,409,810,20201220
20201217,수인선,야목,130,108,238,20201220
20201217,수인선,사리,2440,2342,4782,20201220
20201217,수인선,달월,74,51,125,20201220
20201217,수인선,월곶,1839,1728,3567,20201220
20201217,수인선,소래포구,3231,3034,6265,20201220
20201217,중앙선,지평,24,22,46,20201220
20201217,중앙선,용문,907,939,1846,20201220
20201217,중앙선,원덕,166,163,329,20201220
20201217,중앙선,양평,1542,1530,3072,20201220
20201217,중앙선,오빈,179,174,353,20201220
20201217,중앙선,아신,331,320,651,20201220
20201218,경춘선,평내호평,4715,4789,9504,20201221
20201218,경춘선,금곡,1198,1113,2311,20201221
20201218,경춘선,사릉,2813,2755,5568,20201221
20201218,경춘선,퇴계원,3022,2780,5802,20201221
20201218,경춘선,별내,2238,2241,4479,20201221
20201218,경춘선,갈매,2455,2124,4579,20201221
20201218,경춘선,신내,1218,1216,2434,20201221
20201218,경인선,도화,3192,2947,6139,20201221
20201218,경인선,중동,7566,7271,14837,20201221
20201218,경인선,온수(성공회대입구),5430,5261,10691,20201221
20201218,경인선,도원,2306,2367,4673,20201221
20201218,경인선,간석,4647,4507,9154,20201221
20201218,경인선,부개,6937,6543,13480,20201221
20201218,경인선,소사,8104,7519,15623,20201221
20201218,경인선,구일,4932,5088,10020,20201221
20201218,경인선,인천,2322,1770,4092,20201221
20201218,경인선,동인천,11077,10678,21755,20201221
20201218,경인선,제물포,8233,7942,16175,20201221
20201218,경인선,주안,15277,13999,29276,20201221
20201218,경인선,동암,12684,12814,25498,20201221
20201218,경인선,백운,5869,5791,11660,20201221
20201218,경인선,부평,23318,25118,48436,20201221
20201218,경인선,송내,22669,22721,45390,20201221
20201218,경인선,부천,26953,27948,54901,20201221
20201218,경인선,역곡,22527,22556,45083,20201221
20201218,경인선,오류동,9955,9486,19441,20201221
20201218,경인선,개봉,17922,18573,36495,20201221
20201218,경의선,임진강,13,2,15,20201221
20201218,경의선,문산,3838,3786,7624,20201221
20201218,경의선,파주,893,657,1550,20201221
20201218,경의선,월롱,1789,1513,3302,20201221
20201218,경의선,금촌,5047,5079,10126,20201221
20201218,경의선,금릉,3427,3329,6756,20201221
20201218,경의선,운정,4976,4697,9673,20201221
20201218,경의선,야당,4689,4552,9241,20201221
20201218,경의선,탄현,5771,5750,11521,20201221
20201218,경의선,일산,7373,7604,14977,20201221
20201218,경의선,풍산,4184,3968,8152,20201221
20201218,경의선,백마,5230,5142,10372,20201221
20201218,경의선,곡산,401,427,828,20201221
20201218,경의선,능곡,2917,2701,5618,20201221
20201218,경의선,행신,6063,6275,12338,20201221
20201218,경의선,강매,2424,2153,4577,20201221
20201218,경의선,화전,1417,1323,2740,20201221
20201218,경의선,수색,2002,2050,4052,20201221
20201218,경의선,디지털미디어시티,1959,1868,3827,20201221
20201218,경의선,가좌,4198,3926,8124,20201221
20201218,경의선,홍대입구,1127,1330,2457,20201221
20201218,경의선,서강대,1615,1620,3235,20201221
20201218,경의선,공덕,2711,2387,5098,20201221
20201218,경의선,효창공원앞,2451,2765,5216,20201221
20201218,경의선,신촌,645,790,1435,20201221
20201218,경의선,서울역,3228,3927,7155,20201221
20201218,경원선,소요산,1833,1581,3414,20201221
20201218,경원선,동두천,1511,1761,3272,20201221
20201218,경원선,보산,1385,1335,2720,20201221
20201218,경원선,동두천중앙,2457,2452,4909,20201221
20201218,경원선,지행,5114,5010,10124,20201221
20201218,경원선,덕정,4592,4482,9074,20201221
20201218,경원선,덕계,2078,1931,4009,20201221
20201218,경원선,양주,5824,5515,11339,20201221
20201218,경원선,녹양,3700,3574,7274,20201221
20201218,경원선,가능,5244,5022,10266,20201221
20201218,경원선,의정부,14412,14831,29243,20201221
20201218,경원선,회룡,10134,10083,20217,20201221
20201218,경원선,망월사,5653,5809,11462,20201221
20201218,경원선,도봉산,6191,3687,9878,20201221
20201218,경원선,도봉,5087,4836,9923,20201221
20201218,경원선,방학,7844,7766,15610,20201221
20201218,경원선,녹천,3897,3283,7180,20201221
20201218,경원선,월계,5276,4997,10273,20201221
20201218,경원선,광운대,6906,6559,13465,20201221
20201218,경원선,석계,6632,7543,14175,20201221
20201218,경원선,신이문,7167,6699,13866,20201221
20201218,경원선,외대앞,5837,5772,11609,20201221
20201218,경원선,청량리(서울시립대입구),11444,12560,24004,20201221
20201218,경원선,왕십리(성동구청),10261,11835,22096,20201221
20201218,경원선,응봉,1425,1164,2589,20201221
20201218,경원선,옥수,46,24,70,20201221
20201218,경원선,한남,3357,3126,6483,20201221
20201218,경원선,서빙고,1514,1331,2845,20201221
20201218,경원선,이촌(국립중앙박물관),2950,2317,5267,20201221
20201218,경부선,광명,2560,2364,4924,20201221
20201218,경부선,서동탄,1238,1004,2242,20201221
20201218,경부선,당정,5040,4805,9845,20201221
20201218,경부선,천안,4163,4300,8463,20201221
20201218,경부선,두정,4505,4212,8717,20201221
20201218,경부선,직산,620,572,1192,20201221
20201218,경부선,성환,3005,2768,5773,20201221
20201218,경부선,평택,9438,9150,18588,20201221
20201218,경부선,지제,2475,2193,4668,20201221
20201218,경부선,서정리,5387,4720,10107,20201221
20201218,경부선,송탄,3454,3301,6755,20201221
20201218,경부선,진위,1470,1158,2628,20201221
20201218,경부선,오산,8063,7830,15893,20201221
20201218,경부선,오산대,2507,2245,4752,20201221
20201218,경부선,세마,2165,1889,4054,20201221
20201218,경부선,병점,10893,10645,21538,20201221
20201218,경부선,세류,2570,2418,4988,20201221
20201218,경부선,독산,14622,15525,30147,20201221
20201218,경부선,수원,25660,27932,53592,20201221
20201218,경부선,화서,5906,5804,11710,20201221
20201218,경부선,성균관대,11622,11369,22991,20201221
20201218,경부선,의왕,7286,7208,14494,20201221
20201218,경부선,군포,6651,6792,13443,20201221
20201218,경부선,금정,21685,22153,43838,20201221
20201218,경부선,명학,7787,7743,15530,20201221
20201218,경부선,안양,17331,17548,34879,20201221
20201218,경부선,관악,5903,5452,11355,20201221
20201218,경부선,석수,8558,7426,15984,20201221
20201218,경부선,금천구청,9763,9729,19492,20201221
20201218,경부선,가산디지털단지,14241,16982,31223,20201221
20201218,경부선,구로,16061,16409,32470,20201221
20201218,경부선,신길,7670,6457,14127,20201221
20201218,경부선,신도림,3318,3214,6532,20201221
20201218,경부선,영등포,30853,32184,63037,20201221
20201218,경부선,대방,10359,10685,21044,20201221
20201218,경부선,노량진,6522,7010,13532,20201221
20201218,경부선,용산,25180,25802,50982,20201221
20201218,경부선,남영,7849,8329,16178,20201221
20201218,경부선,서울역,3714,1226,4940,20201221
20201218,경강선,여주,1280,1337,2617,20201221
20201218,경강선,세종대왕릉,166,179,345,20201221
20201218,경강선,부발,1729,1231,2960,20201221
20201218,경강선,이천,1801,1866,3667,20201221
20201218,경강선,신둔도예촌,916,891,1807,20201221
20201218,경강선,곤지암,1706,1618,3324,20201221
20201218,경강선,초월,2457,2391,4848,20201221
20201218,경강선,경기광주,5502,5299,10801,20201221
20201218,경강선,삼동,1913,1794,3707,20201221
20201218,경강선,이매,813,714,1527,20201221
20201218,경강선,판교,3406,3282,6688,20201221
20201218,9호선2~3단계,중앙보훈병원,7737,6853,14590,20201221
20201218,9호선2~3단계,둔촌오륜,1017,874,1891,20201221
20201218,9호선2~3단계,올림픽공원(한국체대),4211,4046,8257,20201221
20201218,9호선2~3단계,한성백제,1874,1689,3563,20201221
20201218,9호선2~3단계,송파나루,3558,3739,7297,20201221
20201218,9호선2~3단계,석촌,6076,5298,11374,20201221
20201218,9호선2~3단계,석촌고분,4584,4652,9236,20201221
20201218,9호선2~3단계,삼전,5386,5292,10678,20201221
20201218,9호선2~3단계,종합운동장,3321,3236,6557,20201221
20201218,9호선2~3단계,봉은사,12011,11804,23815,20201221
20201218,9호선2~3단계,삼성중앙,5489,5661,11150,20201221
20201218,9호선2~3단계,선정릉,7452,7923,15375,20201221
20201218,9호선2~3단계,언주,8170,8213,16383,20201221
20201218,9호선,신논현,24319,23805,48124,20201221
20201218,9호선,사평,2534,2456,4990,20201221
20201218,9호선,고속터미널,8674,11549,20223,20201221
20201218,9호선,신반포,2439,2379,4818,20201221
20201218,9호선,구반포,2063,2191,4254,20201221
20201218,9호선,동작(현충원),1344,966,2310,20201221
20201218,9호선,흑석(중앙대입구),6035,6320,12355,20201221
20201218,9호선,노들,3515,3091,6606,20201221
20201218,9호선,노량진,18866,17972,36838,20201221
20201218,9호선,샛강,4467,4659,9126,20201221
20201218,9호선,여의도,18710,17708,36418,20201221
20201218,9호선,국회의사당,13377,13347,26724,20201221
20201218,9호선,당산,14410,14241,28651,20201221
20201218,9호선,선유도,6334,6194,12528,20201221
20201218,9호선,신목동,3050,2745,5795,20201221
20201218,9호선,염창,13799,13693,27492,20201221
20201218,9호선,등촌,9279,9169,18448,20201221
20201218,9호선,증미,6087,6212,12299,20201221
20201218,9호선,가양,16328,16097,32425,20201221
20201218,9호선,양천향교,7637,7938,15575,20201221
20201218,9호선,마곡나루(서울식물원),8413,8544,16957,20201221
20201218,9호선,신방화,5409,5424,10833,20201221
20201218,9호선,공항시장,2342,2565,4907,20201221
20201218,9호선,김포공항,5883,7910,13793,20201221
20201218,9호선,개화,1986,1450,3436,20201221
20201218,8호선,모란,3432,2454,5886,20201221
20201218,8호선,수진,4281,3895,8176,20201221
20201218,8호선,신흥,3818,4180,7998,20201221
20201218,8호선,단대오거리,8594,8146,16740,20201221
20201218,8호선,남한산성입구(성남법원.검찰청),11344,10228,21572,20201221
20201218,8호선,산성,5677,5512,11189,20201221
20201218,8호선,복정,8597,7467,16064,20201221
20201218,8호선,장지,14418,14130,28548,20201221
20201218,8호선,문정,18237,19060,37297,20201221
20201218,8호선,가락시장,6847,7784,14631,20201221
20201218,8호선,송파,6353,6347,12700,20201221
20201218,8호선,석촌,6211,7130,13341,20201221
20201218,8호선,잠실(송파구청),11473,12781,24254,20201221
20201218,8호선,몽촌토성(평화의문),4565,4724,9289,20201221
20201218,8호선,강동구청,8912,9336,18248,20201221
20201218,8호선,천호(풍납토성),13125,14731,27856,20201221
20201218,8호선,암사,15675,14008,29683,20201221
20201218,7호선,부평구청,9601,7980,17581,20201221
20201218,7호선,굴포천,7087,7513,14600,20201221
20201218,7호선,삼산체육관,3868,3425,7293,20201221
20201218,7호선,상동,9708,10433,20141,20201221
20201218,7호선,부천시청,10257,10424,20681,20201221
20201218,7호선,신중동,12151,11951,24102,20201221
20201218,7호선,춘의,8680,8694,17374,20201221
20201218,7호선,부천종합운동장,4102,3550,7652,20201221
20201218,7호선,까치울,6308,6054,12362,20201221
20201218,7호선,온수(성공회대입구),9014,8354,17368,20201221
20201218,7호선,천왕,9047,8536,17583,20201221
20201218,7호선,광명사거리,18972,18999,37971,20201221
20201218,7호선,철산,17650,18081,35731,20201221
20201218,7호선,가산디지털단지,39814,39762,79576,20201221
20201218,7호선,남구로,13954,14871,28825,20201221
20201218,7호선,대림(구로구청),6244,6245,12489,20201221
20201218,7호선,신풍,9637,9312,18949,20201221
20201218,7호선,보라매,7994,7800,15794,20201221
20201218,7호선,신대방삼거리,13864,13568,27432,20201221
20201218,7호선,장승배기,8307,8098,16405,20201221
20201218,7호선,상도,8402,8174,16576,20201221
20201218,7호선,숭실대입구(살피재),9591,9485,19076,20201221
20201218,7호선,남성,9590,8868,18458,20201221
20201218,7호선,이수,12418,12124,24542,20201221
20201218,7호선,내방,12094,12271,24365,20201221
20201218,7호선,고속터미널,12438,10695,23133,20201221
20201218,7호선,반포,4786,4581,9367,20201221
20201218,7호선,논현,16628,18048,34676,20201221
20201218,7호선,학동,20225,21388,41613,20201221
20201218,7호선,강남구청,13428,14353,27781,20201221
20201218,7호선,청담,16210,17681,33891,20201221
20201218,7호선,뚝섬유원지,5761,5745,11506,20201221
20201218,7호선,건대입구,10114,10048,20162,20201221
20201218,7호선,어린이대공원(세종대),9749,9451,19200,20201221
20201218,7호선,군자(능동),12108,9825,21933,20201221
20201218,7호선,중곡,8376,7974,16350,20201221
20201218,7호선,용마산(용마폭포공원),5011,4836,9847,20201221
20201218,7호선,사가정,13947,13944,27891,20201221
20201218,7호선,면목,13175,13117,26292,20201221
20201218,7호선,상봉(시외버스터미널),14024,13606,27630,20201221
20201218,7호선,중화,9415,9154,18569,20201221
20201218,7호선,먹골,8623,8444,17067,20201221
20201218,7호선,태릉입구,6611,6214,12825,20201221
20201218,7호선,공릉(서울과학기술대),9534,9424,18958,20201221
20201218,7호선,하계,14274,13575,27849,20201221
20201218,7호선,중계,11703,10602,22305,20201221
20201218,7호선,노원,15863,16594,32457,20201221
20201218,7호선,마들,10276,9961,20237,20201221
20201218,7호선,수락산,10479,10504,20983,20201221
20201218,7호선,도봉산,7411,8732,16143,20201221
20201218,7호선,장암,1885,738,2623,20201221
20201218,6호선,봉화산(서울의료원),7362,6831,14193,20201221
20201218,6호선,화랑대(서울여대입구),9224,7255,16479,20201221
20201218,6호선,태릉입구,4258,4626,8884,20201221
20201218,6호선,석계,10147,10523,20670,20201221
20201218,6호선,돌곶이,7131,6592,13723,20201221
20201218,6호선,상월곡(한국과학기술연구원),5216,4621,9837,20201221
20201218,6호선,월곡(동덕여대),9343,9339,18682,20201221
20201218,6호선,고려대(종암),6245,6068,12313,20201221
20201218,6호선,안암(고대병원앞),7576,7449,15025,20201221
20201218,6호선,보문,6071,5550,11621,20201221
20201218,6호선,창신,2922,2361,5283,20201221
20201218,6호선,동묘앞,6622,6808,13430,20201221
20201218,6호선,신당,6581,6741,13322,20201221
20201218,6호선,청구,3219,3412,6631,20201221
20201218,6호선,약수,2968,2933,5901,20201221
20201218,6호선,버티고개,1947,1805,3752,20201221
20201218,6호선,한강진,5348,6108,11456,20201221
20201218,6호선,이태원,6630,6899,13529,20201221
20201218,6호선,녹사평(용산구청),3584,3502,7086,20201221
20201218,6호선,삼각지,4356,3889,8245,20201221
20201218,6호선,효창공원앞,6107,5739,11846,20201221
20201218,6호선,공덕,14541,13946,28487,20201221
20201218,6호선,대흥(서강대앞),6109,6335,12444,20201221
20201218,6호선,광흥창(서강),6988,6868,13856,20201221
20201218,6호선,상수,6087,6569,12656,20201221
20201218,6호선,합정,9620,9510,19130,20201221
20201218,6호선,망원,11063,12158,23221,20201221
20201218,6호선,마포구청,11824,10686,22510,20201221
20201218,6호선,월드컵경기장(성산),3430,3580,7010,20201221
20201218,6호선,디지털미디어시티,11291,12195,23486,20201221
20201218,6호선,증산(명지대앞),8370,8401,16771,20201221
20201218,6호선,새절(신사),10712,9972,20684,20201221
20201218,6호선,구산,6036,4562,10598,20201221
20201218,6호선,독바위,2313,2416,4729,20201221
20201218,6호선,불광,3745,3701,7446,20201221
20201218,6호선,역촌,3193,3639,6832,20201221
20201218,6호선,응암,14623,14570,29193,20201221
20201218,5호선,하남풍산,3916,4022,7938,20201221
20201218,5호선,미사,10840,10839,21679,20201221
20201218,5호선,마천,5026,4967,9993,20201221
20201218,5호선,거여,6481,6208,12689,20201221
20201218,5호선,개롱,5204,5266,10470,20201221
20201218,5호선,오금,3254,3171,6425,20201221
20201218,5호선,방이,5424,5565,10989,20201221
20201218,5호선,올림픽공원(한국체대),3307,2923,6230,20201221
20201218,5호선,둔촌동,6804,6940,13744,20201221
20201218,5호선,상일동,12890,11764,24654,20201221
20201218,5호선,고덕,7079,7021,14100,20201221
20201218,5호선,명일,6783,6923,13706,20201221
20201218,5호선,굽은다리(강동구민회관앞),7601,7224,14825,20201221
20201218,5호선,길동,6427,6900,13327,20201221
20201218,5호선,강동,16075,14941,31016,20201221
20201218,5호선,천호(풍납토성),14775,14792,29567,20201221
20201218,5호선,광나루(장신대),10049,9479,19528,20201221
20201218,5호선,아차산(어린이대공원후문),11722,11668,23390,20201221
20201218,5호선,군자(능동),9046,9767,18813,20201221
20201218,5호선,장한평,15183,15117,30300,20201221
20201218,5호선,답십리,13185,12265,25450,20201221
20201218,5호선,마장,4727,4453,9180,20201221
20201218,5호선,왕십리(성동구청),3684,3863,7547,20201221
20201218,5호선,행당,6587,5860,12447,20201221
20201218,5호선,신금호,5036,5175,10211,20201221
20201218,5호선,청구,3333,3085,6418,20201221
20201218,5호선,동대문역사문화공원(DDP),2460,2727,5187,20201221
20201218,5호선,을지로4가,5135,5253,10388,20201221
20201218,5호선,종로3가,7466,7530,14996,20201221
20201218,5호선,광화문(세종문화회관),23456,24185,47641,20201221
20201218,5호선,서대문,14820,15280,30100,20201221
20201218,5호선,충정로(경기대입구),3863,3957,7820,20201221
20201218,5호선,애오개,5382,5533,10915,20201221
20201218,5호선,공덕,11136,12014,23150,20201221
20201218,5호선,마포,11527,11962,23489,20201221
20201218,5호선,여의나루,5728,5793,11521,20201221
20201218,5호선,여의도,21239,22054,43293,20201221
20201218,5호선,신길,3251,3604,6855,20201221
20201218,5호선,영등포시장,7777,8034,15811,20201221
20201218,5호선,영등포구청,3386,3511,6897,20201221
20201218,5호선,양평,6353,6313,12666,20201221
20201218,5호선,오목교(목동운동장앞),17653,19123,36776,20201221
20201218,5호선,목동,13876,15334,29210,20201221
20201218,5호선,신정(은행정),11765,9256,21021,20201221
20201218,5호선,까치산,24212,23499,47711,20201221
20201218,5호선,화곡,23640,22448,46088,20201221
20201218,5호선,우장산,10928,11218,22146,20201221
20201218,5호선,발산,14256,14522,28778,20201221
20201218,5호선,마곡,7559,7356,14915,20201221
20201218,5호선,송정,5485,5159,10644,20201221
20201218,5호선,김포공항,5519,5448,10967,20201221
20201218,5호선,개화산,4302,4133,8435,20201221
20201218,5호선,방화,5402,5221,10623,20201221
20201218,4호선,쌍문,25046,23014,48060,20201221
20201218,4호선,창동,21394,22988,44382,20201221
20201218,4호선,노원,14984,16624,31608,20201221
20201218,4호선,상계,15724,14622,30346,20201221
20201218,4호선,당고개,10238,9350,19588,20201221
20201218,4호선,남태령,848,716,1564,20201221
20201218,4호선,사당,18924,15637,34561,20201221
20201218,4호선,총신대입구(이수),15367,16499,31866,20201221
20201218,4호선,동작(현충원),1886,1913,3799,20201221
20201218,4호선,이촌(국립중앙박물관),5297,5926,11223,20201221
20201218,4호선,신용산,11788,12282,24070,20201221
20201218,4호선,삼각지,3727,4065,7792,20201221
20201218,4호선,숙대입구(갈월),11677,11269,22946,20201221
20201218,4호선,서울역,8479,11755,20234,20201221
20201218,4호선,충무로,22173,22972,45145,20201221
20201218,4호선,동대문역사문화공원(DDP),11403,10858,22261,20201221
20201218,4호선,동대문,16615,17153,33768,20201221
20201218,4호선,혜화,22341,21862,44203,20201221
20201218,4호선,한성대입구(삼선교),10820,10628,21448,20201221
20201218,4호선,성신여대입구(돈암),15441,15031,30472,20201221
20201218,4호선,길음,16156,15883,32039,20201221
20201218,4호선,미아사거리,22850,22704,45554,20201221
20201218,4호선,미아(서울사이버대학),12484,12227,24711,20201221
20201218,4호선,수유(강북구청),28892,28639,57531,20201221
20201218,3호선,오금,5054,4485,9539,20201221
20201218,3호선,경찰병원,6266,6345,12611,20201221
20201218,3호선,가락시장,7572,7430,15002,20201221
20201218,3호선,수서,12799,13255,26054,20201221
20201218,3호선,일원,8010,7735,15745,20201221
20201218,3호선,대청,7525,7004,14529,20201221
20201218,3호선,학여울,1376,1397,2773,20201221
20201218,3호선,대치,7967,7894,15861,20201221
20201218,3호선,도곡,4238,4231,8469,20201221
20201218,3호선,매봉,10096,9427,19523,20201221
20201218,3호선,양재(서초구청),32332,33660,65992,20201221
20201218,3호선,남부터미널(예술의전당),23634,24367,48001,20201221
20201218,3호선,교대(법원.검찰청),11339,7531,18870,20201221
20201218,3호선,고속터미널,30784,32645,63429,20201221
20201218,3호선,잠원,3676,3657,7333,20201221
20201218,3호선,신사,24103,24862,48965,20201221
20201218,3호선,압구정,26158,27646,53804,20201221
20201218,3호선,옥수,6926,7300,14226,20201221
20201218,3호선,금호,6554,6211,12765,20201221
20201218,3호선,약수,10527,10333,20860,20201221
20201218,3호선,동대입구,5712,5935,11647,20201221
20201218,3호선,을지로3가,8419,8747,17166,20201221
20201218,3호선,종로3가,7701,8690,16391,20201221
20201218,3호선,안국,14168,14323,28491,20201221
20201218,3호선,경복궁(정부서울청사),14165,13564,27729,20201221
20201218,3호선,독립문,5749,5905,11654,20201221
20201218,3호선,무악재,3161,3190,6351,20201221
20201218,3호선,홍제,14421,13971,28392,20201221
20201218,3호선,녹번,12344,11382,23726,20201221
20201218,3호선,불광,13383,14381,27764,20201221
20201218,3호선,연신내,31053,29184,60237,20201221
20201218,3호선,구파발,16458,15612,32070,20201221
20201218,3호선,지축,2614,2525,5139,20201221
20201218,2호선,용두(동대문구청),2034,2100,4134,20201221
20201218,2호선,신정네거리,8180,8568,16748,20201221
20201218,2호선,양천구청,5481,5914,11395,20201221
20201218,2호선,도림천,1115,1165,2280,20201221
20201218,2호선,신설동,2754,2657,5411,20201221
20201218,2호선,신답,1311,1475,2786,20201221
20201218,2호선,용답,2124,2023,4147,20201221
20201218,2호선,충정로(경기대입구),8078,8413,16491,20201221
20201218,2호선,아현,8201,7908,16109,20201221
20201218,1호선,동대문,9203,8633,17836,20201221
20201218,공항철도 1호선,마곡나루(서울식물원),5479,5134,10613,20201221
20201218,2호선,이대,9404,9656,19060,20201221
20201218,2호선,신촌,23653,24195,47848,20201221
20201218,과천선,선바위,6822,6341,13163,20201221
20201218,공항철도 1호선,김포공항,8677,5513,14190,20201221
20201218,공항철도 1호선,계양,7470,7086,14556,20201221
20201218,공항철도 1호선,검암,5902,5800,11702,20201221
20201218,공항철도 1호선,청라국제도시,4982,4822,9804,20201221
20201218,공항철도 1호선,운서,4890,4922,9812,20201221
20201218,공항철도 1호선,공항화물청사,2150,2259,4409,20201221
20201218,공항철도 1호선,인천공항1터미널,3121,3449,6570,20201221
20201218,공항철도 1호선,인천공항2터미널,1806,1744,3550,20201221
20201218,공항철도 1호선,영종,2162,2299,4461,20201221
20201218,과천선,경마공원,1140,1095,2235,20201221
20201218,과천선,대공원,1387,1445,2832,20201221
20201218,과천선,과천,4081,3818,7899,20201221
20201218,과천선,정부과천청사,7773,7630,15403,20201221
20201218,과천선,인덕원,19408,20270,39678,20201221
20201218,과천선,평촌,14763,14846,29609,20201221
20201218,과천선,범계,20244,20010,40254,20201221
20201218,분당선,선릉,10943,16073,27016,20201221
20201218,분당선,한티,10865,11412,22277,20201221
20201218,분당선,도곡,5143,5194,10337,20201221
20201218,분당선,구룡,1362,1269,2631,20201221
20201218,분당선,개포동,2933,2987,5920,20201221
20201218,분당선,대모산입구,2921,2731,5652,20201221
20201218,분당선,수서,10090,10870,20960,20201221
20201218,분당선,수원,6445,5202,11647,20201221
20201218,분당선,서울숲,6493,6497,12990,20201221
20201218,분당선,압구정로데오,14818,15976,30794,20201221
20201218,분당선,강남구청,7612,8737,16349,20201221
20201218,분당선,선정릉,6506,6739,13245,20201221
20201218,분당선,가천대,6112,6782,12894,20201221
20201218,분당선,태평,11262,11133,22395,20201221
20201218,분당선,모란,16446,16340,32786,20201221
20201218,분당선,야탑,20652,21847,42499,20201221
20201218,분당선,서현,19491,19961,39452,20201221
20201218,분당선,수내,10599,10616,21215,20201221
20201218,분당선,정자,12603,13323,25926,20201221
20201218,분당선,미금,12399,12783,25182,20201221
20201218,분당선,오리,9733,8212,17945,20201221
20201218,분당선,이매,4184,3941,8125,20201221
20201218,분당선,보정,1998,1676,3674,20201221
20201218,분당선,죽전,10768,11590,22358,20201221
20201218,분당선,구성,3904,4039,7943,20201221
20201218,분당선,신갈,3556,3520,7076,20201221
20201218,분당선,기흥,7560,7243,14803,20201221
20201218,분당선,상갈,4355,4200,8555,20201221
20201218,분당선,청명,3549,3260,6809,20201221
20201218,분당선,영통,6538,6492,13030,20201221
20201218,분당선,망포,11755,11141,22896,20201221
20201218,분당선,매탄권선,3865,3704,7569,20201221
20201218,분당선,수원시청,9720,10605,20325,20201221
20201218,분당선,매교,2429,2532,4961,20201221
20201218,수인선,고색,2783,2603,5386,20201221
20201218,수인선,오목천,1782,1675,3457,20201221
20201218,수인선,어천,464,443,907,20201221
20201218,수인선,야목,158,121,279,20201221
20201218,수인선,사리,2773,2567,5340,20201221
20201218,수인선,달월,77,48,125,20201221
20201218,수인선,월곶,1949,1861,3810,20201221
20201218,수인선,소래포구,3566,3510,7076,20201221
20201218,수인선,인천논현,4439,4623,9062,20201221
20201218,수인선,호구포,3273,3387,6660,20201221
20201218,수인선,남동인더스파크,2158,2451,4609,20201221
20201218,수인선,원인재,3629,3705,7334,20201221
20201218,수인선,연수,3502,3454,6956,20201221
20201218,수인선,송도,1998,1842,3840,20201221
20201218,수인선,인하대,4658,4377,9035,20201221
20201218,수인선,숭의,3324,3119,6443,20201221
20201218,수인선,신포,1349,1417,2766,20201221
20201218,수인선,인천,779,1301,2080,20201221
20201218,안산선,산본,12638,13425,26063,20201221
20201218,안산선,대야미,4010,3578,7588,20201221
20201218,안산선,반월,3428,3213,6641,20201221
20201218,안산선,상록수,13329,13506,26835,20201221
20201218,안산선,한대앞,7012,6968,13980,20201221
20201218,안산선,중앙,12548,13129,25677,20201221
20201218,안산선,고잔,6871,6706,13577,20201221
20201218,안산선,초지,3580,3765,7345,20201221
20201218,안산선,안산,10150,9246,19396,20201221
20201218,안산선,신길온천,1301,1216,2517,20201221
20201218,안산선,정왕,7759,7893,15652,20201221
20201218,안산선,오이도,6627,6653,13280,20201221
20201218,안산선,수리산,3464,2773,6237,20201221
20201218,우이신설선,북한산우이,1825,1699,3524,20201221
20201218,우이신설선,솔밭공원,1934,1924,3858,20201221
20201218,우이신설선,4.19민주묘지,2249,2139,4388,20201221
20201218,우이신설선,가오리,3301,3275,6576,20201221
20201218,우이신설선,화계,2710,2570,5280,20201221
20201218,우이신설선,삼양,1635,1821,3456,20201221
20201218,우이신설선,삼양사거리,1998,2015,4013,20201221
20201218,우이신설선,솔샘,4622,4342,8964,20201221
20201218,우이신설선,북한산보국문,4610,4613,9223,20201221
20201218,우이신설선,정릉,3574,3390,6964,20201221
20201218,우이신설선,성신여대입구(돈암),2422,2554,4976,20201221
20201218,우이신설선,보문,1215,1218,2433,20201221
20201218,우이신설선,신설동,1803,1739,3542,20201221
20201218,일산선,원흥,7337,7027,14364,20201221
20201218,일산선,삼송,14255,14364,28619,20201221
20201218,일산선,원당,8875,8590,17465,20201221
20201218,일산선,화정,13348,13882,27230,20201221
20201218,일산선,대곡,1419,1011,2430,20201221
20201218,일산선,백석,8179,8373,16552,20201221
20201218,일산선,마두,5879,6229,12108,20201221
20201218,일산선,정발산,5408,5274,10682,20201221
20201218,일산선,주엽,6713,7032,13745,20201221
20201218,일산선,대화,10319,8310,18629,20201221
20201218,장항선,봉명,1051,1055,2106,20201221
20201218,장항선,쌍용(나사렛대),1674,1504,3178,20201221
20201218,장항선,아산,2386,2462,4848,20201221
20201218,장항선,배방,854,735,1589,20201221
20201218,장항선,온양온천,2828,2905,5733,20201221
20201218,장항선,신창(순천향대),1144,831,1975,20201221
20201218,중앙선,회기,18666,17878,36544,20201221
20201218,중앙선,중랑,4482,4347,8829,20201221
20201218,중앙선,상봉(시외버스터미널),4828,4709,9537,20201221
20201218,중앙선,망우,6225,6159,12384,20201221
20201218,중앙선,양원,1343,1342,2685,20201221
20201218,중앙선,구리,10745,11086,21831,20201221
20201218,중앙선,도농,7949,7288,15237,20201221
20201218,중앙선,양정,647,537,1184,20201221
20201218,중앙선,덕소,4533,4560,9093,20201221
20201218,중앙선,도심,1855,1500,3355,20201221
20201218,중앙선,팔당,625,622,1247,20201221
20201218,중앙선,운길산,412,394,806,20201221
20201218,중앙선,양수,1223,1279,2502,20201221
20201218,중앙선,신원,117,135,252,20201221
20201218,중앙선,국수,515,494,1009,20201221
20201218,중앙선,아신,385,408,793,20201221
20201218,중앙선,오빈,201,187,388,20201221
20201218,중앙선,양평,1949,2053,4002,20201221
20201218,중앙선,원덕,206,212,418,20201221
20201218,중앙선,용문,1161,1279,2440,20201221
20201218,중앙선,지평,18,38,56,20201221
20201218,2호선,홍대입구,34007,36005,70012,20201221
20201218,1호선,종로5가,17886,17617,35503,20201221
20201218,1호선,종로3가,17974,16494,34468,20201221
20201218,1호선,종각,25921,25076,50997,20201221
20201218,1호선,시청,16959,16441,33400,20201221
20201218,1호선,동묘앞,6443,6661,13104,20201221
20201218,1호선,서울역,32989,31277,64266,20201221
20201218,일산선,지축,1,0,1,20201221
20201218,4호선,회현(남대문시장),18418,19257,37675,20201221
20201218,4호선,명동,13726,14003,27729,20201221
20201218,2호선,합정,22496,23640,46136,20201221
20201218,2호선,당산,14808,17288,32096,20201221
20201218,2호선,영등포구청,19978,20264,40242,20201221
20201218,2호선,문래,17514,17671,35185,20201221
20201218,2호선,신도림,40015,38928,78943,20201221
20201218,2호선,대림(구로구청),20386,20801,41187,20201221
20201218,2호선,구로디지털단지,49801,50470,100271,20201221
20201218,2호선,신대방,21856,21319,43175,20201221
20201218,2호선,신림,52521,50677,103198,20201221
20201218,2호선,봉천,19958,18618,38576,20201221
20201218,2호선,서울대입구(관악구청),38204,36701,74905,20201221
20201218,2호선,낙성대(강감찬),22486,21071,43557,20201221
20201218,2호선,사당,28044,30288,58332,20201221
20201218,2호선,방배,13227,13832,27059,20201221
20201218,2호선,서초,17304,17150,34454,20201221
20201218,2호선,교대(법원.검찰청),27440,30438,57878,20201221
20201218,2호선,강남,61698,60395,122093,20201221
20201218,2호선,역삼,40662,43495,84157,20201221
20201218,2호선,선릉,45337,40193,85530,20201221
20201218,2호선,삼성(무역센터),39233,39342,78575,20201221
20201218,2호선,종합운동장,5310,5832,11142,20201221
20201218,2호선,잠실새내,16044,15995,32039,20201221
20201218,2호선,잠실(송파구청),49974,49739,99713,20201221
20201218,2호선,잠실나루,11409,11004,22413,20201221
20201218,2호선,강변(동서울터미널),23718,24059,47777,20201221
20201218,2호선,구의(광진구청),19499,19431,38930,20201221
20201218,2호선,건대입구,24959,27042,52001,20201221
20201218,2호선,성수,27361,30175,57536,20201221
20201218,2호선,뚝섬,16059,17383,33442,20201221
20201218,2호선,한양대,5541,5712,11253,20201221
20201218,2호선,왕십리(성동구청),12335,9856,22191,20201221
20201218,2호선,상왕십리,11291,10943,22234,20201221
20201218,2호선,신당,11351,11908,23259,20201221
20201218,2호선,동대문역사문화공원(DDP),8747,9836,18583,20201221
20201218,2호선,을지로4가,11247,11094,22341,20201221
20201218,2호선,을지로3가,16318,16310,32628,20201221
20201218,2호선,을지로입구,30783,30856,61639,20201221
20201218,2호선,시청,18221,17947,36168,20201221
20201218,1호선,청량리(서울시립대입구),17637,17807,35444,20201221
20201218,1호선,제기동,14450,14726,29176,20201221
20201218,1호선,신설동,11620,11450,23070,20201221
20201218,공항철도 1호선,디지털미디어시티,10635,9546,20181,20201221
20201218,공항철도 1호선,홍대입구,5630,5939,11569,20201221
20201218,공항철도 1호선,공덕,1662,2237,3899,20201221
20201218,공항철도 1호선,서울역,5400,4948,10348,20201221
20201218,경춘선,춘천,1061,904,1965,20201221
20201218,경춘선,남춘천,2167,1960,4127,20201221
20201218,경춘선,김유정,162,188,350,20201221
20201218,경춘선,강촌,251,279,530,20201221
20201218,경춘선,백양리,117,161,278,20201221
20201218,경춘선,굴봉산,62,72,134,20201221
20201218,경춘선,가평,1059,1131,2190,20201221
20201218,경춘선,상천,179,153,332,20201221
20201218,경춘선,청평,1043,1154,2197,20201221
20201218,경춘선,대성리,352,339,691,20201221
20201218,경춘선,마석,3070,3051,6121,20201221
20201218,경춘선,천마산,1287,1226,2513,20201221
20201219,일산선,대화,5389,4967,10356,20201222
20201219,2호선,신당,7299,7358,14657,20201222
20201219,안산선,대야미,2415,2121,4536,20201222
20201219,안산선,반월,2133,1970,4103,20201222
20201219,안산선,상록수,8112,8277,16389,20201222
20201219,안산선,한대앞,4252,4314,8566,20201222
20201219,안산선,중앙,8281,8538,16819,20201222
20201219,안산선,고잔,3634,3644,7278,20201222
20201219,안산선,초지,1896,2036,3932,20201222
20201219,안산선,안산,6869,7048,13917,20201222
20201219,안산선,신길온천,842,797,1639,20201222
20201219,안산선,정왕,4393,4362,8755,20201222
20201219,안산선,오이도,4235,4382,8617,20201222
20201219,안산선,수리산,1785,1613,3398,20201222
20201219,우이신설선,북한산우이,1756,1690,3446,20201222
20201219,우이신설선,솔밭공원,1174,1144,2318,20201222
20201219,우이신설선,4.19민주묘지,1413,1269,2682,20201222
20201219,우이신설선,가오리,1851,1923,3774,20201222
20201219,우이신설선,화계,1686,1540,3226,20201222
20201219,우이신설선,삼양,1027,1139,2166,20201222
20201219,우이신설선,삼양사거리,1235,1268,2503,20201222
20201219,우이신설선,솔샘,2349,2149,4498,20201222
20201219,우이신설선,북한산보국문,3066,2893,5959,20201222
20201219,우이신설선,정릉,2376,2081,4457,20201222
20201219,우이신설선,성신여대입구(돈암),1635,1848,3483,20201222
20201219,우이신설선,보문,763,808,1571,20201222
20201219,1호선,서울역,15779,15689,31468,20201222
20201219,1호선,동묘앞,7397,7416,14813,20201222
20201219,1호선,시청,5683,5258,10941,20201222
20201219,1호선,종각,9135,8705,17840,20201222
20201219,1호선,종로3가,10810,10122,20932,20201222
20201219,1호선,종로5가,10163,10141,20304,20201222
20201219,1호선,동대문,7184,6222,13406,20201222
20201219,1호선,신설동,6441,6026,12467,20201222
20201219,1호선,제기동,9915,10152,20067,20201222
20201219,1호선,청량리(서울시립대입구),12201,12214,24415,20201222
20201219,2호선,시청,4475,3985,8460,20201222
20201219,2호선,을지로입구,12953,12824,25777,20201222
20201219,2호선,을지로3가,5286,5039,10325,20201222
20201219,2호선,을지로4가,5138,5030,10168,20201222
20201219,2호선,동대문역사문화공원(DDP),5707,5841,11548,20201222
20201219,2호선,상왕십리,6048,5823,11871,20201222
20201219,2호선,왕십리(성동구청),7803,6456,14259,20201222
20201219,2호선,한양대,2592,2459,5051,20201222
20201219,2호선,뚝섬,6332,6503,12835,20201222
20201219,2호선,성수,8761,9662,18423,20201222
20201219,2호선,건대입구,17626,19031,36657,20201222
20201219,2호선,구의(광진구청),11108,10929,22037,20201222
20201219,2호선,강변(동서울터미널),14191,14772,28963,20201222
20201219,2호선,잠실나루,4439,4235,8674,20201222
20201219,2호선,잠실(송파구청),32677,31021,63698,20201222
20201219,2호선,잠실새내,9851,10154,20005,20201222
20201219,2호선,종합운동장,2478,2778,5256,20201222
20201219,2호선,삼성(무역센터),16999,16913,33912,20201222
20201219,2호선,선릉,16021,14032,30053,20201222
20201219,2호선,역삼,12642,13276,25918,20201222
20201219,2호선,강남,32212,31899,64111,20201222
20201219,2호선,교대(법원.검찰청),10335,11319,21654,20201222
20201219,2호선,서초,6491,6016,12507,20201222
20201219,2호선,방배,6214,6301,12515,20201222
20201219,2호선,사당,16998,18160,35158,20201222
20201219,2호선,낙성대(강감찬),13804,12928,26732,20201222
20201219,2호선,서울대입구(관악구청),23557,22697,46254,20201222
20201219,2호선,봉천,11849,11137,22986,20201222
20201219,2호선,신림,33780,32386,66166,20201222
20201219,2호선,신대방,13510,13456,26966,20201222
20201219,2호선,구로디지털단지,23067,23199,46266,20201222
20201219,2호선,대림(구로구청),12451,13401,25852,20201222
20201219,2호선,신도림,24710,24607,49317,20201222
20201219,2호선,문래,6859,7102,13961,20201222
20201219,2호선,영등포구청,8283,8445,16728,20201222
20201219,2호선,당산,7356,8235,15591,20201222
20201219,2호선,합정,13787,14498,28285,20201222
20201219,2호선,홍대입구,26006,26755,52761,20201222
20201219,2호선,신촌,17167,16990,34157,20201222
20201219,2호선,이대,5968,6135,12103,20201222
20201219,2호선,아현,4737,4663,9400,20201222
20201219,2호선,충정로(경기대입구),3476,3502,6978,20201222
20201219,2호선,용답,1522,1502,3024,20201222
20201219,2호선,신답,630,632,1262,20201222
20201219,2호선,신설동,2094,2126,4220,20201222
20201219,2호선,도림천,599,624,1223,20201222
20201219,2호선,양천구청,2614,2792,5406,20201222
20201219,2호선,신정네거리,4460,4675,9135,20201222
20201219,2호선,용두(동대문구청),1160,1265,2425,20201222
20201219,3호선,지축,1549,1506,3055,20201222
20201219,3호선,구파발,9192,9173,18365,20201222
20201219,3호선,연신내,19489,18504,37993,20201222
20201219,3호선,불광,8704,9594,18298,20201222
20201219,3호선,녹번,6436,5796,12232,20201222
20201219,3호선,홍제,8444,8158,16602,20201222
20201219,3호선,무악재,1708,1710,3418,20201222
20201219,3호선,독립문,3302,3355,6657,20201222
20201219,3호선,경복궁(정부서울청사),6279,6175,12454,20201222
20201219,3호선,안국,5368,5797,11165,20201222
20201219,3호선,종로3가,2673,3510,6183,20201222
20201219,3호선,을지로3가,2808,3098,5906,20201222
20201219,3호선,충무로,1,0,1,20201222
20201219,3호선,동대입구,4096,4250,8346,20201222
20201219,3호선,약수,5942,5611,11553,20201222
20201219,3호선,금호,3900,3716,7616,20201222
20201219,3호선,옥수,4177,4273,8450,20201222
20201219,3호선,압구정,16349,16786,33135,20201222
20201219,3호선,신사,13934,14477,28411,20201222
20201219,3호선,잠원,1989,1883,3872,20201222
20201219,3호선,고속터미널,25550,26467,52017,20201222
20201219,3호선,교대(법원.검찰청),3664,2279,5943,20201222
20201219,3호선,남부터미널(예술의전당),11336,11547,22883,20201222
20201219,3호선,양재(서초구청),12178,13137,25315,20201222
20201219,3호선,매봉,3798,3641,7439,20201222
20201219,3호선,도곡,2180,2076,4256,20201222
20201219,3호선,대치,4554,4365,8919,20201222
20201219,3호선,학여울,613,578,1191,20201222
20201219,3호선,대청,3937,3641,7578,20201222
20201219,3호선,일원,2944,2950,5894,20201222
20201219,3호선,수서,6897,7025,13922,20201222
20201219,3호선,가락시장,4231,3972,8203,20201222
20201219,3호선,경찰병원,2667,2631,5298,20201222
20201219,3호선,오금,2283,2117,4400,20201222
20201219,4호선,수유(강북구청),17684,17547,35231,20201222
20201219,4호선,미아(서울사이버대학),7724,7494,15218,20201222
20201219,4호선,미아사거리,14853,14575,29428,20201222
20201219,4호선,길음,10784,10151,20935,20201222
20201219,4호선,성신여대입구(돈암),10019,9631,19650,20201222
20201219,4호선,한성대입구(삼선교),6314,6113,12427,20201222
20201219,4호선,혜화,11392,11313,22705,20201222
20201219,4호선,동대문,8642,8531,17173,20201222
20201219,4호선,동대문역사문화공원(DDP),6595,5623,12218,20201222
20201219,4호선,충무로,8009,8117,16126,20201222
20201219,4호선,명동,7560,8368,15928,20201222
20201219,4호선,회현(남대문시장),10032,10466,20498,20201222
20201219,4호선,서울역,3303,5699,9002,20201222
20201219,4호선,숙대입구(갈월),5322,5016,10338,20201222
20201219,4호선,삼각지,1667,2057,3724,20201222
20201219,4호선,신용산,5239,5633,10872,20201222
20201219,4호선,이촌(국립중앙박물관),2733,3026,5759,20201222
20201219,4호선,동작(현충원),1126,1156,2282,20201222
20201219,4호선,총신대입구(이수),8850,9598,18448,20201222
20201219,4호선,사당,11213,9704,20917,20201222
20201219,4호선,남태령,498,433,931,20201222
20201219,4호선,당고개,6299,6117,12416,20201222
20201219,4호선,상계,9075,8753,17828,20201222
20201219,4호선,노원,9662,10488,20150,20201222
20201219,4호선,창동,12742,13652,26394,20201222
20201219,4호선,쌍문,14514,13569,28083,20201222
20201219,5호선,방화,2979,2922,5901,20201222
20201219,5호선,개화산,2427,2443,4870,20201222
20201219,5호선,김포공항,4480,4622,9102,20201222
20201219,5호선,송정,3473,3471,6944,20201222
20201219,5호선,마곡,3023,3061,6084,20201222
20201219,5호선,발산,7456,7705,15161,20201222
20201219,5호선,우장산,5833,6008,11841,20201222
20201219,5호선,화곡,13178,12517,25695,20201222
20201219,5호선,까치산,14370,13932,28302,20201222
20201219,5호선,신정(은행정),5980,5250,11230,20201222
20201219,5호선,목동,6927,7238,14165,20201222
20201219,5호선,오목교(목동운동장앞),10198,10566,20764,20201222
20201219,5호선,양평,2454,2459,4913,20201222
20201219,5호선,영등포구청,1246,1233,2479,20201222
20201219,5호선,영등포시장,4560,4684,9244,20201222
20201219,5호선,신길,1635,1762,3397,20201222
20201219,5호선,여의도,5156,5416,10572,20201222
20201219,5호선,여의나루,2412,2208,4620,20201222
20201219,5호선,마포,4523,4528,9051,20201222
20201219,5호선,공덕,4230,4510,8740,20201222
20201219,5호선,애오개,2405,2295,4700,20201222
20201219,5호선,충정로(경기대입구),1232,1157,2389,20201222
20201219,5호선,서대문,4551,4483,9034,20201222
20201219,5호선,광화문(세종문화회관),7783,7695,15478,20201222
20201219,5호선,종로3가,4427,4571,8998,20201222
20201219,5호선,을지로4가,2197,2382,4579,20201222
20201219,5호선,동대문역사문화공원(DDP),763,927,1690,20201222
20201219,5호선,청구,1687,1559,3246,20201222
20201219,5호선,신금호,2661,2793,5454,20201222
20201219,5호선,행당,3467,3069,6536,20201222
20201219,5호선,왕십리(성동구청),2296,2543,4839,20201222
20201219,5호선,마장,2596,2526,5122,20201222
20201219,5호선,답십리,7013,6526,13539,20201222
20201219,5호선,장한평,7333,7349,14682,20201222
20201219,5호선,군자(능동),5504,5844,11348,20201222
20201219,5호선,아차산(어린이대공원후문),7610,7645,15255,20201222
20201219,5호선,광나루(장신대),6060,5762,11822,20201222
20201219,5호선,천호(풍납토성),11000,10521,21521,20201222
20201219,5호선,강동,9146,8415,17561,20201222
20201219,5호선,길동,3988,4074,8062,20201222
20201219,5호선,굽은다리(강동구민회관앞),4522,4430,8952,20201222
20201219,5호선,명일,3516,3717,7233,20201222
20201219,5호선,고덕,3443,3427,6870,20201222
20201219,5호선,상일동,6106,5766,11872,20201222
20201219,5호선,둔촌동,3971,3934,7905,20201222
20201219,5호선,올림픽공원(한국체대),1695,1491,3186,20201222
20201219,5호선,방이,2975,2954,5929,20201222
20201219,5호선,오금,1371,1316,2687,20201222
20201219,5호선,개롱,2913,2996,5909,20201222
20201219,5호선,거여,3590,3493,7083,20201222
20201219,5호선,마천,3072,3115,6187,20201222
20201219,5호선,미사,5948,5961,11909,20201222
20201219,5호선,하남풍산,2155,2322,4477,20201222
20201219,6호선,응암,8391,8554,16945,20201222
20201219,6호선,역촌,1803,2029,3832,20201222
20201219,6호선,불광,2724,2511,5235,20201222
20201219,6호선,독바위,1366,1550,2916,20201222
20201219,6호선,구산,3344,2697,6041,20201222
20201219,6호선,새절(신사),5999,5747,11746,20201222
20201219,6호선,증산(명지대앞),5144,5076,10220,20201222
20201219,6호선,디지털미디어시티,4721,4934,9655,20201222
20201219,6호선,월드컵경기장(성산),2548,2674,5222,20201222
20201219,6호선,마포구청,6181,5483,11664,20201222
20201219,6호선,망원,7145,7904,15049,20201222
20201219,6호선,합정,6304,5935,12239,20201222
20201219,6호선,상수,3814,4289,8103,20201222
20201219,6호선,광흥창(서강),3148,3037,6185,20201222
20201219,6호선,대흥(서강대앞),3164,3207,6371,20201222
20201219,6호선,공덕,6227,5975,12202,20201222
20201219,6호선,효창공원앞,2989,2716,5705,20201222
20201219,6호선,삼각지,2473,1929,4402,20201222
20201219,6호선,녹사평(용산구청),2343,2380,4723,20201222
20201219,6호선,이태원,5112,5350,10462,20201222
20201219,6호선,한강진,3174,3619,6793,20201222
20201219,6호선,버티고개,1023,1045,2068,20201222
20201219,6호선,약수,1635,1674,3309,20201222
20201219,6호선,청구,1583,1664,3247,20201222
20201219,6호선,신당,3801,3009,6810,20201222
20201219,6호선,동묘앞,5348,4770,10118,20201222
20201219,6호선,창신,1459,1262,2721,20201222
20201219,6호선,보문,3349,3004,6353,20201222
20201219,6호선,안암(고대병원앞),3853,3549,7402,20201222
20201219,6호선,고려대(종암),3522,3372,6894,20201222
20201219,6호선,월곡(동덕여대),4938,5004,9942,20201222
20201219,6호선,상월곡(한국과학기술연구원),2813,2506,5319,20201222
20201219,6호선,돌곶이,3915,3685,7600,20201222
20201219,6호선,석계,6049,6024,12073,20201222
20201219,6호선,태릉입구,2576,2748,5324,20201222
20201219,6호선,화랑대(서울여대입구),4350,3633,7983,20201222
20201219,6호선,봉화산(서울의료원),3403,3421,6824,20201222
20201219,7호선,장암,889,545,1434,20201222
20201219,7호선,도봉산,3980,5727,9707,20201222
20201219,7호선,수락산,6443,6361,12804,20201222
20201219,7호선,마들,5798,5700,11498,20201222
20201219,7호선,노원,10001,10191,20192,20201222
20201219,7호선,중계,6103,5405,11508,20201222
20201219,7호선,하계,7727,7426,15153,20201222
20201219,7호선,공릉(서울과학기술대),5611,5548,11159,20201222
20201219,7호선,태릉입구,4308,3906,8214,20201222
20201219,7호선,먹골,5537,5369,10906,20201222
20201219,7호선,중화,5536,5473,11009,20201222
20201219,7호선,상봉(시외버스터미널),9273,8972,18245,20201222
20201219,7호선,면목,8113,8074,16187,20201222
20201219,7호선,사가정,8745,8670,17415,20201222
20201219,7호선,용마산(용마폭포공원),3041,3051,6092,20201222
20201219,7호선,중곡,4669,4629,9298,20201222
20201219,7호선,군자(능동),7201,5610,12811,20201222
20201219,7호선,어린이대공원(세종대),5832,5473,11305,20201222
20201219,7호선,건대입구,7397,6978,14375,20201222
20201219,7호선,뚝섬유원지,3612,3727,7339,20201222
20201219,7호선,청담,7512,7843,15355,20201222
20201219,7호선,강남구청,6476,7041,13517,20201222
20201219,7호선,학동,7260,7558,14818,20201222
20201219,7호선,논현,7712,8242,15954,20201222
20201219,7호선,반포,2984,2647,5631,20201222
20201219,7호선,고속터미널,7478,6257,13735,20201222
20201219,7호선,내방,5398,5204,10602,20201222
20201219,7호선,이수,7436,7008,14444,20201222
20201219,7호선,남성,5384,5096,10480,20201222
20201219,7호선,숭실대입구(살피재),5214,5209,10423,20201222
20201219,7호선,상도,5005,4742,9747,20201222
20201219,7호선,장승배기,4777,4700,9477,20201222
20201219,7호선,신대방삼거리,7821,7393,15214,20201222
20201219,7호선,보라매,3934,3783,7717,20201222
20201219,7호선,신풍,5525,5422,10947,20201222
20201219,7호선,대림(구로구청),4781,5113,9894,20201222
20201219,7호선,남구로,6351,6886,13237,20201222
20201219,7호선,가산디지털단지,10682,9863,20545,20201222
20201219,7호선,철산,9452,9712,19164,20201222
20201219,7호선,광명사거리,11781,12028,23809,20201222
20201219,7호선,천왕,4312,4169,8481,20201222
20201219,7호선,온수(성공회대입구),4124,4039,8163,20201222
20201219,7호선,까치울,3330,3331,6661,20201222
20201219,7호선,부천종합운동장,2084,1901,3985,20201222
20201219,7호선,춘의,3883,3826,7709,20201222
20201219,7호선,신중동,6280,6159,12439,20201222
20201219,7호선,부천시청,5992,5951,11943,20201222
20201219,7호선,상동,5943,6042,11985,20201222
20201219,7호선,삼산체육관,1867,1819,3686,20201222
20201219,7호선,굴포천,4124,4385,8509,20201222
20201219,7호선,부평구청,4579,4152,8731,20201222
20201219,8호선,암사,8561,8008,16569,20201222
20201219,8호선,천호(풍납토성),8723,9922,18645,20201222
20201219,8호선,강동구청,4133,4319,8452,20201222
20201219,8호선,몽촌토성(평화의문),2849,2820,5669,20201222
20201219,8호선,잠실(송파구청),7785,8309,16094,20201222
20201219,8호선,석촌,3783,4398,8181,20201222
20201219,8호선,송파,3574,3667,7241,20201222
20201219,8호선,가락시장,4313,4302,8615,20201222
20201219,8호선,문정,5516,5610,11126,20201222
20201219,8호선,장지,8398,8325,16723,20201222
20201219,8호선,복정,4339,3805,8144,20201222
20201219,8호선,산성,3446,3464,6910,20201222
20201219,8호선,남한산성입구(성남법원.검찰청),6304,5717,12021,20201222
20201219,8호선,단대오거리,5205,5016,10221,20201222
20201219,8호선,신흥,2724,2937,5661,20201222
20201219,8호선,수진,2868,2670,5538,20201222
20201219,8호선,모란,3018,2409,5427,20201222
20201219,9호선,개화,890,752,1642,20201222
20201219,9호선,김포공항,4539,6497,11036,20201222
20201219,9호선,공항시장,1532,1637,3169,20201222
20201219,9호선,신방화,3144,3146,6290,20201222
20201219,9호선,마곡나루(서울식물원),4279,4244,8523,20201222
20201219,9호선,양천향교,3664,3623,7287,20201222
20201219,9호선,가양,8985,8671,17656,20201222
20201219,9호선,증미,2954,2948,5902,20201222
20201219,9호선,등촌,4977,4862,9839,20201222
20201219,9호선,염창,7243,6957,14200,20201222
20201219,9호선,신목동,1303,1141,2444,20201222
20201219,9호선,선유도,2211,2310,4521,20201222
20201219,9호선,당산,7660,7060,14720,20201222
20201219,9호선,국회의사당,2679,2773,5452,20201222
20201219,9호선,여의도,4730,4493,9223,20201222
20201219,9호선,샛강,1575,1482,3057,20201222
20201219,9호선,노량진,11904,11679,23583,20201222
20201219,9호선,노들,2019,1691,3710,20201222
20201219,9호선,흑석(중앙대입구),3518,3570,7088,20201222
20201219,9호선,동작(현충원),739,574,1313,20201222
20201219,9호선,구반포,1221,1260,2481,20201222
20201219,9호선,신반포,1333,1334,2667,20201222
20201219,9호선,고속터미널,6117,8426,14543,20201222
20201219,9호선,사평,1191,1134,2325,20201222
20201219,9호선,신논현,14272,13974,28246,20201222
20201219,9호선2~3단계,언주,3958,3852,7810,20201222
20201219,9호선2~3단계,선정릉,3052,3355,6407,20201222
20201219,9호선2~3단계,삼성중앙,2077,1988,4065,20201222
20201219,9호선2~3단계,봉은사,5838,5915,11753,20201222
20201219,9호선2~3단계,종합운동장,1696,1626,3322,20201222
20201219,9호선2~3단계,삼전,3193,3010,6203,20201222
20201219,9호선2~3단계,석촌고분,2737,2657,5394,20201222
20201219,9호선2~3단계,석촌,3634,3027,6661,20201222
20201219,9호선2~3단계,송파나루,2216,2297,4513,20201222
20201219,9호선2~3단계,한성백제,1117,953,2070,20201222
20201219,9호선2~3단계,올림픽공원(한국체대),2157,2092,4249,20201222
20201219,9호선2~3단계,둔촌오륜,437,393,830,20201222
20201219,9호선2~3단계,중앙보훈병원,2579,2424,5003,20201222
20201219,경강선,판교,1799,1715,3514,20201222
20201219,경강선,이매,473,289,762,20201222
20201219,경강선,삼동,895,882,1777,20201222
20201219,경강선,경기광주,3004,2942,5946,20201222
20201219,경강선,초월,1292,1239,2531,20201222
20201219,경강선,곤지암,1091,1012,2103,20201222
20201219,경강선,신둔도예촌,540,541,1081,20201222
20201219,경강선,이천,1377,1498,2875,20201222
20201219,경강선,부발,1156,871,2027,20201222
20201219,경강선,세종대왕릉,110,134,244,20201222
20201219,경강선,여주,1006,1073,2079,20201222
20201219,경부선,서울역,2158,725,2883,20201222
20201219,경부선,남영,3962,3785,7747,20201222
20201219,경부선,용산,16161,16947,33108,20201222
20201219,경부선,노량진,4882,4732,9614,20201222
20201219,경부선,대방,4897,4995,9892,20201222
20201219,경부선,영등포,23270,24390,47660,20201222
20201219,경부선,신도림,1771,1794,3565,20201222
20201219,경부선,신길,4208,3435,7643,20201222
20201219,경부선,구로,8872,9139,18011,20201222
20201219,경부선,가산디지털단지,4000,5463,9463,20201222
20201219,경부선,금천구청,5216,5298,10514,20201222
20201219,경부선,석수,4341,4148,8489,20201222
20201219,경부선,관악,3533,3412,6945,20201222
20201219,경부선,안양,10899,10988,21887,20201222
20201219,경부선,명학,3642,3447,7089,20201222
20201219,경부선,금정,11829,12140,23969,20201222
20201219,경부선,군포,3181,3054,6235,20201222
20201219,경부선,의왕,3723,3692,7415,20201222
20201219,경부선,성균관대,6152,5964,12116,20201222
20201219,경부선,화서,3039,3041,6080,20201222
20201219,경부선,수원,20235,21990,42225,20201222
20201219,경부선,독산,5730,5879,11609,20201222
20201219,경부선,세류,1530,1593,3123,20201222
20201219,경부선,병점,6753,6803,13556,20201222
20201219,경부선,세마,1193,1060,2253,20201222
20201219,경부선,오산대,1488,1399,2887,20201222
20201219,경부선,오산,5722,5436,11158,20201222
20201219,경부선,진위,645,579,1224,20201222
20201219,경부선,송탄,2844,2545,5389,20201222
20201219,경부선,서정리,4125,3164,7289,20201222
20201219,경부선,지제,1739,1527,3266,20201222
20201219,경부선,평택,7774,7369,15143,20201222
20201219,경부선,성환,1952,1818,3770,20201222
20201219,경부선,직산,402,405,807,20201222
20201219,경부선,두정,3181,3106,6287,20201222
20201219,경부선,천안,3537,3635,7172,20201222
20201219,경부선,당정,2482,2346,4828,20201222
20201219,경부선,서동탄,544,550,1094,20201222
20201219,경부선,광명,1364,1228,2592,20201222
20201219,경원선,이촌(국립중앙박물관),1717,1367,3084,20201222
20201219,경원선,서빙고,814,684,1498,20201222
20201219,경원선,한남,1871,1669,3540,20201222
20201219,경원선,옥수,21,18,39,20201222
20201219,경원선,응봉,766,672,1438,20201222
20201219,경원선,왕십리(성동구청),7168,8404,15572,20201222
20201219,경원선,청량리(서울시립대입구),8217,9049,17266,20201222
20201219,경원선,외대앞,4110,3955,8065,20201222
20201219,경원선,신이문,4249,3894,8143,20201222
20201219,경원선,석계,4410,4700,9110,20201222
20201219,경원선,광운대,3944,3871,7815,20201222
20201219,경원선,월계,3200,3045,6245,20201222
20201219,경원선,녹천,2360,2002,4362,20201222
20201219,경원선,방학,5033,4973,10006,20201222
20201219,경원선,도봉,2940,2930,5870,20201222
20201219,경원선,도봉산,5515,3532,9047,20201222
20201219,경원선,망월사,3509,3682,7191,20201222
20201219,경원선,회룡,5888,5989,11877,20201222
20201219,경원선,의정부,10698,11094,21792,20201222
20201219,경원선,가능,3414,3350,6764,20201222
20201219,경원선,녹양,2231,2241,4472,20201222
20201219,경원선,양주,3556,3555,7111,20201222
20201219,경원선,덕계,1289,1251,2540,20201222
20201219,경원선,덕정,2689,2631,5320,20201222
20201219,경원선,지행,3220,3169,6389,20201222
20201219,경원선,동두천중앙,1568,1597,3165,20201222
20201219,경원선,보산,886,935,1821,20201222
20201219,경원선,동두천,882,1133,2015,20201222
20201219,경원선,소요산,1867,1685,3552,20201222
20201219,경의선,서울역,622,696,1318,20201222
20201219,경의선,신촌,246,215,461,20201222
20201219,경의선,효창공원앞,1064,1165,2229,20201222
20201219,경의선,공덕,1543,1209,2752,20201222
20201219,경의선,서강대,1005,913,1918,20201222
20201219,경의선,홍대입구,857,900,1757,20201222
20201219,경의선,가좌,2212,2205,4417,20201222
20201219,경의선,디지털미디어시티,1116,1049,2165,20201222
20201219,경의선,수색,788,836,1624,20201222
20201219,경의선,화전,546,544,1090,20201222
20201219,경의선,강매,1175,1072,2247,20201222
20201219,경의선,행신,2844,2949,5793,20201222
20201219,경의선,능곡,1635,1641,3276,20201222
20201219,경의선,곡산,189,197,386,20201222
20201219,경의선,백마,2288,2243,4531,20201222
20201219,경의선,풍산,2292,2367,4659,20201222
20201219,경의선,일산,3434,3470,6904,20201222
20201219,경의선,탄현,3054,3037,6091,20201222
20201219,경의선,야당,2609,2634,5243,20201222
20201219,경의선,운정,2537,2534,5071,20201222
20201219,경의선,금릉,1980,2067,4047,20201222
20201219,경의선,금촌,3281,3209,6490,20201222
20201219,경의선,월롱,749,771,1520,20201222
20201219,경의선,파주,508,402,910,20201222
20201219,경의선,문산,2596,2550,5146,20201222
20201219,경의선,임진강,11,17,28,20201222
20201219,경인선,개봉,10799,10880,21679,20201222
20201219,경인선,오류동,6472,6107,12579,20201222
20201219,경인선,역곡,13416,13480,26896,20201222
20201219,경인선,부천,18691,19458,38149,20201222
20201219,경인선,송내,11418,11534,22952,20201222
20201219,경인선,부평,17743,19070,36813,20201222
20201219,경인선,백운,3562,3556,7118,20201222
20201219,경인선,동암,8494,8848,17342,20201222
20201219,경인선,주안,10697,9745,20442,20201222
20201219,경인선,제물포,4710,4577,9287,20201222
20201219,경인선,동인천,7250,7229,14479,20201222
20201219,경인선,인천,1887,1480,3367,20201222
20201219,경인선,구일,2706,2590,5296,20201222
20201219,경인선,소사,4996,5060,10056,20201222
20201219,경인선,부개,4222,4055,8277,20201222
20201219,경인선,간석,2741,2670,5411,20201222
20201219,경인선,도원,1435,1465,2900,20201222
20201219,경인선,온수(성공회대입구),2978,2878,5856,20201222
20201219,경인선,중동,4315,4179,8494,20201222
20201219,경인선,도화,1969,1840,3809,20201222
20201219,경춘선,신내,623,656,1279,20201222
20201219,경춘선,갈매,1132,1076,2208,20201222
20201219,경춘선,별내,1288,1278,2566,20201222
20201219,경춘선,퇴계원,1651,1540,3191,20201222
20201219,경춘선,사릉,1380,1452,2832,20201222
20201219,경춘선,금곡,682,654,1336,20201222
20201219,경춘선,평내호평,2630,2647,5277,20201222
20201219,경춘선,천마산,846,819,1665,20201222
20201219,경춘선,마석,1763,1883,3646,20201222
20201219,경춘선,대성리,245,262,507,20201222
20201219,경춘선,청평,684,796,1480,20201222
20201219,경춘선,상천,171,147,318,20201222
20201219,경춘선,가평,714,839,1553,20201222
20201219,경춘선,굴봉산,81,89,170,20201222
20201219,경춘선,백양리,117,130,247,20201222
20201219,경춘선,강촌,259,262,521,20201222
20201219,경춘선,김유정,148,165,313,20201222
20201219,경춘선,남춘천,1356,1302,2658,20201222
20201219,경춘선,춘천,621,566,1187,20201222
20201219,공항철도 1호선,서울역,3499,3315,6814,20201222
20201219,공항철도 1호선,공덕,903,1323,2226,20201222
20201219,공항철도 1호선,홍대입구,4680,4574,9254,20201222
20201219,공항철도 1호선,디지털미디어시티,3220,2996,6216,20201222
20201219,공항철도 1호선,마곡나루(서울식물원),1526,1537,3063,20201222
20201219,공항철도 1호선,김포공항,5980,3696,9676,20201222
20201219,공항철도 1호선,계양,3888,3701,7589,20201222
20201219,공항철도 1호선,검암,2891,2944,5835,20201222
20201219,공항철도 1호선,청라국제도시,2208,2145,4353,20201222
20201219,공항철도 1호선,운서,3675,3748,7423,20201222
20201219,공항철도 1호선,공항화물청사,1135,1186,2321,20201222
20201219,공항철도 1호선,인천공항1터미널,2454,2706,5160,20201222
20201219,공항철도 1호선,인천공항2터미널,1499,1519,3018,20201222
20201219,공항철도 1호선,영종,1410,1443,2853,20201222
20201219,과천선,선바위,2933,2790,5723,20201222
20201219,과천선,경마공원,737,710,1447,20201222
20201219,과천선,대공원,1332,1439,2771,20201222
20201219,과천선,과천,2410,2208,4618,20201222
20201219,과천선,정부과천청사,3482,3505,6987,20201222
20201219,과천선,인덕원,9241,9204,18445,20201222
20201219,과천선,평촌,5788,5942,11730,20201222
20201219,과천선,범계,11750,11547,23297,20201222
20201219,분당선,선릉,3416,5092,8508,20201222
20201219,분당선,한티,6355,6405,12760,20201222
20201219,분당선,도곡,2697,2597,5294,20201222
20201219,분당선,구룡,797,757,1554,20201222
20201219,분당선,개포동,1589,1580,3169,20201222
20201219,분당선,대모산입구,1653,1529,3182,20201222
20201219,분당선,수서,5562,6018,11580,20201222
20201219,분당선,수원,4484,3516,8000,20201222
20201219,분당선,서울숲,2893,2918,5811,20201222
20201219,분당선,압구정로데오,10343,11086,21429,20201222
20201219,분당선,강남구청,3313,3852,7165,20201222
20201219,분당선,선정릉,2315,2328,4643,20201222
20201219,분당선,가천대,3508,3849,7357,20201222
20201219,분당선,태평,7463,7311,14774,20201222
20201219,분당선,모란,12701,12721,25422,20201222
20201219,분당선,야탑,10658,11543,22201,20201222
20201219,분당선,서현,11665,11645,23310,20201222
20201219,분당선,수내,5535,5399,10934,20201222
20201219,분당선,정자,6543,6612,13155,20201222
20201219,분당선,미금,7219,7127,14346,20201222
20201219,분당선,오리,5046,4212,9258,20201222
20201219,분당선,이매,2161,2182,4343,20201222
20201219,분당선,보정,888,823,1711,20201222
20201219,분당선,죽전,6448,7108,13556,20201222
20201219,분당선,구성,1845,2035,3880,20201222
20201219,분당선,신갈,1625,1681,3306,20201222
20201219,분당선,기흥,4137,3996,8133,20201222
20201219,분당선,상갈,2261,2352,4613,20201222
20201219,분당선,청명,1593,1553,3146,20201222
20201219,분당선,영통,3809,3846,7655,20201222
20201219,분당선,망포,5592,5268,10860,20201222
20201219,분당선,매탄권선,1997,1942,3939,20201222
20201219,분당선,수원시청,6078,6551,12629,20201222
20201219,분당선,매교,1283,1317,2600,20201222
20201219,수인선,고색,1311,1275,2586,20201222
20201219,수인선,오목천,977,872,1849,20201222
20201219,수인선,어천,307,270,577,20201222
20201219,수인선,야목,94,94,188,20201222
20201219,수인선,사리,1596,1493,3089,20201222
20201219,수인선,달월,52,50,102,20201222
20201219,수인선,월곶,1252,1345,2597,20201222
20201219,수인선,소래포구,2702,2807,5509,20201222
20201219,수인선,인천논현,2850,2996,5846,20201222
20201219,수인선,호구포,1796,1747,3543,20201222
20201219,수인선,남동인더스파크,768,748,1516,20201222
20201219,수인선,원인재,2376,2456,4832,20201222
20201219,수인선,연수,2398,2386,4784,20201222
20201219,수인선,송도,1257,1244,2501,20201222
20201219,수인선,인하대,4417,3373,7790,20201222
20201219,수인선,숭의,1851,1746,3597,20201222
20201219,수인선,신포,882,881,1763,20201222
20201219,수인선,인천,599,998,1597,20201222
20201219,안산선,산본,7336,7913,15249,20201222
20201219,우이신설선,신설동,1002,979,1981,20201222
20201219,일산선,원흥,4106,3819,7925,20201222
20201219,일산선,삼송,8547,8507,17054,20201222
20201219,일산선,원당,5177,5124,10301,20201222
20201219,일산선,화정,7712,8361,16073,20201222
20201219,일산선,대곡,745,615,1360,20201222
20201219,일산선,백석,5168,5269,10437,20201222
20201219,일산선,마두,3050,3151,6201,20201222
20201219,일산선,정발산,3577,3646,7223,20201222
20201219,일산선,주엽,3648,3771,7419,20201222
20201219,장항선,봉명,539,519,1058,20201222
20201219,장항선,쌍용(나사렛대),1035,895,1930,20201222
20201219,장항선,아산,1618,1554,3172,20201222
20201219,장항선,배방,589,545,1134,20201222
20201219,장항선,온양온천,2572,2793,5365,20201222
20201219,장항선,신창(순천향대),819,629,1448,20201222
20201219,중앙선,회기,12460,11782,24242,20201222
20201219,중앙선,중랑,2857,2750,5607,20201222
20201219,중앙선,상봉(시외버스터미널),3015,2945,5960,20201222
20201219,중앙선,망우,3877,3878,7755,20201222
20201219,중앙선,양원,652,637,1289,20201222
20201219,중앙선,구리,6193,6495,12688,20201222
20201219,중앙선,도농,4045,3883,7928,20201222
20201219,중앙선,양정,315,280,595,20201222
20201219,중앙선,덕소,2580,2723,5303,20201222
20201219,중앙선,도심,923,828,1751,20201222
20201219,중앙선,팔당,628,677,1305,20201222
20201219,중앙선,운길산,456,479,935,20201222
20201219,중앙선,양수,797,846,1643,20201222
20201219,중앙선,신원,125,108,233,20201222
20201219,중앙선,국수,308,324,632,20201222
20201219,중앙선,아신,257,283,540,20201222
20201219,중앙선,오빈,140,146,286,20201222
20201219,중앙선,양평,1155,1180,2335,20201222
20201219,중앙선,원덕,153,159,312,20201222
20201219,중앙선,용문,800,929,1729,20201222
20201219,중앙선,지평,16,31,47,20201222
20201220,분당선,구룡,371,376,747,20201223
20201220,분당선,도곡,1555,1476,3031,20201223
20201220,분당선,한티,3941,4159,8100,20201223
20201220,분당선,선릉,1798,2487,4285,20201223
20201220,과천선,범계,7892,7535,15427,20201223
20201220,과천선,평촌,3689,3653,7342,20201223
20201220,과천선,인덕원,5993,5982,11975,20201223
20201220,과천선,정부과천청사,2240,2343,4583,20201223
20201220,과천선,과천,1489,1386,2875,20201223
20201220,과천선,대공원,1537,1646,3183,20201223
20201220,과천선,경마공원,593,553,1146,20201223
20201220,과천선,선바위,1985,2018,4003,20201223
20201220,공항철도 1호선,영종,1282,1204,2486,20201223
20201220,공항철도 1호선,인천공항2터미널,1320,1308,2628,20201223
20201220,공항철도 1호선,인천공항1터미널,2412,2684,5096,20201223
20201220,공항철도 1호선,공항화물청사,862,904,1766,20201223
20201220,공항철도 1호선,운서,3031,3264,6295,20201223
20201220,공항철도 1호선,청라국제도시,1550,1528,3078,20201223
20201220,공항철도 1호선,검암,2208,2227,4435,20201223
20201220,공항철도 1호선,계양,2702,2654,5356,20201223
20201220,공항철도 1호선,김포공항,6319,3333,9652,20201223
20201220,공항철도 1호선,마곡나루(서울식물원),986,1027,2013,20201223
20201220,공항철도 1호선,디지털미디어시티,2108,2123,4231,20201223
20201220,공항철도 1호선,홍대입구,3627,3281,6908,20201223
20201220,공항철도 1호선,공덕,708,942,1650,20201223
20201220,공항철도 1호선,서울역,3428,2749,6177,20201223
20201220,경춘선,춘천,576,550,1126,20201223
20201220,경춘선,남춘천,1117,1116,2233,20201223
20201220,경춘선,김유정,165,154,319,20201223
20201220,경춘선,강촌,298,219,517,20201223
20201220,경춘선,백양리,111,108,219,20201223
20201220,경춘선,굴봉산,73,79,152,20201223
20201220,경춘선,가평,691,585,1276,20201223
20201220,경춘선,상천,219,153,372,20201223
20201220,경춘선,청평,697,581,1278,20201223
20201220,경춘선,대성리,258,164,422,20201223
20201220,경춘선,마석,1290,1268,2558,20201223
20201220,경춘선,천마산,641,560,1201,20201223
20201220,경춘선,평내호평,1871,1885,3756,20201223
20201220,경춘선,금곡,516,524,1040,20201223
20201220,경춘선,사릉,1000,1031,2031,20201223
20201220,경춘선,퇴계원,1149,1070,2219,20201223
20201220,경춘선,별내,981,928,1909,20201223
20201220,경춘선,갈매,834,720,1554,20201223
20201220,경춘선,신내,423,444,867,20201223
20201220,경인선,도화,1398,1369,2767,20201223
20201220,경인선,중동,2979,2728,5707,20201223
20201220,경인선,온수(성공회대입구),2087,1972,4059,20201223
20201220,경인선,도원,943,1013,1956,20201223
20201220,경인선,간석,1894,1766,3660,20201223
20201220,경인선,부개,2801,2695,5496,20201223
20201220,경인선,소사,3606,3373,6979,20201223
20201220,경인선,구일,1750,1757,3507,20201223
20201220,경인선,인천,1634,1310,2944,20201223
20201220,경인선,동인천,5180,5093,10273,20201223
20201220,경인선,제물포,3254,3049,6303,20201223
20201220,경인선,주안,7864,7032,14896,20201223
20201220,경인선,동암,6011,5794,11805,20201223
20201220,3호선,지축,997,948,1945,20201223
20201220,경인선,백운,2448,2390,4838,20201223
20201220,경인선,부평,12739,12926,25665,20201223
20201220,경인선,송내,7860,7767,15627,20201223
20201220,경인선,부천,13750,13309,27059,20201223
20201220,경인선,역곡,8880,8726,17606,20201223
20201220,경인선,오류동,4158,3889,8047,20201223
20201220,경인선,개봉,7277,7295,14572,20201223
20201220,경의선,임진강,15,12,27,20201223
20201220,경의선,문산,1805,1877,3682,20201223
20201220,경의선,파주,387,346,733,20201223
20201220,경의선,월롱,454,796,1250,20201223
20201220,경의선,금촌,2286,2495,4781,20201223
20201220,경의선,금릉,1500,1400,2900,20201223
20201220,경의선,운정,1810,1752,3562,20201223
20201220,경의선,야당,1960,1842,3802,20201223
20201220,경의선,탄현,2210,2108,4318,20201223
20201220,경의선,일산,2458,2377,4835,20201223
20201220,경의선,풍산,1734,1561,3295,20201223
20201220,경의선,백마,1722,1573,3295,20201223
20201220,경의선,곡산,173,166,339,20201223
20201220,경의선,능곡,1341,1297,2638,20201223
20201220,경의선,행신,2179,2084,4263,20201223
20201220,경의선,강매,808,759,1567,20201223
20201220,경의선,화전,427,422,849,20201223
20201220,경의선,수색,473,519,992,20201223
20201220,경의선,디지털미디어시티,756,690,1446,20201223
20201220,경의선,가좌,1627,1603,3230,20201223
20201220,경의선,홍대입구,706,713,1419,20201223
20201220,경의선,서강대,646,604,1250,20201223
20201220,경의선,공덕,1096,845,1941,20201223
20201220,경의선,효창공원앞,716,827,1543,20201223
20201220,경의선,신촌,260,234,494,20201223
20201220,경의선,서울역,526,573,1099,20201223
20201220,경원선,소요산,1959,1717,3676,20201223
20201220,경원선,동두천,783,915,1698,20201223
20201220,경원선,보산,884,771,1655,20201223
20201220,경원선,동두천중앙,1351,1254,2605,20201223
20201220,경원선,지행,2355,2280,4635,20201223
20201220,경원선,덕정,1888,1932,3820,20201223
20201220,경원선,덕계,925,865,1790,20201223
20201220,경원선,양주,2756,2589,5345,20201223
20201220,경원선,녹양,1631,1611,3242,20201223
20201220,경원선,가능,2492,2379,4871,20201223
20201220,경원선,의정부,7950,8005,15955,20201223
20201220,경원선,회룡,4071,4163,8234,20201223
20201220,경원선,망월사,2547,2635,5182,20201223
20201220,경원선,도봉산,5300,3582,8882,20201223
20201220,경원선,도봉,2127,2003,4130,20201223
20201220,경원선,방학,3571,3448,7019,20201223
20201220,경원선,녹천,1638,1356,2994,20201223
20201220,경원선,월계,2404,2322,4726,20201223
20201220,경원선,광운대,2833,2809,5642,20201223
20201220,경원선,석계,2993,3237,6230,20201223
20201220,경원선,신이문,2990,2727,5717,20201223
20201220,경원선,외대앞,2853,2756,5609,20201223
20201220,경원선,청량리(서울시립대입구),6699,6597,13296,20201223
20201220,경원선,왕십리(성동구청),5067,5798,10865,20201223
20201220,경원선,응봉,575,570,1145,20201223
20201220,경원선,옥수,32,14,46,20201223
20201220,경원선,한남,1203,1204,2407,20201223
20201220,경원선,서빙고,483,507,990,20201223
20201220,경원선,이촌(국립중앙박물관),1064,881,1945,20201223
20201220,경부선,광명,1235,859,2094,20201223
20201220,경부선,서동탄,395,419,814,20201223
20201220,경부선,당정,1729,1785,3514,20201223
20201220,경부선,천안,3334,3282,6616,20201223
20201220,경부선,두정,2443,2592,5035,20201223
20201220,경부선,직산,334,358,692,20201223
20201220,경부선,성환,1496,1747,3243,20201223
20201220,경부선,평택,6565,6958,13523,20201223
20201220,경부선,지제,1200,1228,2428,20201223
20201220,경부선,서정리,2511,3759,6270,20201223
20201220,경부선,송탄,2294,2468,4762,20201223
20201220,경부선,진위,460,486,946,20201223
20201220,경부선,오산,4469,4902,9371,20201223
20201220,경부선,오산대,1145,1002,2147,20201223
20201220,경부선,세마,1381,1233,2614,20201223
20201220,경부선,병점,4890,5477,10367,20201223
20201220,경부선,세류,1124,1184,2308,20201223
20201220,경부선,독산,3552,3654,7206,20201223
20201220,경부선,수원,18091,17714,35805,20201223
20201220,경부선,화서,2094,2069,4163,20201223
20201220,경부선,성균관대,4226,4482,8708,20201223
20201220,경부선,의왕,2578,2615,5193,20201223
20201220,경부선,군포,2100,2056,4156,20201223
20201220,경부선,금정,8147,8512,16659,20201223
20201220,경부선,명학,2260,2201,4461,20201223
20201220,경부선,안양,8025,7653,15678,20201223
20201220,경부선,관악,2905,2663,5568,20201223
20201220,경부선,석수,3112,3128,6240,20201223
20201220,경부선,금천구청,3726,3625,7351,20201223
20201220,경부선,가산디지털단지,2757,3889,6646,20201223
20201220,경부선,구로,5883,6007,11890,20201223
20201220,경부선,신길,2971,2539,5510,20201223
20201220,경부선,신도림,1223,1115,2338,20201223
20201220,경부선,영등포,18429,17945,36374,20201223
20201220,경부선,대방,3448,3539,6987,20201223
20201220,경부선,노량진,3304,3436,6740,20201223
20201220,경부선,용산,14437,13118,27555,20201223
20201220,경부선,남영,2347,2574,4921,20201223
20201220,경부선,서울역,2538,586,3124,20201223
20201220,경강선,여주,938,839,1777,20201223
20201220,경강선,세종대왕릉,114,120,234,20201223
20201220,경강선,부발,664,1132,1796,20201223
20201220,경강선,이천,1038,1160,2198,20201223
20201220,경강선,신둔도예촌,450,402,852,20201223
20201220,경강선,곤지암,794,873,1667,20201223
20201220,경강선,초월,915,916,1831,20201223
20201220,경강선,경기광주,2033,2077,4110,20201223
20201220,경강선,삼동,605,637,1242,20201223
20201220,경강선,이매,326,241,567,20201223
20201220,경강선,판교,1370,1265,2635,20201223
20201220,9호선2~3단계,중앙보훈병원,1695,1571,3266,20201223
20201220,9호선2~3단계,둔촌오륜,211,212,423,20201223
20201220,9호선2~3단계,올림픽공원(한국체대),1523,1557,3080,20201223
20201220,9호선2~3단계,한성백제,722,683,1405,20201223
20201220,9호선2~3단계,송파나루,1383,1498,2881,20201223
20201220,9호선2~3단계,석촌,2362,2016,4378,20201223
20201220,9호선2~3단계,석촌고분,1796,1836,3632,20201223
20201220,9호선2~3단계,삼전,2065,2147,4212,20201223
20201220,9호선2~3단계,종합운동장,1042,990,2032,20201223
20201220,9호선2~3단계,봉은사,3950,3902,7852,20201223
20201220,9호선2~3단계,삼성중앙,1170,1229,2399,20201223
20201220,9호선2~3단계,선정릉,1806,2054,3860,20201223
20201220,9호선2~3단계,언주,1990,2106,4096,20201223
20201220,9호선,신논현,7714,7372,15086,20201223
20201220,9호선,사평,658,709,1367,20201223
20201220,9호선,고속터미널,4735,5981,10716,20201223
20201220,9호선,신반포,691,699,1390,20201223
20201220,9호선,구반포,655,710,1365,20201223
20201220,9호선,동작(현충원),527,471,998,20201223
20201220,9호선,흑석(중앙대입구),2176,2306,4482,20201223
20201220,9호선,노들,1364,1240,2604,20201223
20201220,9호선,노량진,7644,8092,15736,20201223
20201220,9호선,샛강,1003,1034,2037,20201223
20201220,9호선,여의도,3086,2910,5996,20201223
20201220,9호선,국회의사당,2160,1983,4143,20201223
20201220,9호선,당산,4852,4665,9517,20201223
20201220,9호선,선유도,1477,1480,2957,20201223
20201220,9호선,신목동,845,816,1661,20201223
20201220,9호선,염창,4869,4883,9752,20201223
20201220,9호선,등촌,3080,3162,6242,20201223
20201220,9호선,증미,1944,1972,3916,20201223
20201220,9호선,가양,6024,5969,11993,20201223
20201220,9호선,양천향교,2295,2493,4788,20201223
20201220,9호선,마곡나루(서울식물원),2766,2798,5564,20201223
20201220,9호선,신방화,2183,2103,4286,20201223
20201220,9호선,공항시장,1053,1178,2231,20201223
20201220,9호선,김포공항,4304,5756,10060,20201223
20201220,9호선,개화,592,565,1157,20201223
20201220,8호선,모란,1585,1310,2895,20201223
20201220,8호선,수진,1973,1757,3730,20201223
20201220,8호선,신흥,1924,2013,3937,20201223
20201220,8호선,단대오거리,3380,3267,6647,20201223
20201220,8호선,남한산성입구(성남법원.검찰청),4241,4009,8250,20201223
20201220,8호선,산성,2443,2431,4874,20201223
20201220,8호선,복정,2753,2742,5495,20201223
20201220,8호선,장지,5857,6333,12190,20201223
20201220,8호선,문정,3289,3505,6794,20201223
20201220,8호선,가락시장,2197,3008,5205,20201223
20201220,8호선,송파,2224,2376,4600,20201223
20201220,8호선,석촌,2429,2882,5311,20201223
20201220,8호선,잠실(송파구청),5735,5926,11661,20201223
20201220,8호선,몽촌토성(평화의문),1738,1821,3559,20201223
20201220,8호선,강동구청,2725,2736,5461,20201223
20201220,8호선,천호(풍납토성),5773,6530,12303,20201223
20201220,8호선,암사,5595,5474,11069,20201223
20201220,7호선,부평구청,3149,2823,5972,20201223
20201220,7호선,굴포천,2747,2810,5557,20201223
20201220,7호선,삼산체육관,1288,1227,2515,20201223
20201220,7호선,상동,3846,3796,7642,20201223
20201220,7호선,부천시청,4035,3795,7830,20201223
20201220,7호선,신중동,4069,3894,7963,20201223
20201220,7호선,춘의,2292,2151,4443,20201223
20201220,7호선,부천종합운동장,1423,1327,2750,20201223
20201220,7호선,까치울,2223,2264,4487,20201223
20201220,7호선,온수(성공회대입구),2438,2488,4926,20201223
20201220,7호선,천왕,2988,2946,5934,20201223
20201220,7호선,광명사거리,7872,7729,15601,20201223
20201220,7호선,철산,6106,6147,12253,20201223
20201220,7호선,가산디지털단지,7112,6595,13707,20201223
20201220,7호선,남구로,4666,4575,9241,20201223
20201220,7호선,대림(구로구청),3877,3647,7524,20201223
20201220,7호선,신풍,3736,3409,7145,20201223
20201220,7호선,보라매,2553,2511,5064,20201223
20201220,7호선,신대방삼거리,5001,5078,10079,20201223
20201220,7호선,장승배기,3143,3015,6158,20201223
20201220,7호선,상도,3279,3298,6577,20201223
20201220,7호선,숭실대입구(살피재),3358,3582,6940,20201223
20201220,7호선,남성,3410,3352,6762,20201223
20201220,7호선,이수,4570,4407,8977,20201223
20201220,7호선,내방,3220,3225,6445,20201223
20201220,7호선,고속터미널,6240,4425,10665,20201223
20201220,7호선,반포,1766,1812,3578,20201223
20201220,7호선,논현,3926,4279,8205,20201223
20201220,7호선,학동,3616,3877,7493,20201223
20201220,7호선,강남구청,3489,3891,7380,20201223
20201220,7호선,청담,4100,4339,8439,20201223
20201220,7호선,뚝섬유원지,2698,2521,5219,20201223
20201220,7호선,건대입구,5151,4950,10101,20201223
20201220,7호선,어린이대공원(세종대),3950,3858,7808,20201223
20201220,7호선,군자(능동),4600,3747,8347,20201223
20201220,7호선,중곡,3195,3144,6339,20201223
20201220,7호선,용마산(용마폭포공원),2100,2337,4437,20201223
20201220,7호선,사가정,5907,5820,11727,20201223
20201220,7호선,면목,5359,5373,10732,20201223
20201220,7호선,상봉(시외버스터미널),6027,5613,11640,20201223
20201220,7호선,중화,3697,3682,7379,20201223
20201220,7호선,먹골,3486,3391,6877,20201223
20201220,7호선,태릉입구,2746,2504,5250,20201223
20201220,7호선,공릉(서울과학기술대),3901,3932,7833,20201223
20201220,7호선,하계,5276,5055,10331,20201223
20201220,7호선,중계,4222,3873,8095,20201223
20201220,7호선,노원,6382,6252,12634,20201223
20201220,7호선,마들,3679,3472,7151,20201223
20201220,7호선,수락산,5184,5076,10260,20201223
20201220,7호선,도봉산,3189,4749,7938,20201223
20201220,7호선,장암,756,515,1271,20201223
20201220,6호선,신내,1,0,1,20201223
20201220,6호선,봉화산(서울의료원),2276,2282,4558,20201223
20201220,6호선,화랑대(서울여대입구),2792,2421,5213,20201223
20201220,6호선,태릉입구,1845,1949,3794,20201223
20201220,6호선,석계,3987,4143,8130,20201223
20201220,6호선,돌곶이,2705,2530,5235,20201223
20201220,6호선,상월곡(한국과학기술연구원),1933,1717,3650,20201223
20201220,6호선,월곡(동덕여대),3410,3344,6754,20201223
20201220,6호선,고려대(종암),2328,2276,4604,20201223
20201220,6호선,안암(고대병원앞),2543,2762,5305,20201223
20201220,6호선,보문,2303,2192,4495,20201223
20201220,6호선,창신,971,861,1832,20201223
20201220,6호선,동묘앞,3779,3685,7464,20201223
20201220,6호선,신당,1876,2669,4545,20201223
20201220,6호선,청구,964,1017,1981,20201223
20201220,6호선,약수,960,931,1891,20201223
20201220,6호선,버티고개,665,718,1383,20201223
20201220,6호선,한강진,2231,2513,4744,20201223
20201220,6호선,이태원,4045,3859,7904,20201223
20201220,6호선,녹사평(용산구청),1783,1782,3565,20201223
20201220,6호선,삼각지,1560,1293,2853,20201223
20201220,6호선,효창공원앞,1987,1791,3778,20201223
20201220,6호선,공덕,4060,3931,7991,20201223
20201220,6호선,대흥(서강대앞),2058,2151,4209,20201223
20201220,6호선,광흥창(서강),2295,2306,4601,20201223
20201220,6호선,상수,2635,2957,5592,20201223
20201220,6호선,합정,4486,4214,8700,20201223
20201220,6호선,망원,5068,5263,10331,20201223
20201220,6호선,마포구청,4431,4029,8460,20201223
20201220,6호선,월드컵경기장(성산),2237,2155,4392,20201223
20201220,6호선,디지털미디어시티,3150,3326,6476,20201223
20201220,6호선,증산(명지대앞),3461,3577,7038,20201223
20201220,6호선,새절(신사),4043,3961,8004,20201223
20201220,6호선,구산,2249,1692,3941,20201223
20201220,6호선,독바위,982,1338,2320,20201223
20201220,6호선,불광,2064,1825,3889,20201223
20201220,6호선,역촌,1188,1370,2558,20201223
20201220,6호선,응암,5752,5890,11642,20201223
20201220,5호선,하남풍산,1506,1644,3150,20201223
20201220,5호선,미사,3850,3855,7705,20201223
20201220,5호선,마천,2112,2275,4387,20201223
20201220,5호선,거여,2137,2153,4290,20201223
20201220,5호선,개롱,1656,1786,3442,20201223
20201220,5호선,오금,922,884,1806,20201223
20201220,5호선,방이,1854,1949,3803,20201223
20201220,5호선,올림픽공원(한국체대),1146,997,2143,20201223
20201220,5호선,둔촌동,2647,2740,5387,20201223
20201220,5호선,상일동,3839,3779,7618,20201223
20201220,5호선,고덕,2183,2196,4379,20201223
20201220,5호선,명일,2176,2218,4394,20201223
20201220,5호선,굽은다리(강동구민회관앞),3082,2893,5975,20201223
20201220,5호선,길동,2482,2540,5022,20201223
20201220,5호선,강동,5772,5613,11385,20201223
20201220,5호선,천호(풍납토성),7352,6999,14351,20201223
20201220,5호선,광나루(장신대),4270,4220,8490,20201223
20201220,5호선,아차산(어린이대공원후문),5996,6031,12027,20201223
20201220,5호선,군자(능동),3599,3969,7568,20201223
20201220,5호선,장한평,4436,4488,8924,20201223
20201220,5호선,답십리,4378,4181,8559,20201223
20201220,5호선,마장,1669,1572,3241,20201223
20201220,5호선,왕십리(성동구청),1444,1610,3054,20201223
20201220,5호선,행당,2313,2145,4458,20201223
20201220,5호선,신금호,1745,1853,3598,20201223
20201220,5호선,청구,1098,995,2093,20201223
20201220,5호선,동대문역사문화공원(DDP),531,546,1077,20201223
20201220,5호선,을지로4가,820,787,1607,20201223
20201220,5호선,종로3가,2906,2789,5695,20201223
20201220,5호선,광화문(세종문화회관),5329,5133,10462,20201223
20201220,5호선,서대문,2917,2801,5718,20201223
20201220,5호선,충정로(경기대입구),872,952,1824,20201223
20201220,5호선,애오개,1545,1638,3183,20201223
20201220,5호선,공덕,2647,2703,5350,20201223
20201220,5호선,마포,2725,2771,5496,20201223
20201220,5호선,여의나루,1599,1608,3207,20201223
20201220,5호선,여의도,3263,3346,6609,20201223
20201220,5호선,신길,1082,1265,2347,20201223
20201220,5호선,영등포시장,2742,2783,5525,20201223
20201220,5호선,영등포구청,845,845,1690,20201223
20201220,5호선,양평,1625,1692,3317,20201223
20201220,5호선,오목교(목동운동장앞),6489,6968,13457,20201223
20201220,5호선,목동,4371,4582,8953,20201223
20201220,5호선,신정(은행정),3902,3578,7480,20201223
20201220,5호선,까치산,9432,9486,18918,20201223
20201220,5호선,화곡,8552,8015,16567,20201223
20201220,5호선,우장산,3619,3727,7346,20201223
20201220,5호선,발산,4776,4870,9646,20201223
20201220,5호선,마곡,1819,1899,3718,20201223
20201220,5호선,송정,2229,2310,4539,20201223
20201220,5호선,김포공항,4233,3905,8138,20201223
20201220,5호선,개화산,1684,1732,3416,20201223
20201220,5호선,방화,2336,2246,4582,20201223
20201220,4호선,쌍문,9612,8885,18497,20201223
20201220,4호선,창동,8612,9188,17800,20201223
20201220,4호선,노원,6379,6887,13266,20201223
20201220,4호선,상계,6333,5912,12245,20201223
20201220,4호선,당고개,4676,4381,9057,20201223
20201220,4호선,남태령,285,264,549,20201223
20201220,4호선,사당,7447,7317,14764,20201223
20201220,4호선,총신대입구(이수),5765,6362,12127,20201223
20201220,4호선,동작(현충원),838,833,1671,20201223
20201220,4호선,이촌(국립중앙박물관),1932,2199,4131,20201223
20201220,4호선,신용산,3834,3874,7708,20201223
20201220,4호선,삼각지,1061,1366,2427,20201223
20201220,4호선,숙대입구(갈월),3404,3269,6673,20201223
20201220,4호선,서울역,2395,4037,6432,20201223
20201220,4호선,회현(남대문시장),5357,5302,10659,20201223
20201220,4호선,명동,5322,5539,10861,20201223
20201220,4호선,충무로,4320,4391,8711,20201223
20201220,4호선,동대문역사문화공원(DDP),4936,5116,10052,20201223
20201220,4호선,동대문,3779,4443,8222,20201223
20201220,4호선,혜화,8163,8430,16593,20201223
20201220,4호선,한성대입구(삼선교),4382,4405,8787,20201223
20201220,4호선,성신여대입구(돈암),6898,6565,13463,20201223
20201220,4호선,길음,5586,5645,11231,20201223
20201220,4호선,미아사거리,10142,9606,19748,20201223
20201220,4호선,미아(서울사이버대학),4895,4724,9619,20201223
20201220,4호선,수유(강북구청),12395,11535,23930,20201223
20201220,3호선,오금,1594,1549,3143,20201223
20201220,3호선,경찰병원,1608,1635,3243,20201223
20201220,3호선,가락시장,2306,2559,4865,20201223
20201220,3호선,수서,5323,5175,10498,20201223
20201220,3호선,일원,1793,1956,3749,20201223
20201220,3호선,대청,2327,2256,4583,20201223
20201220,3호선,학여울,407,407,814,20201223
20201220,3호선,대치,2388,2312,4700,20201223
20201220,3호선,도곡,1118,1151,2269,20201223
20201220,3호선,매봉,2356,2337,4693,20201223
20201220,3호선,양재(서초구청),7357,8602,15959,20201223
20201220,3호선,남부터미널(예술의전당),7239,7516,14755,20201223
20201220,3호선,교대(법원.검찰청),2003,1341,3344,20201223
20201220,3호선,고속터미널,20142,18736,38878,20201223
20201220,3호선,잠원,1120,1164,2284,20201223
20201220,3호선,신사,6927,7175,14102,20201223
20201220,3호선,압구정,7547,7882,15429,20201223
20201220,3호선,옥수,2717,2959,5676,20201223
20201220,3호선,금호,2567,2532,5099,20201223
20201220,3호선,약수,3763,3604,7367,20201223
20201220,3호선,동대입구,3127,3404,6531,20201223
20201220,3호선,을지로3가,1305,1341,2646,20201223
20201220,3호선,종로3가,1547,1975,3522,20201223
20201220,3호선,안국,3583,3630,7213,20201223
20201220,3호선,경복궁(정부서울청사),4385,4630,9015,20201223
20201220,3호선,독립문,2316,2472,4788,20201223
20201220,3호선,무악재,1045,1124,2169,20201223
20201220,3호선,홍제,5440,5136,10576,20201223
20201220,3호선,녹번,4086,3670,7756,20201223
20201220,3호선,불광,5860,6756,12616,20201223
20201220,3호선,연신내,13214,12268,25482,20201223
20201220,3호선,구파발,6513,6786,13299,20201223
20201220,2호선,용두(동대문구청),704,750,1454,20201223
20201220,2호선,신정네거리,3050,2993,6043,20201223
20201220,2호선,양천구청,1763,1840,3603,20201223
20201220,2호선,도림천,286,273,559,20201223
20201220,2호선,신설동,1875,1870,3745,20201223
20201220,2호선,신답,398,426,824,20201223
20201220,2호선,용답,1086,1063,2149,20201223
20201220,2호선,충정로(경기대입구),2324,2427,4751,20201223
20201220,2호선,아현,3094,3109,6203,20201223
20201220,2호선,이대,5055,5318,10373,20201223
20201220,2호선,신촌,11696,11337,23033,20201223
20201220,2호선,홍대입구,18915,18272,37187,20201223
20201220,2호선,합정,9522,9789,19311,20201223
20201220,2호선,당산,4983,5225,10208,20201223
20201220,2호선,영등포구청,4962,5294,10256,20201223
20201220,2호선,문래,4279,4431,8710,20201223
20201220,2호선,신도림,16449,16241,32690,20201223
20201220,2호선,대림(구로구청),9357,9199,18556,20201223
20201220,2호선,구로디지털단지,14907,14779,29686,20201223
20201220,2호선,신대방,9732,9479,19211,20201223
20201220,우이신설선,솔밭공원,899,848,1747,20201223
20201220,2호선,신림,23173,22956,46129,20201223
20201220,2호선,봉천,7690,7555,15245,20201223
20201220,2호선,서울대입구(관악구청),15698,16321,32019,20201223
20201220,2호선,낙성대(강감찬),9154,9619,18773,20201223
20201220,2호선,사당,11369,12503,23872,20201223
20201220,2호선,방배,3661,4017,7678,20201223
20201220,2호선,서초,3671,3453,7124,20201223
20201220,2호선,교대(법원.검찰청),5449,6051,11500,20201223
20201220,2호선,강남,16627,15979,32606,20201223
20201220,2호선,역삼,6808,7349,14157,20201223
20201220,2호선,선릉,7694,6808,14502,20201223
20201220,2호선,삼성(무역센터),11343,11177,22520,20201223
20201220,2호선,종합운동장,1735,1976,3711,20201223
20201220,2호선,잠실새내,5522,5816,11338,20201223
20201220,2호선,잠실(송파구청),22888,21492,44380,20201223
20201220,2호선,잠실나루,2958,2939,5897,20201223
20201220,2호선,강변(동서울터미널),11029,11019,22048,20201223
20201220,2호선,구의(광진구청),6899,7110,14009,20201223
20201220,2호선,건대입구,12491,13302,25793,20201223
20201220,2호선,성수,5348,5984,11332,20201223
20201220,2호선,뚝섬,4097,4198,8295,20201223
20201220,2호선,한양대,1555,1699,3254,20201223
20201220,2호선,왕십리(성동구청),5251,4397,9648,20201223
20201220,2호선,상왕십리,3917,3929,7846,20201223
20201220,2호선,신당,4938,5155,10093,20201223
20201220,2호선,동대문역사문화공원(DDP),4094,5089,9183,20201223
20201220,2호선,을지로4가,1895,1748,3643,20201223
20201220,2호선,을지로3가,2957,2699,5656,20201223
20201220,2호선,을지로입구,9644,9263,18907,20201223
20201220,2호선,시청,2839,2354,5193,20201223
20201220,1호선,청량리(서울시립대입구),8285,8176,16461,20201223
20201220,1호선,제기동,5897,6240,12137,20201223
20201220,1호선,신설동,4512,4506,9018,20201223
20201220,1호선,동대문,5234,5861,11095,20201223
20201220,1호선,종로5가,4055,4194,8249,20201223
20201220,1호선,종로3가,6586,5937,12523,20201223
20201220,1호선,종각,5926,5428,11354,20201223
20201220,1호선,시청,3819,3697,7516,20201223
20201220,1호선,동묘앞,8118,8175,16293,20201223
20201220,1호선,서울역,13067,11845,24912,20201223
20201220,우이신설선,북한산우이,1560,1692,3252,20201223
20201220,안산선,수리산,1222,1252,2474,20201223
20201220,안산선,오이도,3181,3177,6358,20201223
20201220,안산선,정왕,3036,3206,6242,20201223
20201220,안산선,신길온천,683,642,1325,20201223
20201220,안산선,안산,6536,5841,12377,20201223
20201220,안산선,초지,1343,1368,2711,20201223
20201220,안산선,고잔,2497,2379,4876,20201223
20201220,안산선,중앙,6095,5949,12044,20201223
20201220,안산선,한대앞,3062,2989,6051,20201223
20201220,안산선,상록수,5707,5495,11202,20201223
20201220,수인선,오목천,681,667,1348,20201223
20201220,수인선,어천,199,270,469,20201223
20201220,수인선,야목,70,67,137,20201223
20201220,수인선,사리,1173,1054,2227,20201223
20201220,수인선,달월,40,40,80,20201223
20201220,수인선,월곶,978,954,1932,20201223
20201220,안산선,반월,1439,1458,2897,20201223
20201220,안산선,대야미,1739,1564,3303,20201223
20201220,안산선,산본,4788,5119,9907,20201223
20201220,수인선,인천,510,796,1306,20201223
20201220,수인선,신포,687,727,1414,20201223
20201220,수인선,숭의,1211,1168,2379,20201223
20201220,수인선,인하대,4444,3212,7656,20201223
20201220,수인선,송도,975,1010,1985,20201223
20201220,수인선,연수,1872,1818,3690,20201223
20201220,수인선,원인재,1750,1810,3560,20201223
20201220,수인선,남동인더스파크,468,470,938,20201223
20201220,수인선,호구포,1213,1249,2462,20201223
20201220,수인선,인천논현,1866,1933,3799,20201223
20201220,수인선,소래포구,2302,2229,4531,20201223
20201220,수인선,고색,926,986,1912,20201223
20201220,분당선,매교,828,805,1633,20201223
20201220,분당선,수원시청,3990,3893,7883,20201223
20201220,분당선,매탄권선,1438,1460,2898,20201223
20201220,분당선,망포,3585,3754,7339,20201223
20201220,분당선,영통,2682,2652,5334,20201223
20201220,분당선,청명,1078,1128,2206,20201223
20201220,분당선,상갈,1686,1696,3382,20201223
20201220,분당선,기흥,2914,2913,5827,20201223
20201220,분당선,신갈,1037,1071,2108,20201223
20201220,분당선,구성,1263,1396,2659,20201223
20201220,분당선,죽전,4956,5437,10393,20201223
20201220,분당선,보정,558,538,1096,20201223
20201220,분당선,이매,1599,1647,3246,20201223
20201220,분당선,오리,3358,2928,6286,20201223
20201220,분당선,미금,4223,4438,8661,20201223
20201220,분당선,정자,4033,4101,8134,20201223
20201220,분당선,수내,3821,3695,7516,20201223
20201220,분당선,서현,7751,7644,15395,20201223
20201220,분당선,야탑,7311,7653,14964,20201223
20201220,분당선,모란,6858,7090,13948,20201223
20201220,분당선,태평,5230,4937,10167,20201223
20201220,분당선,가천대,2168,2656,4824,20201223
20201220,분당선,선정릉,1345,1426,2771,20201223
20201220,분당선,강남구청,1776,2149,3925,20201223
20201220,분당선,압구정로데오,5586,5968,11554,20201223
20201220,분당선,서울숲,2019,2018,4037,20201223
20201220,분당선,수원,3280,2717,5997,20201223
20201220,분당선,수서,4162,4217,8379,20201223
20201220,중앙선,지평,13,20,33,20201223
20201220,중앙선,용문,1150,1009,2159,20201223
20201220,중앙선,원덕,152,121,273,20201223
20201220,중앙선,양평,979,935,1914,20201223
20201220,중앙선,오빈,89,94,183,20201223
20201220,중앙선,아신,243,205,448,20201223
20201220,중앙선,국수,282,286,568,20201223
20201220,중앙선,신원,128,78,206,20201223
20201220,중앙선,양수,723,714,1437,20201223
20201220,중앙선,운길산,535,468,1003,20201223
20201220,중앙선,팔당,626,688,1314,20201223
20201220,중앙선,도심,660,630,1290,20201223
20201220,중앙선,덕소,1913,1945,3858,20201223
20201220,중앙선,양정,270,217,487,20201223
20201220,중앙선,도농,2662,2741,5403,20201223
20201220,중앙선,구리,4229,4321,8550,20201223
20201220,중앙선,양원,474,465,939,20201223
20201220,중앙선,망우,2695,2748,5443,20201223
20201220,중앙선,상봉(시외버스터미널),2301,2225,4526,20201223
20201220,중앙선,중랑,2063,2035,4098,20201223
20201220,중앙선,회기,9010,8849,17859,20201223
20201220,장항선,신창(순천향대),656,598,1254,20201223
20201220,장항선,온양온천,2146,2163,4309,20201223
20201220,장항선,배방,474,554,1028,20201223
20201220,장항선,아산,1613,1246,2859,20201223
20201220,장항선,쌍용(나사렛대),694,687,1381,20201223
20201220,장항선,봉명,348,334,682,20201223
20201220,일산선,대화,3651,3335,6986,20201223
20201220,일산선,주엽,2388,2340,4728,20201223
20201220,일산선,정발산,2697,2614,5311,20201223
20201220,일산선,마두,1888,1915,3803,20201223
20201220,일산선,백석,3584,3544,7128,20201223
20201220,일산선,대곡,553,484,1037,20201223
20201220,일산선,화정,5397,5612,11009,20201223
20201220,일산선,원당,3581,3509,7090,20201223
20201220,일산선,삼송,6015,6012,12027,20201223
20201220,일산선,지축,1,0,1,20201223
20201220,일산선,원흥,2926,2742,5668,20201223
20201220,우이신설선,신설동,704,687,1391,20201223
20201220,우이신설선,보문,561,584,1145,20201223
20201220,우이신설선,성신여대입구(돈암),1151,1276,2427,20201223
20201220,우이신설선,정릉,1498,1372,2870,20201223
20201220,우이신설선,북한산보국문,2136,2021,4157,20201223
20201220,우이신설선,솔샘,1598,1465,3063,20201223
20201220,우이신설선,삼양사거리,936,967,1903,20201223
20201220,우이신설선,삼양,790,830,1620,20201223
20201220,우이신설선,화계,1246,1134,2380,20201223
20201220,우이신설선,가오리,1385,1352,2737,20201223
20201220,우이신설선,4.19민주묘지,1145,960,2105,20201223
20201220,분당선,대모산입구,1042,1021,2063,20201223
20201220,분당선,개포동,912,952,1864,20201223
20201221,3호선,가락시장,7058,6918,13976,20201224
20201221,경부선,화서,5720,5567,11287,20201224
20201221,경부선,성균관대,10883,10844,21727,20201224
20201221,경부선,의왕,7132,7266,14398,20201224
20201221,경부선,군포,6555,6817,13372,20201224
20201221,경부선,금정,21193,21965,43158,20201224
20201221,경부선,명학,7735,7765,15500,20201224
20201221,경부선,안양,16774,16688,33462,20201224
20201221,경부선,관악,6026,5509,11535,20201224
20201221,경부선,석수,8150,7348,15498,20201224
20201221,경부선,금천구청,9557,9532,19089,20201224
20201221,경부선,가산디지털단지,14993,17715,32708,20201224
20201221,경부선,구로,15607,15739,31346,20201224
20201221,경부선,신길,7750,6475,14225,20201224
20201221,경부선,신도림,3336,3291,6627,20201224
20201221,경부선,영등포,28025,28913,56938,20201224
20201221,경부선,대방,10331,10782,21113,20201224
20201221,경부선,노량진,5886,6274,12160,20201224
20201221,경부선,용산,22478,22968,45446,20201224
20201221,경부선,남영,7448,7910,15358,20201224
20201221,경부선,서울역,3345,1102,4447,20201224
20201221,경강선,여주,1177,1175,2352,20201224
20201221,경강선,세종대왕릉,191,181,372,20201224
20201221,경강선,부발,1187,1252,2439,20201224
20201221,경강선,이천,1727,1809,3536,20201224
20201221,경강선,신둔도예촌,888,850,1738,20201224
20201221,경강선,곤지암,1534,1503,3037,20201224
20201221,경강선,초월,2350,2349,4699,20201224
20201221,경강선,경기광주,5413,5211,10624,20201224
20201221,경강선,삼동,1861,1770,3631,20201224
20201221,경강선,이매,794,669,1463,20201224
20201221,경강선,판교,3474,3286,6760,20201224
20201221,경원선,도봉산,6268,3805,10073,20201224
20201221,경원선,망월사,5694,5934,11628,20201224
20201221,경원선,회룡,9768,9704,19472,20201224
20201221,경원선,의정부,14047,14035,28082,20201224
20201221,경원선,가능,5171,5014,10185,20201224
20201221,경원선,녹양,3718,3569,7287,20201224
20201221,경원선,양주,5833,5561,11394,20201224
20201221,경원선,덕계,2166,1960,4126,20201224
20201221,경원선,덕정,4249,4171,8420,20201224
20201221,경원선,지행,4935,4782,9717,20201224
20201221,경의선,효창공원앞,2344,2682,5026,20201224
20201221,경의선,신촌,675,784,1459,20201224
20201221,경의선,서울역,3186,4010,7196,20201224
20201221,경원선,소요산,1919,1590,3509,20201224
20201221,경원선,동두천,1498,1725,3223,20201224
20201221,일산선,주엽,6680,6650,13330,20201224
20201221,일산선,대화,10325,8139,18464,20201224
20201221,장항선,봉명,1068,1048,2116,20201224
20201221,장항선,쌍용(나사렛대),1423,1358,2781,20201224
20201221,장항선,아산,2080,1933,4013,20201224
20201221,장항선,배방,702,708,1410,20201224
20201221,장항선,온양온천,2591,2582,5173,20201224
20201221,장항선,신창(순천향대),820,821,1641,20201224
20201221,중앙선,회기,18531,17867,36398,20201224
20201221,중앙선,중랑,4514,4408,8922,20201224
20201221,중앙선,상봉(시외버스터미널),4642,4607,9249,20201224
20201221,중앙선,망우,6066,5944,12010,20201224
20201221,중앙선,양원,1222,1255,2477,20201224
20201221,중앙선,구리,10741,10842,21583,20201224
20201221,우이신설선,북한산우이,2880,2746,5626,20201224
20201221,안산선,수리산,3447,2821,6268,20201224
20201221,안산선,오이도,6522,6153,12675,20201224
20201221,안산선,정왕,6873,7456,14329,20201224
20201221,안산선,신길온천,1281,1191,2472,20201224
20201221,안산선,안산,10193,9204,19397,20201224
20201221,안산선,초지,3508,3606,7114,20201224
20201221,안산선,고잔,6862,6502,13364,20201224
20201221,안산선,중앙,12580,12771,25351,20201224
20201221,안산선,한대앞,6731,6844,13575,20201224
20201221,안산선,상록수,13373,13453,26826,20201224
20201221,안산선,반월,3533,3399,6932,20201224
20201221,안산선,대야미,3837,3491,7328,20201224
20201221,안산선,산본,12465,13385,25850,20201224
20201221,수인선,인천,766,1183,1949,20201224
20201221,수인선,신포,1293,1303,2596,20201224
20201221,수인선,숭의,3164,2935,6099,20201224
20201221,수인선,인하대,4395,4146,8541,20201224
20201221,수인선,송도,1980,1796,3776,20201224
20201221,수인선,연수,3451,3311,6762,20201224
20201221,수인선,원인재,3548,3492,7040,20201224
20201221,수인선,남동인더스파크,2142,2441,4583,20201224
20201221,수인선,호구포,3020,3198,6218,20201224
20201221,수인선,인천논현,4254,4408,8662,20201224
20201221,수인선,소래포구,3399,3208,6607,20201224
20201221,수인선,월곶,1964,1837,3801,20201224
20201221,수인선,달월,83,46,129,20201224
20201221,수인선,사리,2737,2583,5320,20201224
20201221,수인선,야목,161,122,283,20201224
20201221,수인선,어천,444,472,916,20201224
20201221,수인선,오목천,1647,1565,3212,20201224
20201221,수인선,고색,2623,2553,5176,20201224
20201221,분당선,매교,2384,2379,4763,20201224
20201221,우이신설선,삼양,1693,1848,3541,20201224
20201221,우이신설선,삼양사거리,1959,2103,4062,20201224
20201221,우이신설선,솔샘,4643,4469,9112,20201224
20201221,우이신설선,북한산보국문,4716,4631,9347,20201224
20201221,우이신설선,정릉,3522,3396,6918,20201224
20201221,우이신설선,성신여대입구(돈암),2397,2403,4800,20201224
20201221,우이신설선,보문,1215,1254,2469,20201224
20201221,우이신설선,신설동,1880,1783,3663,20201224
20201221,일산선,원흥,7391,7087,14478,20201224
20201221,일산선,삼송,14084,14054,28138,20201224
20201221,일산선,원당,8955,8657,17612,20201224
20201221,일산선,화정,13040,13412,26452,20201224
20201221,일산선,대곡,1298,959,2257,20201224
20201221,일산선,백석,8031,8121,16152,20201224
20201221,일산선,마두,5630,5840,11470,20201224
20201221,일산선,정발산,5145,5068,10213,20201224
20201221,우이신설선,솔밭공원,1905,1853,3758,20201224
20201221,우이신설선,4.19민주묘지,2231,2178,4409,20201224
20201221,우이신설선,가오리,3260,3381,6641,20201224
20201221,우이신설선,화계,2842,2656,5498,20201224
20201221,3호선,금호,6384,6209,12593,20201224
20201221,5호선,을지로4가,5274,5300,10574,20201224
20201221,5호선,청구,3318,3088,6406,20201224
20201221,7호선,뚝섬유원지,5740,5702,11442,20201224
20201221,경의선,능곡,2897,2650,5547,20201224
20201221,경의선,행신,6011,6090,12101,20201224
20201221,경의선,강매,2422,2146,4568,20201224
20201221,경의선,화전,1268,1163,2431,20201224
20201221,경의선,수색,2017,2047,4064,20201224
20201221,경의선,디지털미디어시티,1875,1831,3706,20201224
20201221,경의선,가좌,4187,3875,8062,20201224
20201221,경의선,홍대입구,1097,1164,2261,20201224
20201221,중앙선,지평,38,25,63,20201224
20201221,중앙선,용문,1196,1123,2319,20201224
20201221,중앙선,원덕,232,206,438,20201224
20201221,중앙선,양평,1829,1781,3610,20201224
20201221,중앙선,오빈,223,215,438,20201224
20201221,중앙선,아신,394,384,778,20201224
20201221,중앙선,국수,470,497,967,20201224
20201221,중앙선,신원,145,110,255,20201224
20201221,중앙선,양수,1240,1247,2487,20201224
20201221,중앙선,운길산,466,408,874,20201224
20201221,중앙선,팔당,539,553,1092,20201224
20201221,중앙선,도심,1972,1534,3506,20201224
20201221,중앙선,덕소,4509,4589,9098,20201224
20201221,중앙선,양정,630,540,1170,20201224
20201221,중앙선,도농,8023,7282,15305,20201224
20201221,분당선,수원시청,9286,9807,19093,20201224
20201221,분당선,매탄권선,3692,3544,7236,20201224
20201221,분당선,망포,10892,10520,21412,20201224
20201221,분당선,영통,6110,6121,12231,20201224
20201221,분당선,청명,3217,3100,6317,20201224
20201221,분당선,상갈,4063,3966,8029,20201224
20201221,분당선,기흥,7123,6876,13999,20201224
20201221,분당선,신갈,3502,3524,7026,20201224
20201221,분당선,구성,3711,3937,7648,20201224
20201221,분당선,죽전,9977,10787,20764,20201224
20201221,분당선,보정,1916,1637,3553,20201224
20201221,분당선,이매,3900,3681,7581,20201224
20201221,분당선,오리,9482,7924,17406,20201224
20201221,분당선,미금,12040,12922,24962,20201224
20201221,분당선,정자,12092,12841,24933,20201224
20201221,분당선,수내,9942,9962,19904,20201224
20201221,분당선,서현,18624,18727,37351,20201224
20201221,분당선,야탑,20074,21019,41093,20201224
20201221,분당선,모란,15935,15889,31824,20201224
20201221,분당선,태평,11041,10796,21837,20201224
20201221,분당선,가천대,5145,6104,11249,20201224
20201221,분당선,선정릉,6639,7020,13659,20201224
20201221,분당선,강남구청,7445,8593,16038,20201224
20201221,분당선,압구정로데오,13045,13955,27000,20201224
20201221,분당선,서울숲,6327,6355,12682,20201224
20201221,분당선,수원,5883,4693,10576,20201224
20201221,분당선,수서,9777,10064,19841,20201224
20201221,분당선,대모산입구,2870,2705,5575,20201224
20201221,분당선,개포동,2956,3003,5959,20201224
20201221,분당선,구룡,1301,1273,2574,20201224
20201221,분당선,도곡,5371,5471,10842,20201224
20201221,분당선,한티,10462,11161,21623,20201224
20201221,분당선,선릉,11275,16587,27862,20201224
20201221,과천선,범계,19518,18994,38512,20201224
20201221,과천선,평촌,14628,14663,29291,20201224
20201221,과천선,인덕원,18871,19866,38737,20201224
20201221,과천선,정부과천청사,7688,7558,15246,20201224
20201221,과천선,과천,4125,3756,7881,20201224
20201221,과천선,대공원,1199,1230,2429,20201224
20201221,과천선,경마공원,707,713,1420,20201224
20201221,과천선,선바위,6874,6021,12895,20201224
20201221,공항철도 1호선,영종,2120,2181,4301,20201224
20201221,공항철도 1호선,인천공항2터미널,1689,1738,3427,20201224
20201221,공항철도 1호선,인천공항1터미널,2790,2919,5709,20201224
20201221,공항철도 1호선,공항화물청사,2039,2242,4281,20201224
20201221,공항철도 1호선,운서,4576,4687,9263,20201224
20201221,공항철도 1호선,청라국제도시,5141,4716,9857,20201224
20201221,공항철도 1호선,검암,5597,5466,11063,20201224
20201221,공항철도 1호선,계양,7379,7299,14678,20201224
20201221,공항철도 1호선,김포공항,7417,4679,12096,20201224
20201221,공항철도 1호선,마곡나루(서울식물원),5763,5572,11335,20201224
20201221,공항철도 1호선,디지털미디어시티,10935,9988,20923,20201224
20201221,공항철도 1호선,홍대입구,5318,5455,10773,20201224
20201221,공항철도 1호선,공덕,1687,2125,3812,20201224
20201221,공항철도 1호선,서울역,4945,4316,9261,20201224
20201221,경춘선,춘천,807,763,1570,20201224
20201221,경춘선,남춘천,1506,1562,3068,20201224
20201221,경춘선,김유정,146,129,275,20201224
20201221,경춘선,강촌,232,253,485,20201224
20201221,경춘선,백양리,117,113,230,20201224
20201221,경춘선,굴봉산,48,57,105,20201224
20201221,경춘선,가평,1073,1103,2176,20201224
20201221,경춘선,상천,168,169,337,20201224
20201221,경춘선,청평,1087,1158,2245,20201224
20201221,경춘선,대성리,333,339,672,20201224
20201221,경춘선,마석,2985,2924,5909,20201224
20201221,경춘선,천마산,1344,1269,2613,20201224
20201221,경춘선,평내호평,4747,4581,9328,20201224
20201221,경춘선,금곡,1260,1123,2383,20201224
20201221,경춘선,사릉,2784,2661,5445,20201224
20201221,경춘선,퇴계원,2937,2693,5630,20201224
20201221,경춘선,별내,2181,2129,4310,20201224
20201221,경춘선,갈매,2491,2117,4608,20201224
20201221,경춘선,신내,1211,1172,2383,20201224
20201221,경인선,도화,3348,3104,6452,20201224
20201221,경인선,중동,7503,7122,14625,20201224
20201221,경인선,온수(성공회대입구),5325,5250,10575,20201224
20201221,경인선,도원,2472,2629,5101,20201224
20201221,경인선,간석,4592,4409,9001,20201224
20201221,경인선,부개,6923,6569,13492,20201224
20201221,경인선,소사,7743,7010,14753,20201224
20201221,경인선,구일,4885,5150,10035,20201224
20201221,경인선,인천,2305,1696,4001,20201224
20201221,경인선,동인천,10992,10472,21464,20201224
20201221,경인선,제물포,8003,7653,15656,20201224
20201221,경인선,주안,15014,13561,28575,20201224
20201221,경인선,동암,12514,12568,25082,20201224
20201221,경인선,백운,5818,5909,11727,20201224
20201221,경인선,부평,22892,23683,46575,20201224
20201221,경인선,송내,22626,22501,45127,20201224
20201221,경인선,부천,26273,25996,52269,20201224
20201221,경인선,역곡,22276,22070,44346,20201224
20201221,경인선,오류동,9705,9332,19037,20201224
20201221,경인선,개봉,17537,18313,35850,20201224
20201221,경의선,임진강,6,1,7,20201224
20201221,경의선,문산,3881,3784,7665,20201224
20201221,경의선,파주,772,604,1376,20201224
20201221,경의선,월롱,1632,1577,3209,20201224
20201221,경의선,금촌,5094,5053,10147,20201224
20201221,경의선,금릉,3416,3295,6711,20201224
20201221,경의선,운정,4964,4729,9693,20201224
20201221,경의선,야당,4662,4438,9100,20201224
20201221,경의선,탄현,5718,5661,11379,20201224
20201221,경의선,일산,7269,7245,14514,20201224
20201221,경의선,풍산,4006,3748,7754,20201224
20201221,경의선,백마,5205,4978,10183,20201224
20201221,경의선,곡산,401,439,840,20201224
20201221,경원선,도봉,4941,4734,9675,20201224
20201221,경원선,방학,7800,7705,15505,20201224
20201221,경원선,녹천,3905,3259,7164,20201224
20201221,경원선,월계,5206,4992,10198,20201224
20201221,경원선,광운대,6530,6250,12780,20201224
20201221,경원선,석계,6481,7478,13959,20201224
20201221,경원선,신이문,7205,6641,13846,20201224
20201221,경원선,외대앞,5702,5719,11421,20201224
20201221,경원선,청량리(서울시립대입구),10116,11128,21244,20201224
20201221,경원선,왕십리(성동구청),9801,11345,21146,20201224
20201221,경원선,응봉,1377,1147,2524,20201224
20201221,경원선,옥수,37,22,59,20201224
20201221,경원선,한남,3362,3160,6522,20201224
20201221,경원선,서빙고,1472,1344,2816,20201224
20201221,경원선,이촌(국립중앙박물관),2944,2210,5154,20201224
20201221,경부선,광명,2415,2138,4553,20201224
20201221,경부선,서동탄,1190,961,2151,20201224
20201221,경부선,당정,4922,4585,9507,20201224
20201221,경부선,천안,3550,3589,7139,20201224
20201221,경부선,두정,3758,4011,7769,20201224
20201221,경부선,직산,534,547,1081,20201224
20201221,경부선,성환,2597,2737,5334,20201224
20201221,경부선,평택,8260,8293,16553,20201224
20201221,경부선,지제,2133,2100,4233,20201224
20201221,경부선,송탄,3283,3163,6446,20201224
20201221,경부선,진위,1214,1150,2364,20201224
20201221,경부선,오산,7307,7476,14783,20201224
20201221,경부선,오산대,2393,2173,4566,20201224
20201221,경부선,세마,1943,1790,3733,20201224
20201221,경부선,병점,10093,10144,20237,20201224
20201221,경부선,세류,2429,2211,4640,20201224
20201221,경부선,독산,15066,15768,30834,20201224
20201221,경부선,수원,23684,25118,48802,20201224
20201221,9호선2~3단계,중앙보훈병원,7910,6913,14823,20201224
20201221,9호선2~3단계,둔촌오륜,1048,890,1938,20201224
20201221,9호선2~3단계,올림픽공원(한국체대),4119,4062,8181,20201224
20201221,9호선2~3단계,한성백제,1818,1709,3527,20201224
20201221,9호선2~3단계,송파나루,3428,3729,7157,20201224
20201221,9호선2~3단계,석촌,5848,5304,11152,20201224
20201221,9호선2~3단계,석촌고분,4499,4641,9140,20201224
20201221,9호선2~3단계,삼전,5187,5058,10245,20201224
20201221,9호선2~3단계,종합운동장,3109,3156,6265,20201224
20201221,9호선2~3단계,봉은사,12073,12203,24276,20201224
20201221,9호선2~3단계,삼성중앙,5381,5593,10974,20201224
20201221,9호선2~3단계,선정릉,7367,8003,15370,20201224
20201221,9호선2~3단계,언주,8093,8140,16233,20201224
20201221,9호선,신논현,23371,22965,46336,20201224
20201221,9호선,사평,2431,2418,4849,20201224
20201221,9호선,고속터미널,8237,10267,18504,20201224
20201221,9호선,신반포,2349,2287,4636,20201224
20201221,9호선,구반포,2106,2140,4246,20201224
20201221,9호선,동작(현충원),1311,980,2291,20201224
20201221,9호선,흑석(중앙대입구),5984,6263,12247,20201224
20201221,9호선,노들,3452,3132,6584,20201224
20201221,9호선,노량진,17891,17480,35371,20201224
20201221,9호선,샛강,4404,4638,9042,20201224
20201221,9호선,여의도,18447,17785,36232,20201224
20201221,9호선,국회의사당,12347,12308,24655,20201224
20201221,9호선,당산,13577,13850,27427,20201224
20201221,9호선,선유도,6245,6102,12347,20201224
20201221,9호선,신목동,3013,2830,5843,20201224
20201221,9호선,염창,13495,13493,26988,20201224
20201221,9호선,등촌,8826,8835,17661,20201224
20201221,9호선,증미,5948,6061,12009,20201224
20201221,9호선,가양,16240,16162,32402,20201224
20201221,9호선,양천향교,7616,7738,15354,20201224
20201221,9호선,마곡나루(서울식물원),8065,8204,16269,20201224
20201221,9호선,신방화,5394,5199,10593,20201224
20201221,9호선,공항시장,2304,2572,4876,20201224
20201221,9호선,김포공항,5387,8387,13774,20201224
20201221,9호선,개화,2218,2849,5067,20201224
20201221,8호선,모란,3416,2519,5935,20201224
20201221,8호선,수진,4306,3910,8216,20201224
20201221,8호선,신흥,3708,4057,7765,20201224
20201221,8호선,단대오거리,8404,8251,16655,20201224
20201221,8호선,남한산성입구(성남법원.검찰청),11172,10340,21512,20201224
20201221,8호선,산성,5542,5545,11087,20201224
20201221,8호선,복정,8375,7260,15635,20201224
20201221,8호선,장지,13847,13736,27583,20201224
20201221,8호선,문정,18522,19544,38066,20201224
20201221,8호선,가락시장,6448,7208,13656,20201224
20201221,8호선,송파,6502,6562,13064,20201224
20201221,8호선,석촌,6096,6748,12844,20201224
20201221,8호선,잠실(송파구청),10782,12117,22899,20201224
20201221,8호선,몽촌토성(평화의문),4325,4526,8851,20201224
20201221,8호선,강동구청,8720,9202,17922,20201224
20201221,8호선,천호(풍납토성),12577,14001,26578,20201224
20201221,8호선,암사,15827,14100,29927,20201224
20201221,7호선,부평구청,9517,7937,17454,20201224
20201221,7호선,굴포천,6948,7404,14352,20201224
20201221,7호선,삼산체육관,3791,3349,7140,20201224
20201221,7호선,상동,9474,9677,19151,20201224
20201221,7호선,부천시청,9905,9879,19784,20201224
20201221,7호선,신중동,11604,11410,23014,20201224
20201221,7호선,춘의,8596,8512,17108,20201224
20201221,7호선,부천종합운동장,3785,3317,7102,20201224
20201221,7호선,까치울,6211,6047,12258,20201224
20201221,7호선,온수(성공회대입구),9174,8473,17647,20201224
20201221,7호선,천왕,9117,8702,17819,20201224
20201221,7호선,광명사거리,19204,19015,38219,20201224
20201221,7호선,철산,17316,17685,35001,20201224
20201221,7호선,가산디지털단지,41043,41057,82100,20201224
20201221,7호선,남구로,14347,15106,29453,20201224
20201221,7호선,대림(구로구청),6202,6207,12409,20201224
20201221,7호선,신풍,9505,9181,18686,20201224
20201221,7호선,보라매,8191,8128,16319,20201224
20201221,7호선,신대방삼거리,13717,13591,27308,20201224
20201221,7호선,장승배기,8172,8035,16207,20201224
20201221,7호선,상도,8296,8309,16605,20201224
20201221,7호선,숭실대입구(살피재),9442,9756,19198,20201224
20201221,경부선,서정리,4529,4499,9028,20201224
20201221,7호선,남성,9205,8646,17851,20201224
20201221,7호선,이수,11980,11766,23746,20201224
20201221,7호선,내방,11966,12188,24154,20201224
20201221,7호선,고속터미널,11870,10175,22045,20201224
20201221,7호선,논현,17034,18114,35148,20201224
20201221,7호선,학동,20562,21517,42079,20201224
20201221,7호선,강남구청,13183,14288,27471,20201224
20201221,7호선,청담,16376,17885,34261,20201224
20201221,7호선,건대입구,9432,9535,18967,20201224
20201221,7호선,어린이대공원(세종대),9341,9180,18521,20201224
20201221,7호선,군자(능동),11727,9525,21252,20201224
20201221,7호선,중곡,8275,7936,16211,20201224
20201221,7호선,용마산(용마폭포공원),5024,4867,9891,20201224
20201221,7호선,사가정,13782,13875,27657,20201224
20201221,7호선,면목,13162,13182,26344,20201224
20201221,7호선,상봉(시외버스터미널),13805,12934,26739,20201224
20201221,7호선,중화,9137,9103,18240,20201224
20201221,7호선,먹골,8412,8335,16747,20201224
20201221,7호선,태릉입구,6489,6030,12519,20201224
20201221,7호선,공릉(서울과학기술대),9382,9418,18800,20201224
20201221,7호선,하계,14184,13606,27790,20201224
20201221,7호선,중계,11525,10579,22104,20201224
20201221,7호선,노원,15362,16029,31391,20201224
20201221,7호선,마들,10018,9745,19763,20201224
20201221,7호선,수락산,10094,10173,20267,20201224
20201221,7호선,도봉산,7400,8641,16041,20201224
20201221,7호선,장암,1889,661,2550,20201224
20201221,6호선,봉화산(서울의료원),7434,6986,14420,20201224
20201221,6호선,화랑대(서울여대입구),9132,7180,16312,20201224
20201221,6호선,태릉입구,4231,4587,8818,20201224
20201221,6호선,석계,10154,10510,20664,20201224
20201221,6호선,돌곶이,6935,6569,13504,20201224
20201221,6호선,상월곡(한국과학기술연구원),5174,4629,9803,20201224
20201221,6호선,월곡(동덕여대),9092,9156,18248,20201224
20201221,6호선,고려대(종암),6081,6013,12094,20201224
20201221,6호선,안암(고대병원앞),7972,7876,15848,20201224
20201221,6호선,보문,5817,5522,11339,20201224
20201221,6호선,창신,2876,2343,5219,20201224
20201221,6호선,동묘앞,6508,6574,13082,20201224
20201221,6호선,신당,6609,7059,13668,20201224
20201221,6호선,청구,3139,3394,6533,20201224
20201221,6호선,약수,2875,2975,5850,20201224
20201221,6호선,버티고개,1818,1770,3588,20201224
20201221,6호선,한강진,4813,5413,10226,20201224
20201221,6호선,이태원,6247,6325,12572,20201224
20201221,6호선,녹사평(용산구청),3388,3232,6620,20201224
20201221,6호선,삼각지,4162,3709,7871,20201224
20201221,6호선,효창공원앞,5549,5151,10700,20201224
20201221,6호선,공덕,14690,14260,28950,20201224
20201221,6호선,대흥(서강대앞),6114,6299,12413,20201224
20201221,6호선,광흥창(서강),6942,6745,13687,20201224
20201221,6호선,상수,5444,5869,11313,20201224
20201221,6호선,합정,8904,8693,17597,20201224
20201221,6호선,망원,10352,11369,21721,20201224
20201221,6호선,마포구청,11380,10412,21792,20201224
20201221,6호선,월드컵경기장(성산),3332,3485,6817,20201224
20201221,6호선,디지털미디어시티,11512,12430,23942,20201224
20201221,6호선,증산(명지대앞),8319,8288,16607,20201224
20201221,6호선,새절(신사),10639,9929,20568,20201224
20201221,6호선,구산,5921,4709,10630,20201224
20201221,6호선,독바위,2268,2468,4736,20201224
20201221,6호선,불광,3403,3594,6997,20201224
20201221,6호선,역촌,3117,3654,6771,20201224
20201221,6호선,응암,14290,14472,28762,20201224
20201221,5호선,하남풍산,3835,3784,7619,20201224
20201221,5호선,미사,10577,10491,21068,20201224
20201221,5호선,마천,4838,4958,9796,20201224
20201221,5호선,거여,6531,6315,12846,20201224
20201221,5호선,개롱,4907,5238,10145,20201224
20201221,5호선,오금,3118,2958,6076,20201224
20201221,5호선,방이,5390,5569,10959,20201224
20201221,5호선,올림픽공원(한국체대),3385,2962,6347,20201224
20201221,5호선,둔촌동,6711,6818,13529,20201224
20201221,5호선,상일동,12996,11936,24932,20201224
20201221,5호선,고덕,7210,7076,14286,20201224
20201221,5호선,명일,6594,6762,13356,20201224
20201221,5호선,굽은다리(강동구민회관앞),7449,7201,14650,20201224
20201221,5호선,길동,6358,6708,13066,20201224
20201221,5호선,강동,16057,15080,31137,20201224
20201221,5호선,천호(풍납토성),13994,14015,28009,20201224
20201221,5호선,광나루(장신대),10159,9336,19495,20201224
20201221,5호선,아차산(어린이대공원후문),11251,11418,22669,20201224
20201221,5호선,군자(능동),8748,9274,18022,20201224
20201221,5호선,장한평,15150,15208,30358,20201224
20201221,5호선,답십리,13426,12372,25798,20201224
20201221,5호선,마장,4596,4454,9050,20201224
20201221,5호선,왕십리(성동구청),3529,3687,7216,20201224
20201221,5호선,행당,6737,5986,12723,20201224
20201221,5호선,신금호,4836,5157,9993,20201224
20201221,5호선,동대문역사문화공원(DDP),2520,2810,5330,20201224
20201221,5호선,종로3가,7471,7345,14816,20201224
20201221,5호선,광화문(세종문화회관),24265,24982,49247,20201224
20201221,5호선,서대문,15641,15882,31523,20201224
20201221,5호선,충정로(경기대입구),4000,4093,8093,20201224
20201221,5호선,애오개,5399,5545,10944,20201224
20201221,5호선,공덕,11483,12101,23584,20201224
20201221,5호선,마포,11491,11852,23343,20201224
20201221,5호선,여의나루,5969,6138,12107,20201224
20201221,5호선,여의도,21456,22214,43670,20201224
20201221,5호선,신길,3203,3583,6786,20201224
20201221,5호선,영등포시장,7598,7809,15407,20201224
20201221,5호선,영등포구청,3435,3448,6883,20201224
20201221,5호선,양평,6392,6450,12842,20201224
20201221,5호선,오목교(목동운동장앞),17229,18497,35726,20201224
20201221,5호선,목동,13470,15108,28578,20201224
20201221,5호선,신정(은행정),11806,9325,21131,20201224
20201221,5호선,까치산,24101,23402,47503,20201224
20201221,5호선,화곡,23271,21949,45220,20201224
20201221,5호선,우장산,11338,11322,22660,20201224
20201221,5호선,발산,14573,14819,29392,20201224
20201221,5호선,마곡,7654,7501,15155,20201224
20201221,5호선,송정,5519,5907,11426,20201224
20201221,5호선,김포공항,5235,6411,11646,20201224
20201221,5호선,개화산,4327,4328,8655,20201224
20201221,5호선,방화,5380,5227,10607,20201224
20201221,4호선,쌍문,24666,22803,47469,20201224
20201221,4호선,창동,20897,22046,42943,20201224
20201221,4호선,노원,14678,16025,30703,20201224
20201221,4호선,상계,15765,14704,30469,20201224
20201221,4호선,당고개,10488,9768,20256,20201224
20201221,4호선,남태령,904,792,1696,20201224
20201221,4호선,사당,17832,15091,32923,20201224
20201221,4호선,총신대입구(이수),15028,16264,31292,20201224
20201221,4호선,동작(현충원),1891,1957,3848,20201224
20201221,4호선,이촌(국립중앙박물관),5098,5714,10812,20201224
20201221,4호선,신용산,11349,11932,23281,20201224
20201221,4호선,삼각지,3570,3876,7446,20201224
20201221,4호선,숙대입구(갈월),9683,9564,19247,20201224
20201221,4호선,서울역,8548,10746,19294,20201224
20201221,4호선,회현(남대문시장),17726,18492,36218,20201224
20201221,4호선,명동,13468,13901,27369,20201224
20201221,4호선,충무로,21922,22752,44674,20201224
20201221,4호선,동대문역사문화공원(DDP),11444,10769,22213,20201224
20201221,4호선,동대문,16602,17053,33655,20201224
20201221,4호선,혜화,21985,21731,43716,20201224
20201221,4호선,한성대입구(삼선교),10886,10656,21542,20201224
20201221,4호선,성신여대입구(돈암),15164,14630,29794,20201224
20201221,4호선,길음,16277,16063,32340,20201224
20201221,4호선,미아사거리,22674,22212,44886,20201224
20201221,4호선,미아(서울사이버대학),12592,12401,24993,20201224
20201221,4호선,수유(강북구청),28238,28213,56451,20201224
20201221,3호선,오금,5137,4582,9719,20201224
20201221,3호선,경찰병원,6236,6279,12515,20201224
20201221,3호선,수서,12262,12629,24891,20201224
20201221,3호선,일원,8033,7928,15961,20201224
20201221,3호선,대청,7871,7093,14964,20201224
20201221,3호선,학여울,1397,1378,2775,20201224
20201221,3호선,대치,7822,7784,15606,20201224
20201221,3호선,도곡,4407,4551,8958,20201224
20201221,3호선,매봉,10142,9683,19825,20201224
20201221,3호선,양재(서초구청),31201,33648,64849,20201224
20201221,3호선,남부터미널(예술의전당),22681,23619,46300,20201224
20201221,3호선,교대(법원.검찰청),11219,7519,18738,20201224
20201221,3호선,고속터미널,28013,26195,54208,20201224
20201221,3호선,잠원,3663,3719,7382,20201224
20201221,3호선,신사,23832,24855,48687,20201224
20201221,3호선,압구정,25201,26457,51658,20201224
20201221,3호선,옥수,6907,7342,14249,20201224
20201221,3호선,약수,10540,10287,20827,20201224
20201221,3호선,동대입구,5389,5656,11045,20201224
20201221,3호선,을지로3가,8443,8707,17150,20201224
20201221,3호선,종로3가,7817,8908,16725,20201224
20201221,3호선,안국,14227,14480,28707,20201224
20201221,3호선,경복궁(정부서울청사),13350,12935,26285,20201224
20201221,3호선,독립문,5713,5869,11582,20201224
20201221,3호선,무악재,3179,3267,6446,20201224
20201221,3호선,홍제,13981,13651,27632,20201224
20201221,3호선,녹번,12228,11355,23583,20201224
20201221,3호선,불광,13272,14143,27415,20201224
20201221,3호선,연신내,30473,28769,59242,20201224
20201221,3호선,구파발,16754,15701,32455,20201224
20201221,3호선,지축,2657,2681,5338,20201224
20201221,2호선,용두(동대문구청),1937,2049,3986,20201224
20201221,2호선,신정네거리,7973,8312,16285,20201224
20201221,2호선,양천구청,5377,5877,11254,20201224
20201221,2호선,도림천,1257,1321,2578,20201224
20201221,2호선,신설동,2499,2547,5046,20201224
20201221,2호선,신답,1297,1517,2814,20201224
20201221,2호선,용답,2110,2124,4234,20201224
20201221,2호선,충정로(경기대입구),8373,8618,16991,20201224
20201221,2호선,아현,7929,7906,15835,20201224
20201221,2호선,이대,8942,9237,18179,20201224
20201221,2호선,신촌,22678,23692,46370,20201224
20201221,2호선,홍대입구,31958,33059,65017,20201224
20201221,2호선,합정,21217,21768,42985,20201224
20201221,2호선,당산,14776,17128,31904,20201224
20201221,2호선,영등포구청,19291,19421,38712,20201224
20201221,2호선,문래,17314,17699,35013,20201224
20201221,2호선,신도림,38446,36905,75351,20201224
20201221,2호선,대림(구로구청),21142,21232,42374,20201224
20201221,2호선,구로디지털단지,49997,50720,100717,20201224
20201221,2호선,신대방,21621,21296,42917,20201224
20201221,2호선,신림,51020,50033,101053,20201224
20201221,2호선,봉천,19870,18751,38621,20201224
20201221,2호선,서울대입구(관악구청),36401,36116,72517,20201224
20201221,2호선,낙성대(강감찬),21489,21273,42762,20201224
20201221,2호선,사당,26683,26431,53114,20201224
20201221,2호선,방배,13132,13692,26824,20201224
20201221,2호선,서초,17145,16909,34054,20201224
20201221,2호선,교대(법원.검찰청),26942,30030,56972,20201224
20201221,2호선,강남,60721,59102,119823,20201224
20201221,2호선,역삼,40899,44127,85026,20201224
20201221,2호선,선릉,46720,41647,88367,20201224
20201221,2호선,삼성(무역센터),38686,38815,77501,20201224
20201221,2호선,종합운동장,5101,5465,10566,20201224
20201221,2호선,잠실새내,15388,15287,30675,20201224
20201221,2호선,잠실(송파구청),47711,47603,95314,20201224
20201221,2호선,잠실나루,11424,11099,22523,20201224
20201221,2호선,강변(동서울터미널),22703,22557,45260,20201224
20201221,2호선,구의(광진구청),19030,18863,37893,20201224
20201221,2호선,건대입구,24153,25729,49882,20201224
20201221,2호선,성수,27487,29985,57472,20201224
20201221,2호선,뚝섬,16339,17778,34117,20201224
20201221,2호선,한양대,5581,5975,11556,20201224
20201221,2호선,왕십리(성동구청),11659,9261,20920,20201224
20201221,2호선,상왕십리,11038,10920,21958,20201224
20201221,2호선,신당,11287,11719,23006,20201224
20201221,2호선,동대문역사문화공원(DDP),9116,10301,19417,20201224
20201221,2호선,을지로4가,11187,11086,22273,20201224
20201221,2호선,을지로3가,16447,16270,32717,20201224
20201221,2호선,을지로입구,30562,30529,61091,20201224
20201221,2호선,시청,18890,18282,37172,20201224
20201221,1호선,청량리(서울시립대입구),16433,16365,32798,20201224
20201221,1호선,제기동,13791,14244,28035,20201224
20201221,1호선,신설동,11541,11366,22907,20201224
20201221,1호선,동대문,8750,8353,17103,20201224
20201221,1호선,종로5가,17546,17669,35215,20201224
20201221,1호선,종로3가,17830,16106,33936,20201224
20201221,1호선,종각,26922,25973,52895,20201224
20201221,1호선,시청,17149,16826,33975,20201224
20201221,1호선,동묘앞,6162,6295,12457,20201224
20201221,1호선,서울역,30792,28858,59650,20201224
20201221,경원선,보산,1229,1071,2300,20201224
20201221,경원선,동두천중앙,2525,2457,4982,20201224
20201221,경의선,서강대,1596,1536,3132,20201224
20201221,경의선,공덕,2658,2365,5023,20201224
20201221,7호선,반포,4604,4568,9172,20201224
20201222,3호선,녹번,12317,11348,23665,20201225
20201222,7호선,도봉산,7402,8774,16176,20201225
20201222,7호선,장암,1884,712,2596,20201225
20201222,중앙선,지평,34,34,68,20201225
20201222,중앙선,용문,1080,1100,2180,20201225
20201222,중앙선,원덕,204,223,427,20201225
20201222,중앙선,양평,1779,1747,3526,20201225
20201222,중앙선,오빈,198,188,386,20201225
20201222,중앙선,아신,399,361,760,20201225
20201222,중앙선,국수,488,485,973,20201225
20201222,중앙선,신원,160,161,321,20201225
20201222,중앙선,양수,1281,1277,2558,20201225
20201222,중앙선,운길산,447,405,852,20201225
20201222,중앙선,팔당,660,648,1308,20201225
20201222,중앙선,도심,2015,1517,3532,20201225
20201222,중앙선,덕소,4545,4622,9167,20201225
20201222,중앙선,양정,673,535,1208,20201225
20201222,중앙선,도농,7957,7230,15187,20201225
20201222,중앙선,구리,10773,11001,21774,20201225
20201222,중앙선,양원,1318,1306,2624,20201225
20201222,중앙선,망우,6111,5964,12075,20201225
20201222,중앙선,상봉(시외버스터미널),4641,4660,9301,20201225
20201222,중앙선,중랑,4598,4339,8937,20201225
20201222,중앙선,회기,18744,17995,36739,20201225
20201222,장항선,신창(순천향대),797,783,1580,20201225
20201222,장항선,온양온천,2508,2547,5055,20201225
20201222,장항선,배방,715,702,1417,20201225
20201222,장항선,아산,1924,1825,3749,20201225
20201222,장항선,쌍용(나사렛대),1412,1327,2739,20201225
20201222,장항선,봉명,1023,1021,2044,20201225
20201222,일산선,대화,10245,8199,18444,20201225
20201222,일산선,주엽,6605,6702,13307,20201225
20201222,일산선,정발산,5336,5248,10584,20201225
20201222,일산선,마두,5652,5818,11470,20201225
20201222,일산선,백석,8151,5582,13733,20201225
20201222,일산선,대곡,1374,978,2352,20201225
20201222,일산선,화정,13355,13834,27189,20201225
20201222,일산선,원당,8898,8535,17433,20201225
20201222,일산선,삼송,14319,14296,28615,20201225
20201222,일산선,원흥,7375,7166,14541,20201225
20201222,우이신설선,신설동,1803,1729,3532,20201225
20201222,우이신설선,보문,1213,1208,2421,20201225
20201222,우이신설선,성신여대입구(돈암),2344,2420,4764,20201225
20201222,우이신설선,정릉,3467,3348,6815,20201225
20201222,우이신설선,북한산보국문,4549,4589,9138,20201225
20201222,우이신설선,솔샘,4559,4414,8973,20201225
20201222,우이신설선,삼양사거리,1868,1995,3863,20201225
20201222,우이신설선,삼양,1623,1768,3391,20201225
20201222,우이신설선,화계,2720,2443,5163,20201225
20201222,우이신설선,가오리,3246,3224,6470,20201225
20201222,우이신설선,4.19민주묘지,2231,2156,4387,20201225
20201222,우이신설선,솔밭공원,1962,1928,3890,20201225
20201222,우이신설선,북한산우이,2027,1867,3894,20201225
20201222,안산선,수리산,3520,2906,6426,20201225
20201222,안산선,오이도,6525,6274,12799,20201225
20201222,안산선,정왕,7018,7413,14431,20201225
20201222,안산선,신길온천,1313,1219,2532,20201225
20201222,안산선,안산,9927,8861,18788,20201225
20201222,안산선,초지,3620,3620,7240,20201225
20201222,안산선,고잔,6998,6715,13713,20201225
20201222,안산선,중앙,12547,12948,25495,20201225
20201222,안산선,한대앞,6628,6696,13324,20201225
20201222,안산선,상록수,13341,13417,26758,20201225
20201222,안산선,반월,3524,3429,6953,20201225
20201222,안산선,대야미,3884,3582,7466,20201225
20201222,안산선,산본,12370,13212,25582,20201225
20201222,수인선,인천,771,1256,2027,20201225
20201222,수인선,신포,1301,1290,2591,20201225
20201222,수인선,숭의,3296,3046,6342,20201225
20201222,수인선,인하대,4352,4201,8553,20201225
20201222,수인선,송도,1993,1822,3815,20201225
20201222,수인선,연수,3385,3402,6787,20201225
20201222,수인선,원인재,3590,3673,7263,20201225
20201222,수인선,남동인더스파크,2185,2460,4645,20201225
20201222,수인선,호구포,3125,3258,6383,20201225
20201222,수인선,인천논현,4278,4429,8707,20201225
20201222,수인선,소래포구,3657,3438,7095,20201225
20201222,수인선,월곶,1988,1872,3860,20201225
20201222,수인선,달월,79,49,128,20201225
20201222,수인선,사리,2905,2709,5614,20201225
20201222,수인선,야목,169,125,294,20201225
20201222,수인선,어천,436,399,835,20201225
20201222,수인선,오목천,1617,1585,3202,20201225
20201222,수인선,고색,2745,2683,5428,20201225
20201222,분당선,매교,2424,2503,4927,20201225
20201222,분당선,수원시청,9338,9816,19154,20201225
20201222,분당선,매탄권선,3674,3555,7229,20201225
20201222,분당선,망포,11256,10664,21920,20201225
20201222,분당선,영통,6010,6300,12310,20201225
20201222,분당선,청명,3333,3155,6488,20201225
20201222,분당선,상갈,4106,3997,8103,20201225
20201222,분당선,기흥,7134,6939,14073,20201225
20201222,분당선,신갈,3527,3612,7139,20201225
20201222,분당선,구성,3765,3979,7744,20201225
20201222,분당선,죽전,10213,11148,21361,20201225
20201222,분당선,보정,1956,1670,3626,20201225
20201222,분당선,이매,3885,3666,7551,20201225
20201222,분당선,오리,9476,8008,17484,20201225
20201222,분당선,미금,12262,12963,25225,20201225
20201222,분당선,정자,12332,12981,25313,20201225
20201222,분당선,수내,10162,10270,20432,20201225
20201222,분당선,서현,18842,18836,37678,20201225
20201222,분당선,야탑,20179,21317,41496,20201225
20201222,분당선,모란,15981,16056,32037,20201225
20201222,분당선,태평,11091,10837,21928,20201225
20201222,분당선,가천대,5130,5946,11076,20201225
20201222,분당선,선정릉,6559,7108,13667,20201225
20201222,분당선,강남구청,7606,8873,16479,20201225
20201222,분당선,압구정로데오,14152,15221,29373,20201225
20201222,분당선,서울숲,6549,6562,13111,20201225
20201222,분당선,수원,5899,4644,10543,20201225
20201222,분당선,수서,9682,10055,19737,20201225
20201222,분당선,대모산입구,2906,2715,5621,20201225
20201222,분당선,개포동,2877,2984,5861,20201225
20201222,분당선,구룡,1289,1285,2574,20201225
20201222,분당선,도곡,5244,5256,10500,20201225
20201222,분당선,한티,10374,11118,21492,20201225
20201222,분당선,선릉,11263,16448,27711,20201225
20201222,과천선,범계,19686,19141,38827,20201225
20201222,과천선,평촌,14898,14738,29636,20201225
20201222,과천선,인덕원,18939,19783,38722,20201225
20201222,과천선,정부과천청사,7601,7469,15070,20201225
20201222,과천선,과천,4122,3811,7933,20201225
20201222,과천선,대공원,1546,1657,3203,20201225
20201222,과천선,경마공원,824,830,1654,20201225
20201222,과천선,선바위,6873,6129,13002,20201225
20201222,공항철도 1호선,영종,2148,2150,4298,20201225
20201222,공항철도 1호선,인천공항2터미널,1637,1664,3301,20201225
20201222,공항철도 1호선,인천공항1터미널,3031,3526,6557,20201225
20201222,공항철도 1호선,공항화물청사,2110,2329,4439,20201225
20201222,공항철도 1호선,운서,4792,4833,9625,20201225
20201222,공항철도 1호선,청라국제도시,5235,4927,10162,20201225
20201222,공항철도 1호선,검암,5668,5579,11247,20201225
20201222,공항철도 1호선,계양,7480,6981,14461,20201225
20201222,공항철도 1호선,김포공항,6986,4520,11506,20201225
20201222,공항철도 1호선,마곡나루(서울식물원),6070,5663,11733,20201225
20201222,공항철도 1호선,디지털미디어시티,10835,9771,20606,20201225
20201222,공항철도 1호선,홍대입구,5756,5592,11348,20201225
20201222,공항철도 1호선,공덕,1691,2106,3797,20201225
20201222,공항철도 1호선,서울역,4620,4096,8716,20201225
20201222,경춘선,춘천,811,739,1550,20201225
20201222,경춘선,남춘천,1604,1639,3243,20201225
20201222,경춘선,김유정,171,183,354,20201225
20201222,경춘선,강촌,267,284,551,20201225
20201222,경춘선,백양리,124,145,269,20201225
20201222,경춘선,굴봉산,81,79,160,20201225
20201222,경춘선,가평,1105,1071,2176,20201225
20201222,경춘선,상천,168,165,333,20201225
20201222,경춘선,청평,1069,1097,2166,20201225
20201222,경춘선,대성리,390,295,685,20201225
20201222,경춘선,마석,3010,2950,5960,20201225
20201222,경춘선,천마산,1273,1224,2497,20201225
20201222,경춘선,평내호평,4693,4686,9379,20201225
20201222,경춘선,금곡,1288,1188,2476,20201225
20201222,경춘선,사릉,2811,2686,5497,20201225
20201222,경춘선,퇴계원,2937,2709,5646,20201225
20201222,경춘선,별내,2234,2121,4355,20201225
20201222,경춘선,갈매,2477,2175,4652,20201225
20201222,경춘선,신내,1245,1281,2526,20201225
20201222,경인선,도화,3360,3108,6468,20201225
20201222,경인선,중동,7545,7184,14729,20201225
20201222,경인선,온수(성공회대입구),5451,5339,10790,20201225
20201222,경인선,도원,2492,2559,5051,20201225
20201222,경인선,간석,4649,4441,9090,20201225
20201222,경인선,부개,6902,6581,13483,20201225
20201222,경인선,소사,7665,6838,14503,20201225
20201222,경인선,구일,4875,5104,9979,20201225
20201222,경인선,인천,2443,1819,4262,20201225
20201222,경인선,동인천,10955,10447,21402,20201225
20201222,경인선,제물포,7974,7699,15673,20201225
20201222,경인선,주안,14885,13505,28390,20201225
20201222,경인선,동암,12552,12649,25201,20201225
20201222,경인선,백운,5894,5945,11839,20201225
20201222,경인선,부평,22704,23748,46452,20201225
20201222,경인선,송내,22363,22429,44792,20201225
20201222,경인선,부천,26470,26430,52900,20201225
20201222,경인선,역곡,22151,22026,44177,20201225
20201222,경인선,오류동,9760,9344,19104,20201225
20201222,경인선,개봉,17518,18183,35701,20201225
20201222,경의선,임진강,12,5,17,20201225
20201222,경의선,문산,3762,3792,7554,20201225
20201222,경의선,파주,772,584,1356,20201225
20201222,경의선,월롱,1684,1505,3189,20201225
20201222,경의선,금촌,4771,4744,9515,20201225
20201222,경의선,금릉,3437,3347,6784,20201225
20201222,경의선,운정,4855,4654,9509,20201225
20201222,경의선,야당,4697,4508,9205,20201225
20201222,경의선,탄현,5814,5642,11456,20201225
20201222,경의선,일산,7135,7154,14289,20201225
20201222,경의선,풍산,4086,3883,7969,20201225
20201222,경의선,백마,5220,4972,10192,20201225
20201222,경의선,곡산,439,464,903,20201225
20201222,경의선,능곡,2985,2689,5674,20201225
20201222,경의선,행신,6030,6071,12101,20201225
20201222,경의선,강매,2453,2176,4629,20201225
20201222,경의선,화전,1335,1254,2589,20201225
20201222,경의선,수색,1959,1967,3926,20201225
20201222,경의선,디지털미디어시티,1819,1835,3654,20201225
20201222,경의선,가좌,4202,3838,8040,20201225
20201222,경의선,홍대입구,1126,1269,2395,20201225
20201222,경의선,서강대,1572,1458,3030,20201225
20201222,경의선,공덕,2631,2400,5031,20201225
20201222,경의선,효창공원앞,2374,2659,5033,20201225
20201222,경의선,신촌,692,788,1480,20201225
20201222,경의선,서울역,3229,3970,7199,20201225
20201222,경원선,소요산,1975,1703,3678,20201225
20201222,경원선,보산,1118,1005,2123,20201225
20201222,경원선,동두천중앙,2408,2347,4755,20201225
20201222,경원선,지행,4809,4699,9508,20201225
20201222,경원선,덕정,4187,4229,8416,20201225
20201222,경원선,덕계,2164,1947,4111,20201225
20201222,경원선,양주,5856,5580,11436,20201225
20201222,경원선,녹양,3682,3553,7235,20201225
20201222,경원선,가능,5158,4995,10153,20201225
20201222,경원선,의정부,13948,13960,27908,20201225
20201222,경원선,회룡,9959,9853,19812,20201225
20201222,경원선,망월사,5605,5843,11448,20201225
20201222,경원선,도봉산,6386,3846,10232,20201225
20201222,경원선,도봉,4975,4705,9680,20201225
20201222,경원선,방학,7910,7833,15743,20201225
20201222,경원선,녹천,3965,3359,7324,20201225
20201222,경원선,월계,5364,5160,10524,20201225
20201222,경원선,광운대,6371,6098,12469,20201225
20201222,경원선,석계,6580,7566,14146,20201225
20201222,경원선,신이문,7268,6818,14086,20201225
20201222,경원선,외대앞,5872,5795,11667,20201225
20201222,경원선,청량리(서울시립대입구),10220,11239,21459,20201225
20201222,경원선,왕십리(성동구청),10165,11715,21880,20201225
20201222,경원선,응봉,1398,1238,2636,20201225
20201222,9호선,당산,13796,13865,27661,20201225
20201222,9호선,국회의사당,12814,12946,25760,20201225
20201222,9호선,여의도,18654,17891,36545,20201225
20201222,9호선,샛강,4435,4572,9007,20201225
20201222,9호선,노량진,18340,17563,35903,20201225
20201222,9호선,노들,3420,3057,6477,20201225
20201222,9호선,흑석(중앙대입구),6225,6419,12644,20201225
20201222,9호선,동작(현충원),1318,1007,2325,20201225
20201222,9호선,구반포,2039,2102,4141,20201225
20201222,9호선,신반포,2342,2334,4676,20201225
20201222,9호선,고속터미널,8281,10418,18699,20201225
20201222,경원선,옥수,40,24,64,20201225
20201222,경원선,한남,3285,3083,6368,20201225
20201222,경원선,서빙고,1459,1344,2803,20201225
20201222,경원선,이촌(국립중앙박물관),2934,2327,5261,20201225
20201222,경부선,광명,2238,2028,4266,20201225
20201222,경부선,서동탄,1186,996,2182,20201225
20201222,경부선,당정,4943,4711,9654,20201225
20201222,경부선,천안,3443,3519,6962,20201225
20201222,경부선,두정,3836,3863,7699,20201225
20201222,경부선,직산,537,549,1086,20201225
20201222,경부선,성환,2543,2504,5047,20201225
20201222,경부선,평택,8149,8076,16225,20201225
20201222,경부선,지제,2119,2017,4136,20201225
20201222,경부선,서정리,4580,4409,8989,20201225
20201222,경부선,송탄,3148,3029,6177,20201225
20201222,경부선,진위,1260,1135,2395,20201225
20201222,경부선,오산,7210,7333,14543,20201225
20201222,경부선,오산대,2427,2251,4678,20201225
20201222,경부선,세마,1993,1868,3861,20201225
20201222,경부선,병점,10039,9855,19894,20201225
20201222,경부선,세류,2361,2139,4500,20201225
20201222,경부선,독산,14724,15810,30534,20201225
20201222,경부선,수원,23517,25111,48628,20201225
20201222,경부선,화서,5859,5749,11608,20201225
20201222,경부선,성균관대,11149,10892,22041,20201225
20201222,경부선,의왕,7227,7215,14442,20201225
20201222,경부선,군포,6801,6783,13584,20201225
20201222,경부선,금정,21315,22036,43351,20201225
20201222,경부선,명학,7779,7730,15509,20201225
20201222,경부선,안양,16420,16548,32968,20201225
20201222,경부선,관악,5896,5548,11444,20201225
20201222,경부선,석수,8423,7445,15868,20201225
20201222,경부선,금천구청,9697,9630,19327,20201225
20201222,경부선,가산디지털단지,14915,17450,32365,20201225
20201222,경부선,구로,15607,15771,31378,20201225
20201222,경부선,신길,7837,6518,14355,20201225
20201222,경부선,신도림,3326,3301,6627,20201225
20201222,경부선,영등포,28553,29262,57815,20201225
20201222,경부선,대방,10583,10917,21500,20201225
20201222,경부선,노량진,5945,6682,12627,20201225
20201222,경부선,용산,22386,22913,45299,20201225
20201222,경부선,남영,7536,7920,15456,20201225
20201222,경부선,서울역,2937,1003,3940,20201225
20201222,경강선,여주,1136,1183,2319,20201225
20201222,경강선,세종대왕릉,216,174,390,20201225
20201222,경강선,부발,1175,1191,2366,20201225
20201222,경강선,이천,1665,1753,3418,20201225
20201222,경강선,신둔도예촌,860,840,1700,20201225
20201222,경강선,곤지암,1545,1525,3070,20201225
20201222,경강선,초월,2249,2276,4525,20201225
20201222,경강선,경기광주,5512,5261,10773,20201225
20201222,경강선,삼동,1874,1742,3616,20201225
20201222,경강선,이매,766,661,1427,20201225
20201222,경강선,판교,3463,3286,6749,20201225
20201222,9호선2~3단계,중앙보훈병원,8011,7180,15191,20201225
20201222,9호선2~3단계,둔촌오륜,1055,932,1987,20201225
20201222,9호선2~3단계,올림픽공원(한국체대),4137,4256,8393,20201225
20201222,9호선2~3단계,한성백제,1831,1692,3523,20201225
20201222,9호선2~3단계,송파나루,3464,3656,7120,20201225
20201222,9호선2~3단계,석촌,6016,5317,11333,20201225
20201222,9호선2~3단계,석촌고분,4534,4631,9165,20201225
20201222,9호선2~3단계,삼전,5228,5093,10321,20201225
20201222,9호선2~3단계,종합운동장,3243,3223,6466,20201225
20201222,9호선2~3단계,봉은사,11869,11724,23593,20201225
20201222,9호선2~3단계,삼성중앙,5410,5678,11088,20201225
20201222,9호선2~3단계,선정릉,7565,8141,15706,20201225
20201222,9호선2~3단계,언주,8081,8147,16228,20201225
20201222,9호선,신논현,23394,22837,46231,20201225
20201222,9호선,사평,2397,2411,4808,20201225
20201222,9호선,선유도,6353,6135,12488,20201225
20201222,9호선,신목동,3040,2745,5785,20201225
20201222,9호선,염창,13610,13533,27143,20201225
20201222,9호선,등촌,8823,8756,17579,20201225
20201222,9호선,증미,5858,5997,11855,20201225
20201222,9호선,가양,16574,16302,32876,20201225
20201222,9호선,양천향교,7374,7796,15170,20201225
20201222,9호선,마곡나루(서울식물원),8314,8307,16621,20201225
20201222,9호선,신방화,5415,5383,10798,20201225
20201222,9호선,공항시장,2294,2535,4829,20201225
20201222,9호선,김포공항,5060,6980,12040,20201225
20201222,9호선,개화,2073,1451,3524,20201225
20201222,8호선,모란,3417,2505,5922,20201225
20201222,8호선,수진,4218,3786,8004,20201225
20201222,8호선,신흥,3664,3918,7582,20201225
20201222,8호선,단대오거리,8398,8176,16574,20201225
20201222,8호선,남한산성입구(성남법원.검찰청),11274,10483,21757,20201225
20201222,8호선,산성,5537,5646,11183,20201225
20201222,8호선,복정,8542,7347,15889,20201225
20201222,8호선,장지,14176,13985,28161,20201225
20201222,8호선,문정,18274,19249,37523,20201225
20201222,8호선,가락시장,6509,7306,13815,20201225
20201222,8호선,송파,6638,6684,13322,20201225
20201222,8호선,석촌,6185,7017,13202,20201225
20201222,8호선,잠실(송파구청),10951,12268,23219,20201225
20201222,8호선,몽촌토성(평화의문),4422,4547,8969,20201225
20201222,8호선,강동구청,8674,9262,17936,20201225
20201222,8호선,천호(풍납토성),12603,14139,26742,20201225
20201222,8호선,암사,15646,14073,29719,20201225
20201222,7호선,부평구청,9603,8027,17630,20201225
20201222,7호선,굴포천,7092,7481,14573,20201225
20201222,7호선,삼산체육관,3840,3489,7329,20201225
20201222,7호선,상동,9674,10001,19675,20201225
20201222,7호선,부천시청,10059,10111,20170,20201225
20201222,7호선,신중동,11653,11363,23016,20201225
20201222,7호선,춘의,8511,8469,16980,20201225
20201222,7호선,부천종합운동장,3885,3441,7326,20201225
20201222,7호선,까치울,6254,6101,12355,20201225
20201222,7호선,온수(성공회대입구),9359,8619,17978,20201225
20201222,7호선,천왕,9008,8717,17725,20201225
20201222,7호선,광명사거리,18960,18905,37865,20201225
20201222,7호선,철산,17447,17694,35141,20201225
20201222,7호선,가산디지털단지,41069,41367,82436,20201225
20201222,7호선,남구로,14090,14877,28967,20201225
20201222,7호선,대림(구로구청),6310,6277,12587,20201225
20201222,7호선,신풍,9556,9287,18843,20201225
20201222,7호선,보라매,8216,8176,16392,20201225
20201222,7호선,신대방삼거리,13786,13526,27312,20201225
20201222,7호선,장승배기,8113,7983,16096,20201225
20201222,7호선,상도,8524,8349,16873,20201225
20201222,7호선,숭실대입구(살피재),9205,9663,18868,20201225
20201222,7호선,남성,9347,8750,18097,20201225
20201222,7호선,이수,12268,12222,24490,20201225
20201222,7호선,내방,12120,12230,24350,20201225
20201222,7호선,고속터미널,11531,10293,21824,20201225
20201222,7호선,반포,4609,4465,9074,20201225
20201222,7호선,논현,16907,18218,35125,20201225
20201222,7호선,학동,21045,21999,43044,20201225
20201222,7호선,강남구청,13597,14671,28268,20201225
20201222,7호선,청담,16536,18000,34536,20201225
20201222,7호선,뚝섬유원지,5784,5617,11401,20201225
20201222,7호선,건대입구,9644,9804,19448,20201225
20201222,7호선,어린이대공원(세종대),9300,9148,18448,20201225
20201222,7호선,군자(능동),12024,9649,21673,20201225
20201222,7호선,중곡,8474,8015,16489,20201225
20201222,7호선,용마산(용마폭포공원),5083,4828,9911,20201225
20201222,7호선,사가정,13772,13895,27667,20201225
20201222,7호선,면목,13014,12970,25984,20201225
20201222,7호선,상봉(시외버스터미널),14087,13282,27369,20201225
20201222,7호선,중화,9257,9200,18457,20201225
20201222,7호선,먹골,8392,8308,16700,20201225
20201222,7호선,태릉입구,6446,5974,12420,20201225
20201222,7호선,공릉(서울과학기술대),9508,9222,18730,20201225
20201222,7호선,하계,14186,13662,27848,20201225
20201222,7호선,중계,11646,10616,22262,20201225
20201222,7호선,노원,15498,16184,31682,20201225
20201222,7호선,마들,10124,9943,20067,20201225
20201222,7호선,수락산,10412,10531,20943,20201225
20201222,6호선,봉화산(서울의료원),7423,6939,14362,20201225
20201222,6호선,화랑대(서울여대입구),9195,7220,16415,20201225
20201222,6호선,태릉입구,4284,4682,8966,20201225
20201222,6호선,석계,10091,10514,20605,20201225
20201222,6호선,돌곶이,7040,6705,13745,20201225
20201222,6호선,상월곡(한국과학기술연구원),5116,4607,9723,20201225
20201222,6호선,월곡(동덕여대),8992,9066,18058,20201225
20201222,6호선,고려대(종암),6243,6053,12296,20201225
20201222,6호선,안암(고대병원앞),7695,7695,15390,20201225
20201222,6호선,보문,5884,5484,11368,20201225
20201222,6호선,창신,2891,2283,5174,20201225
20201222,6호선,동묘앞,6579,6644,13223,20201225
20201222,6호선,신당,6634,6976,13610,20201225
20201222,6호선,청구,3139,3305,6444,20201225
20201222,6호선,약수,2837,2854,5691,20201225
20201222,6호선,버티고개,1764,1659,3423,20201225
20201222,6호선,한강진,5023,5632,10655,20201225
20201222,6호선,이태원,6364,6423,12787,20201225
20201222,6호선,녹사평(용산구청),3395,3310,6705,20201225
20201222,6호선,삼각지,4257,3849,8106,20201225
20201222,6호선,효창공원앞,5673,5119,10792,20201225
20201222,6호선,공덕,14810,14384,29194,20201225
20201222,6호선,대흥(서강대앞),6007,6205,12212,20201225
20201222,6호선,광흥창(서강),6956,6783,13739,20201225
20201222,6호선,상수,5617,6038,11655,20201225
20201222,6호선,합정,9059,9188,18247,20201225
20201222,6호선,망원,10612,11532,22144,20201225
20201222,6호선,마포구청,11608,10415,22023,20201225
20201222,6호선,월드컵경기장(성산),3479,3614,7093,20201225
20201222,6호선,디지털미디어시티,11351,12426,23777,20201225
20201222,6호선,증산(명지대앞),8198,8198,16396,20201225
20201222,6호선,새절(신사),10413,9869,20282,20201225
20201222,6호선,구산,6059,4838,10897,20201225
20201222,6호선,독바위,2317,2520,4837,20201225
20201222,6호선,불광,3488,3529,7017,20201225
20201222,6호선,역촌,3079,3684,6763,20201225
20201222,6호선,응암,14556,14546,29102,20201225
20201222,5호선,하남풍산,3985,4067,8052,20201225
20201222,5호선,미사,10724,10626,21350,20201225
20201222,5호선,마천,4832,4847,9679,20201225
20201222,5호선,거여,6557,6298,12855,20201225
20201222,5호선,개롱,4864,5227,10091,20201225
20201222,5호선,오금,3088,3059,6147,20201225
20201222,5호선,방이,5386,5556,10942,20201225
20201222,5호선,올림픽공원(한국체대),3471,2936,6407,20201225
20201222,5호선,둔촌동,6866,6720,13586,20201225
20201222,5호선,상일동,13012,11815,24827,20201225
20201222,5호선,고덕,7212,7102,14314,20201225
20201222,5호선,명일,6612,6809,13421,20201225
20201222,5호선,굽은다리(강동구민회관앞),7563,7311,14874,20201225
20201222,5호선,길동,6347,6625,12972,20201225
20201222,5호선,강동,16187,15138,31325,20201225
20201222,5호선,천호(풍납토성),14517,14584,29101,20201225
20201222,5호선,광나루(장신대),10390,9484,19874,20201225
20201222,5호선,아차산(어린이대공원후문),11402,11383,22785,20201225
20201222,5호선,군자(능동),9090,9733,18823,20201225
20201222,5호선,장한평,15329,15324,30653,20201225
20201222,5호선,답십리,13326,12389,25715,20201225
20201222,5호선,마장,4569,4382,8951,20201225
20201222,5호선,왕십리(성동구청),3573,3776,7349,20201225
20201222,5호선,행당,6584,5989,12573,20201225
20201222,5호선,신금호,4959,5223,10182,20201225
20201222,5호선,청구,3295,3132,6427,20201225
20201222,5호선,동대문역사문화공원(DDP),2491,2837,5328,20201225
20201222,5호선,을지로4가,5386,5424,10810,20201225
20201222,5호선,종로3가,7537,7535,15072,20201225
20201222,5호선,광화문(세종문화회관),24242,25171,49413,20201225
20201222,5호선,서대문,15264,15761,31025,20201225
20201222,5호선,충정로(경기대입구),4065,4182,8247,20201225
20201222,5호선,애오개,5492,5680,11172,20201225
20201222,5호선,공덕,11608,12245,23853,20201225
20201222,5호선,마포,11595,12015,23610,20201225
20201222,5호선,여의나루,5907,6053,11960,20201225
20201222,5호선,여의도,21587,22309,43896,20201225
20201222,5호선,신길,3234,3581,6815,20201225
20201222,5호선,영등포시장,7529,7847,15376,20201225
20201222,5호선,영등포구청,3483,3512,6995,20201225
20201222,5호선,오목교(목동운동장앞),17444,18828,36272,20201225
20201222,5호선,목동,13585,15101,28686,20201225
20201222,5호선,신정(은행정),11754,9125,20879,20201225
20201222,5호선,까치산,24249,23433,47682,20201225
20201222,5호선,화곡,23433,22051,45484,20201225
20201222,5호선,우장산,11241,11331,22572,20201225
20201222,5호선,발산,14517,14804,29321,20201225
20201222,5호선,마곡,7735,7507,15242,20201225
20201222,5호선,송정,5479,5130,10609,20201225
20201222,5호선,김포공항,4897,4687,9584,20201225
20201222,5호선,개화산,4281,4143,8424,20201225
20201222,5호선,방화,5294,5020,10314,20201225
20201222,4호선,쌍문,24672,22842,47514,20201225
20201222,4호선,창동,21108,22399,43507,20201225
20201222,4호선,노원,14859,16390,31249,20201225
20201222,4호선,상계,15873,14835,30708,20201225
20201222,4호선,당고개,10292,9371,19663,20201225
20201222,4호선,남태령,911,775,1686,20201225
20201222,4호선,사당,18052,15235,33287,20201225
20201222,4호선,총신대입구(이수),14983,16234,31217,20201225
20201222,4호선,동작(현충원),1994,2131,4125,20201225
20201222,4호선,이촌(국립중앙박물관),5165,5751,10916,20201225
20201222,4호선,신용산,11440,11919,23359,20201225
20201222,4호선,삼각지,3679,3989,7668,20201225
20201222,4호선,숙대입구(갈월),9693,9527,19220,20201225
20201222,4호선,서울역,8704,10993,19697,20201225
20201222,4호선,회현(남대문시장),18583,19307,37890,20201225
20201222,4호선,명동,14121,14488,28609,20201225
20201222,4호선,충무로,22310,22978,45288,20201225
20201222,4호선,동대문역사문화공원(DDP),11680,10901,22581,20201225
20201222,4호선,동대문,16743,17114,33857,20201225
20201222,4호선,혜화,22820,22547,45367,20201225
20201222,4호선,한성대입구(삼선교),10766,10793,21559,20201225
20201222,4호선,성신여대입구(돈암),15202,14613,29815,20201225
20201222,4호선,길음,16187,15956,32143,20201225
20201222,4호선,미아사거리,22938,22622,45560,20201225
20201222,4호선,미아(서울사이버대학),12872,12549,25421,20201225
20201222,4호선,수유(강북구청),28496,28533,57029,20201225
20201222,3호선,오금,5094,4649,9743,20201225
20201222,3호선,경찰병원,6244,6324,12568,20201225
20201222,3호선,가락시장,7405,7256,14661,20201225
20201222,3호선,수서,12453,12745,25198,20201225
20201222,3호선,일원,8074,7783,15857,20201225
20201222,3호선,대청,7908,7264,15172,20201225
20201222,3호선,학여울,1417,1391,2808,20201225
20201222,3호선,대치,7759,7727,15486,20201225
20201222,3호선,도곡,4367,4389,8756,20201225
20201222,3호선,매봉,10280,9861,20141,20201225
20201222,3호선,양재(서초구청),31586,33774,65360,20201225
20201222,3호선,남부터미널(예술의전당),22533,23228,45761,20201225
20201222,3호선,교대(법원.검찰청),11272,7605,18877,20201225
20201222,3호선,고속터미널,28669,27849,56518,20201225
20201222,3호선,잠원,3683,3676,7359,20201225
20201222,3호선,불광,13136,14154,27290,20201225
20201222,3호선,연신내,30732,28891,59623,20201225
20201222,3호선,구파발,16574,15636,32210,20201225
20201222,3호선,지축,2673,2647,5320,20201225
20201222,2호선,용두(동대문구청),2010,2118,4128,20201225
20201222,2호선,신정네거리,8020,8430,16450,20201225
20201222,2호선,양천구청,5308,5642,10950,20201225
20201222,2호선,도림천,1220,1277,2497,20201225
20201222,2호선,신설동,2404,2449,4853,20201225
20201222,2호선,신답,1259,1532,2791,20201225
20201222,2호선,용답,2143,2136,4279,20201225
20201222,2호선,충정로(경기대입구),8158,8412,16570,20201225
20201222,2호선,아현,8133,7824,15957,20201225
20201222,2호선,신촌,22967,23787,46754,20201225
20201222,2호선,홍대입구,33273,34282,67555,20201225
20201222,2호선,합정,22088,22965,45053,20201225
20201222,2호선,당산,15122,17509,32631,20201225
20201222,2호선,영등포구청,19460,19720,39180,20201225
20201222,2호선,문래,17436,17652,35088,20201225
20201222,2호선,신도림,38661,37248,75909,20201225
20201222,2호선,대림(구로구청),20444,20990,41434,20201225
20201222,2호선,구로디지털단지,49747,50439,100186,20201225
20201222,2호선,신대방,21664,21044,42708,20201225
20201222,2호선,신림,51293,49881,101174,20201225
20201222,2호선,봉천,19739,18536,38275,20201225
20201222,2호선,서울대입구(관악구청),37361,36397,73758,20201225
20201222,2호선,낙성대(강감찬),21748,21383,43131,20201225
20201222,2호선,사당,27524,29919,57443,20201225
20201222,2호선,방배,13200,13733,26933,20201225
20201222,2호선,서초,17192,16997,34189,20201225
20201222,2호선,교대(법원.검찰청),27393,30217,57610,20201225
20201222,2호선,강남,61221,60122,121343,20201225
20201222,2호선,역삼,40853,44289,85142,20201225
20201222,2호선,선릉,46547,41699,88246,20201225
20201222,2호선,삼성(무역센터),39083,39234,78317,20201225
20201222,2호선,종합운동장,5164,5445,10609,20201225
20201222,2호선,잠실새내,15410,15272,30682,20201225
20201222,2호선,잠실(송파구청),48777,48549,97326,20201225
20201222,2호선,잠실나루,11605,11337,22942,20201225
20201222,2호선,강변(동서울터미널),22409,22062,44471,20201225
20201222,2호선,구의(광진구청),19433,19374,38807,20201225
20201222,2호선,건대입구,24157,26022,50179,20201225
20201222,2호선,성수,27793,30372,58165,20201225
20201222,2호선,뚝섬,16496,17703,34199,20201225
20201222,2호선,한양대,5450,5672,11122,20201225
20201222,2호선,왕십리(성동구청),11869,9590,21459,20201225
20201222,2호선,상왕십리,11047,10872,21919,20201225
20201222,2호선,신당,11159,11433,22592,20201225
20201222,2호선,동대문역사문화공원(DDP),9198,10171,19369,20201225
20201222,2호선,을지로4가,11558,11353,22911,20201225
20201222,2호선,을지로3가,16739,16550,33289,20201225
20201222,2호선,을지로입구,31682,31831,63513,20201225
20201222,2호선,시청,19203,18828,38031,20201225
20201222,1호선,청량리(서울시립대입구),16502,16496,32998,20201225
20201222,1호선,제기동,14344,14671,29015,20201225
20201222,1호선,신설동,11098,10983,22081,20201225
20201222,1호선,동대문,9100,8709,17809,20201225
20201222,1호선,종로5가,18135,18182,36317,20201225
20201222,1호선,종로3가,18108,16372,34480,20201225
20201222,1호선,종각,26530,25616,52146,20201225
20201222,1호선,시청,17516,17253,34769,20201225
20201222,1호선,동묘앞,6270,6418,12688,20201225
20201222,1호선,서울역,30842,29141,59983,20201225
20201222,5호선,양평,6374,6483,12857,20201225
20201222,경원선,동두천,1489,1753,3242,20201225
20201222,2호선,이대,9067,9411,18478,20201225
20201222,3호선,신사,24258,25221,49479,20201225
20201222,3호선,압구정,26153,27452,53605,20201225
20201222,3호선,옥수,6903,7355,14258,20201225
20201222,3호선,금호,6503,6271,12774,20201225
20201222,3호선,약수,10425,10187,20612,20201225
20201222,3호선,동대입구,5437,5747,11184,20201225
20201222,3호선,을지로3가,8357,8818,17175,20201225
20201222,3호선,종로3가,7973,8980,16953,20201225
20201222,3호선,안국,14224,14629,28853,20201225
20201222,3호선,경복궁(정부서울청사),13864,13167,27031,20201225
20201222,3호선,독립문,5811,5975,11786,20201225
20201222,3호선,무악재,3197,3285,6482,20201225
20201222,3호선,홍제,14107,13503,27610,20201225
20201223,2호선,신도림,39220,37811,77031,20201226
20201223,2호선,대림(구로구청),20591,21034,41625,20201226
20201223,2호선,구로디지털단지,49633,50281,99914,20201226
20201223,2호선,신대방,21636,21174,42810,20201226
20201223,2호선,신림,51571,50218,101789,20201226
20201223,2호선,봉천,19659,18506,38165,20201226
20201223,2호선,서울대입구(관악구청),37309,35981,73290,20201226
20201223,중앙선,지평,29,26,55,20201226
20201223,중앙선,용문,1102,1140,2242,20201226
20201223,중앙선,원덕,220,190,410,20201226
20201223,중앙선,양평,1893,1899,3792,20201226
20201223,중앙선,오빈,208,209,417,20201226
20201223,중앙선,아신,375,380,755,20201226
20201223,중앙선,국수,467,472,939,20201226
20201223,중앙선,신원,124,137,261,20201226
20201223,중앙선,양수,1212,1238,2450,20201226
20201223,중앙선,운길산,495,445,940,20201226
20201223,중앙선,팔당,632,590,1222,20201226
20201223,중앙선,도심,1938,1496,3434,20201226
20201223,중앙선,덕소,4469,4540,9009,20201226
20201223,중앙선,양정,640,549,1189,20201226
20201223,중앙선,도농,7829,7248,15077,20201226
20201223,중앙선,구리,10779,10931,21710,20201226
20201223,중앙선,양원,1271,1304,2575,20201226
20201223,중앙선,망우,6157,6088,12245,20201226
20201223,중앙선,상봉(시외버스터미널),4665,4719,9384,20201226
20201223,중앙선,중랑,4510,4347,8857,20201226
20201223,중앙선,회기,18606,17808,36414,20201226
20201223,장항선,신창(순천향대),812,765,1577,20201226
20201223,장항선,온양온천,2532,2635,5167,20201226
20201223,장항선,배방,743,730,1473,20201226
20201223,장항선,아산,2031,1929,3960,20201226
20201223,장항선,쌍용(나사렛대),1379,1300,2679,20201226
20201223,장항선,봉명,1035,1029,2064,20201226
20201223,일산선,대화,10252,8214,18466,20201226
20201223,일산선,주엽,6625,6721,13346,20201226
20201223,일산선,정발산,5331,5334,10665,20201226
20201223,일산선,마두,5762,5925,11687,20201226
20201223,일산선,백석,7930,7997,15927,20201226
20201223,일산선,대곡,1359,1069,2428,20201226
20201223,일산선,화정,12950,13364,26314,20201226
20201223,일산선,원당,8771,8427,17198,20201226
20201223,일산선,삼송,14163,14159,28322,20201226
20201223,일산선,원흥,7395,7021,14416,20201226
20201223,우이신설선,신설동,1877,1819,3696,20201226
20201223,우이신설선,보문,1253,1248,2501,20201226
20201223,우이신설선,성신여대입구(돈암),2285,2505,4790,20201226
20201223,우이신설선,정릉,3492,3423,6915,20201226
20201223,우이신설선,북한산보국문,4689,4604,9293,20201226
20201223,우이신설선,삼양사거리,1879,1942,3821,20201226
20201223,우이신설선,삼양,1632,1831,3463,20201226
20201223,우이신설선,화계,2683,2421,5104,20201226
20201223,우이신설선,가오리,3255,3356,6611,20201226
20201223,우이신설선,4.19민주묘지,2271,2159,4430,20201226
20201223,우이신설선,솔밭공원,1901,1925,3826,20201226
20201223,우이신설선,북한산우이,1924,1735,3659,20201226
20201223,안산선,수리산,3562,2978,6540,20201226
20201223,안산선,오이도,6583,6416,12999,20201226
20201223,안산선,정왕,6147,6590,12737,20201226
20201223,안산선,신길온천,1319,1232,2551,20201226
20201223,안산선,안산,9880,8806,18686,20201226
20201223,안산선,초지,3553,3645,7198,20201226
20201223,안산선,고잔,6856,6570,13426,20201226
20201223,안산선,중앙,12362,12860,25222,20201226
20201223,안산선,한대앞,6664,6639,13303,20201226
20201223,안산선,상록수,13189,13294,26483,20201226
20201223,안산선,반월,3580,3461,7041,20201226
20201223,안산선,대야미,3882,3521,7403,20201226
20201223,안산선,산본,12648,13528,26176,20201226
20201223,수인선,인천,761,1219,1980,20201226
20201223,수인선,신포,1258,1280,2538,20201226
20201223,수인선,숭의,3266,2970,6236,20201226
20201223,수인선,인하대,4394,4146,8540,20201226
20201223,수인선,송도,1953,1804,3757,20201226
20201223,수인선,연수,3303,3223,6526,20201226
20201223,수인선,원인재,3523,3579,7102,20201226
20201223,수인선,남동인더스파크,2137,2361,4498,20201226
20201223,수인선,호구포,3062,3225,6287,20201226
20201223,수인선,인천논현,4178,4406,8584,20201226
20201223,수인선,소래포구,3610,3355,6965,20201226
20201223,수인선,월곶,1932,1866,3798,20201226
20201223,수인선,달월,77,52,129,20201226
20201223,수인선,사리,2795,2624,5419,20201226
20201223,수인선,야목,157,130,287,20201226
20201223,수인선,어천,428,458,886,20201226
20201223,수인선,오목천,1579,1550,3129,20201226
20201223,수인선,고색,2742,2611,5353,20201226
20201223,분당선,매교,2331,2398,4729,20201226
20201223,분당선,수원시청,9374,10059,19433,20201226
20201223,분당선,매탄권선,3636,3500,7136,20201226
20201223,분당선,망포,10988,10512,21500,20201226
20201223,분당선,영통,6083,6199,12282,20201226
20201223,분당선,청명,3273,3092,6365,20201226
20201223,분당선,상갈,4088,3937,8025,20201226
20201223,분당선,기흥,7218,6909,14127,20201226
20201223,분당선,신갈,3456,3485,6941,20201226
20201223,분당선,구성,3746,3918,7664,20201226
20201223,분당선,죽전,10179,11166,21345,20201226
20201223,분당선,보정,1864,1575,3439,20201226
20201223,분당선,이매,3998,3732,7730,20201226
20201223,분당선,오리,9400,7978,17378,20201226
20201223,분당선,미금,12202,13002,25204,20201226
20201223,분당선,정자,12060,12728,24788,20201226
20201223,분당선,수내,10307,10287,20594,20201226
20201223,분당선,서현,18728,19021,37749,20201226
20201223,분당선,야탑,20225,21143,41368,20201226
20201223,분당선,모란,16008,15973,31981,20201226
20201223,분당선,태평,10999,10774,21773,20201226
20201223,분당선,가천대,5022,5796,10818,20201226
20201223,분당선,선정릉,6536,6953,13489,20201226
20201223,분당선,강남구청,7818,8851,16669,20201226
20201223,분당선,압구정로데오,14243,15256,29499,20201226
20201223,분당선,서울숲,6773,6737,13510,20201226
20201223,분당선,수원,5985,4893,10878,20201226
20201223,분당선,수서,9727,10209,19936,20201226
20201223,분당선,대모산입구,2911,2709,5620,20201226
20201223,분당선,개포동,2868,2988,5856,20201226
20201223,분당선,구룡,1269,1331,2600,20201226
20201223,분당선,도곡,5451,5464,10915,20201226
20201223,분당선,한티,10341,11064,21405,20201226
20201223,분당선,선릉,11315,16427,27742,20201226
20201223,과천선,범계,19888,19437,39325,20201226
20201223,과천선,평촌,14562,14534,29096,20201226
20201223,과천선,인덕원,18788,19615,38403,20201226
20201223,과천선,정부과천청사,7793,7583,15376,20201226
20201223,과천선,과천,4204,3825,8029,20201226
20201223,과천선,대공원,1450,1553,3003,20201226
20201223,과천선,경마공원,905,927,1832,20201226
20201223,과천선,선바위,6681,5936,12617,20201226
20201223,공항철도 1호선,영종,2152,2199,4351,20201226
20201223,공항철도 1호선,인천공항2터미널,1727,1675,3402,20201226
20201223,공항철도 1호선,인천공항1터미널,2948,3188,6136,20201226
20201223,공항철도 1호선,공항화물청사,2187,2323,4510,20201226
20201223,공항철도 1호선,운서,4727,4877,9604,20201226
20201223,공항철도 1호선,청라국제도시,5154,4728,9882,20201226
20201223,공항철도 1호선,검암,5764,5626,11390,20201226
20201223,공항철도 1호선,계양,7378,6871,14249,20201226
20201223,공항철도 1호선,김포공항,7204,4668,11872,20201226
20201223,공항철도 1호선,마곡나루(서울식물원),5584,5387,10971,20201226
20201223,공항철도 1호선,디지털미디어시티,10492,9409,19901,20201226
20201223,공항철도 1호선,홍대입구,5709,5824,11533,20201226
20201223,공항철도 1호선,공덕,1748,2209,3957,20201226
20201223,공항철도 1호선,서울역,4791,4344,9135,20201226
20201223,경춘선,춘천,822,742,1564,20201226
20201223,경춘선,남춘천,1499,1494,2993,20201226
20201223,경춘선,김유정,161,138,299,20201226
20201223,경춘선,강촌,216,218,434,20201226
20201223,경춘선,백양리,149,153,302,20201226
20201223,경춘선,굴봉산,74,76,150,20201226
20201223,경춘선,가평,1013,1083,2096,20201226
20201223,경춘선,상천,173,166,339,20201226
20201223,경춘선,청평,1022,1030,2052,20201226
20201223,경춘선,대성리,295,272,567,20201226
20201223,경춘선,마석,3056,3006,6062,20201226
20201223,경춘선,천마산,1249,1209,2458,20201226
20201223,경춘선,평내호평,4661,4558,9219,20201226
20201223,경춘선,금곡,1214,1092,2306,20201226
20201223,경춘선,사릉,2737,2743,5480,20201226
20201223,경춘선,퇴계원,3007,2825,5832,20201226
20201223,경춘선,별내,2130,2052,4182,20201226
20201223,경춘선,갈매,2542,2216,4758,20201226
20201223,경춘선,신내,1224,1261,2485,20201226
20201223,경인선,도화,3334,3199,6533,20201226
20201223,경인선,중동,7419,7190,14609,20201226
20201223,경인선,온수(성공회대입구),5445,5351,10796,20201226
20201223,경인선,도원,2497,2557,5054,20201226
20201223,경인선,간석,4618,4373,8991,20201226
20201223,경인선,부개,6852,6543,13395,20201226
20201223,경인선,소사,7799,6974,14773,20201226
20201223,경인선,구일,5036,5284,10320,20201226
20201223,경인선,인천,2447,1750,4197,20201226
20201223,경인선,동인천,10745,10292,21037,20201226
20201223,경인선,제물포,7958,7724,15682,20201226
20201223,경인선,주안,14924,13542,28466,20201226
20201223,경인선,동암,12584,12696,25280,20201226
20201223,경인선,백운,5625,5681,11306,20201226
20201223,경인선,부평,22564,24074,46638,20201226
20201223,경인선,송내,22439,22264,44703,20201226
20201223,경인선,부천,26542,26603,53145,20201226
20201223,경인선,역곡,22031,21956,43987,20201226
20201223,경인선,오류동,9973,9488,19461,20201226
20201223,경인선,개봉,17568,18300,35868,20201226
20201223,경의선,임진강,9,5,14,20201226
20201223,경의선,문산,3683,3627,7310,20201226
20201223,경의선,파주,745,592,1337,20201226
20201223,경의선,월롱,1773,1522,3295,20201226
20201223,경의선,금촌,4785,4815,9600,20201226
20201223,경의선,금릉,3362,3299,6661,20201226
20201223,경의선,운정,4813,4646,9459,20201226
20201223,경의선,야당,4653,4403,9056,20201226
20201223,경의선,탄현,5717,5744,11461,20201226
20201223,경의선,일산,7441,7533,14974,20201226
20201223,경의선,풍산,3993,3768,7761,20201226
20201223,경의선,백마,5138,5080,10218,20201226
20201223,경의선,곡산,438,460,898,20201226
20201223,경의선,능곡,2909,2632,5541,20201226
20201223,경의선,행신,6011,6116,12127,20201226
20201223,경의선,강매,2382,2035,4417,20201226
20201223,경의선,화전,1270,1148,2418,20201226
20201223,경의선,수색,1973,2028,4001,20201226
20201223,경의선,디지털미디어시티,1931,1813,3744,20201226
20201223,경의선,가좌,4158,3909,8067,20201226
20201223,경의선,홍대입구,1122,1203,2325,20201226
20201223,경의선,서강대,1580,1454,3034,20201226
20201223,경의선,공덕,2726,2406,5132,20201226
20201223,경의선,효창공원앞,2400,2736,5136,20201226
20201223,경의선,신촌,607,779,1386,20201226
20201223,경의선,서울역,3124,3861,6985,20201226
20201223,경원선,소요산,1905,1553,3458,20201226
20201223,경원선,동두천,1426,1705,3131,20201226
20201223,경원선,보산,1190,1108,2298,20201226
20201223,경원선,동두천중앙,2384,2357,4741,20201226
20201223,경원선,지행,4847,4792,9639,20201226
20201223,경원선,덕정,4138,4088,8226,20201226
20201223,경원선,덕계,2127,1966,4093,20201226
20201223,경원선,양주,5903,5568,11471,20201226
20201223,경원선,녹양,3727,3621,7348,20201226
20201223,경원선,가능,5148,4984,10132,20201226
20201223,경원선,의정부,13998,14290,28288,20201226
20201223,경원선,회룡,9918,9867,19785,20201226
20201223,경원선,망월사,5575,5701,11276,20201226
20201223,경원선,도봉산,6141,3673,9814,20201226
20201223,경원선,도봉,4858,4762,9620,20201226
20201223,경원선,방학,7827,7693,15520,20201226
20201223,경원선,창동,1,0,1,20201226
20201223,경원선,녹천,3888,3388,7276,20201226
20201223,경원선,월계,5238,5148,10386,20201226
20201223,경원선,광운대,6348,5960,12308,20201226
20201223,경원선,석계,6560,7566,14126,20201226
20201223,경원선,신이문,7206,6688,13894,20201226
20201223,경원선,외대앞,5773,5729,11502,20201226
20201223,경원선,청량리(서울시립대입구),10542,11523,22065,20201226
20201223,경원선,왕십리(성동구청),10683,12095,22778,20201226
20201223,경원선,응봉,1387,1210,2597,20201226
20201223,경원선,옥수,43,28,71,20201226
20201223,경원선,한남,3403,3190,6593,20201226
20201223,경원선,서빙고,1508,1349,2857,20201226
20201223,경원선,이촌(국립중앙박물관),2940,2399,5339,20201226
20201223,경부선,광명,2287,2114,4401,20201226
20201223,경부선,서동탄,1216,998,2214,20201226
20201223,경부선,당정,4977,4720,9697,20201226
20201223,경부선,천안,3553,3627,7180,20201226
20201223,경부선,두정,3919,3751,7670,20201226
20201223,경부선,직산,545,556,1101,20201226
20201223,경부선,성환,2487,2531,5018,20201226
20201223,경부선,평택,8309,8274,16583,20201226
20201223,경부선,지제,2157,2071,4228,20201226
20201223,경부선,서정리,4478,4243,8721,20201226
20201223,경부선,송탄,3191,3069,6260,20201226
20201223,경부선,진위,1244,1112,2356,20201226
20201223,경부선,오산,7384,7426,14810,20201226
20201223,경부선,오산대,2375,2222,4597,20201226
20201223,경부선,세마,2007,1847,3854,20201226
20201223,경부선,병점,10188,9996,20184,20201226
20201223,경부선,세류,2304,2120,4424,20201226
20201223,경부선,독산,14802,15467,30269,20201226
20201223,경부선,수원,23986,25309,49295,20201226
20201223,경부선,화서,5843,5621,11464,20201226
20201223,경부선,성균관대,10834,10744,21578,20201226
20201223,경부선,의왕,7181,7152,14333,20201226
20201223,경부선,군포,6693,6744,13437,20201226
20201223,경부선,금정,21146,21609,42755,20201226
20201223,경부선,명학,7652,7685,15337,20201226
20201223,경부선,안양,16363,16722,33085,20201226
20201223,경부선,관악,5968,5456,11424,20201226
20201223,경부선,석수,8358,7317,15675,20201226
20201223,경부선,금천구청,9436,9416,18852,20201226
20201223,경부선,가산디지털단지,14753,17399,32152,20201226
20201223,경부선,구로,15708,16010,31718,20201226
20201223,경부선,신길,7771,6473,14244,20201226
20201223,경부선,신도림,3400,3323,6723,20201226
20201223,경부선,영등포,29222,30116,59338,20201226
20201223,경부선,대방,10576,10820,21396,20201226
20201223,경부선,노량진,6191,6639,12830,20201226
20201223,경부선,용산,23276,24144,47420,20201226
20201223,경부선,남영,7724,8002,15726,20201226
20201223,경부선,서울역,2921,1155,4076,20201226
20201223,경강선,여주,1212,1229,2441,20201226
20201223,경강선,세종대왕릉,177,180,357,20201226
20201223,경강선,부발,1298,1192,2490,20201226
20201223,경강선,이천,1681,1735,3416,20201226
20201223,경강선,신둔도예촌,820,804,1624,20201226
20201223,경강선,곤지암,1565,1501,3066,20201226
20201223,경강선,초월,2317,2231,4548,20201226
20201223,경강선,경기광주,5247,5090,10337,20201226
20201223,경강선,삼동,1812,1704,3516,20201226
20201223,경강선,이매,786,680,1466,20201226
20201223,경강선,판교,3388,3292,6680,20201226
20201223,9호선2~3단계,중앙보훈병원,8055,7137,15192,20201226
20201223,9호선2~3단계,둔촌오륜,1093,976,2069,20201226
20201223,9호선2~3단계,올림픽공원(한국체대),4112,4108,8220,20201226
20201223,9호선2~3단계,한성백제,1881,1698,3579,20201226
20201223,9호선2~3단계,송파나루,3521,3781,7302,20201226
20201223,9호선2~3단계,석촌,5981,5397,11378,20201226
20201223,9호선2~3단계,석촌고분,4572,4669,9241,20201226
20201223,9호선2~3단계,삼전,5394,5155,10549,20201226
20201223,9호선2~3단계,종합운동장,3250,3231,6481,20201226
20201223,9호선2~3단계,봉은사,11802,11849,23651,20201226
20201223,9호선2~3단계,삼성중앙,5452,5610,11062,20201226
20201223,9호선2~3단계,선정릉,7549,8006,15555,20201226
20201223,9호선2~3단계,언주,8093,8154,16247,20201226
20201223,9호선,신논현,23662,22953,46615,20201226
20201223,9호선,사평,2439,2478,4917,20201226
20201223,9호선,고속터미널,8362,10891,19253,20201226
20201223,9호선,신반포,2395,2402,4797,20201226
20201223,9호선,구반포,2109,2186,4295,20201226
20201223,9호선,동작(현충원),1326,1030,2356,20201226
20201223,9호선,흑석(중앙대입구),6054,6275,12329,20201226
20201223,9호선,노들,3588,3133,6721,20201226
20201223,9호선,노량진,18099,17628,35727,20201226
20201223,9호선,샛강,4367,4529,8896,20201226
20201223,9호선,여의도,18501,17730,36231,20201226
20201223,9호선,국회의사당,12735,12605,25340,20201226
20201223,9호선,당산,13855,13728,27583,20201226
20201223,9호선,선유도,6330,6012,12342,20201226
20201223,9호선,신목동,3079,2854,5933,20201226
20201223,9호선,염창,13710,13678,27388,20201226
20201223,9호선,등촌,8800,8756,17556,20201226
20201223,9호선,증미,5894,6023,11917,20201226
20201223,9호선,가양,16257,16020,32277,20201226
20201223,9호선,양천향교,7374,7577,14951,20201226
20201223,9호선,마곡나루(서울식물원),8453,8376,16829,20201226
20201223,9호선,신방화,5356,5297,10653,20201226
20201223,9호선,공항시장,2276,2502,4778,20201226
20201223,9호선,김포공항,5133,7754,12887,20201226
20201223,9호선,개화,2003,1415,3418,20201226
20201223,8호선,모란,3488,2564,6052,20201226
20201223,8호선,수진,4302,3842,8144,20201226
20201223,8호선,신흥,3687,3962,7649,20201226
20201223,8호선,단대오거리,8493,8365,16858,20201226
20201223,8호선,남한산성입구(성남법원.검찰청),11281,10527,21808,20201226
20201223,8호선,산성,5547,5639,11186,20201226
20201223,8호선,복정,8620,7450,16070,20201226
20201223,8호선,장지,14420,14277,28697,20201226
20201223,8호선,문정,18238,19144,37382,20201226
20201223,8호선,가락시장,6718,7411,14129,20201226
20201223,8호선,송파,6612,6697,13309,20201226
20201223,8호선,석촌,6150,6924,13074,20201226
20201223,8호선,잠실(송파구청),11214,12506,23720,20201226
20201223,8호선,몽촌토성(평화의문),4416,4583,8999,20201226
20201223,8호선,강동구청,8785,9111,17896,20201226
20201223,8호선,천호(풍납토성),12817,14366,27183,20201226
20201223,8호선,암사,15742,14194,29936,20201226
20201223,7호선,부평구청,9665,8053,17718,20201226
20201223,7호선,굴포천,6871,7390,14261,20201226
20201223,7호선,삼산체육관,3786,3482,7268,20201226
20201223,7호선,상동,9742,10103,19845,20201226
20201223,7호선,부천시청,10344,10237,20581,20201226
20201223,7호선,신중동,11785,11583,23368,20201226
20201223,7호선,춘의,8617,8508,17125,20201226
20201223,7호선,부천종합운동장,3826,3377,7203,20201226
20201223,7호선,까치울,6247,6167,12414,20201226
20201223,7호선,온수(성공회대입구),9310,8553,17863,20201226
20201223,7호선,천왕,9020,8688,17708,20201226
20201223,7호선,광명사거리,19053,18975,38028,20201226
20201223,7호선,철산,17483,18013,35496,20201226
20201223,7호선,가산디지털단지,40812,40640,81452,20201226
20201223,7호선,남구로,13802,14732,28534,20201226
20201223,7호선,대림(구로구청),6235,6192,12427,20201226
20201223,7호선,신풍,9634,9335,18969,20201226
20201223,7호선,보라매,8263,8258,16521,20201226
20201223,7호선,신대방삼거리,13806,13523,27329,20201226
20201223,7호선,장승배기,8322,8004,16326,20201226
20201223,7호선,상도,8527,8353,16880,20201226
20201223,7호선,숭실대입구(살피재),9421,9537,18958,20201226
20201223,7호선,남성,9585,8899,18484,20201226
20201223,7호선,이수,12437,12112,24549,20201226
20201223,7호선,내방,12270,12327,24597,20201226
20201223,7호선,고속터미널,11496,10348,21844,20201226
20201223,7호선,반포,4711,4508,9219,20201226
20201223,7호선,논현,16804,18003,34807,20201226
20201223,7호선,학동,20655,21769,42424,20201226
20201223,7호선,강남구청,13651,14838,28489,20201226
20201223,7호선,청담,16500,18050,34550,20201226
20201223,7호선,뚝섬유원지,5740,5622,11362,20201226
20201223,7호선,어린이대공원(세종대),9296,9163,18459,20201226
20201223,7호선,군자(능동),11953,9654,21607,20201226
20201223,7호선,중곡,8644,8027,16671,20201226
20201223,7호선,용마산(용마폭포공원),5014,4893,9907,20201226
20201223,7호선,사가정,13852,13967,27819,20201226
20201223,7호선,면목,12863,12845,25708,20201226
20201223,7호선,상봉(시외버스터미널),14131,13442,27573,20201226
20201223,7호선,중화,9205,9136,18341,20201226
20201223,7호선,먹골,8436,8331,16767,20201226
20201223,7호선,태릉입구,6472,5987,12459,20201226
20201223,7호선,공릉(서울과학기술대),9447,9354,18801,20201226
20201223,7호선,하계,14623,14091,28714,20201226
20201223,7호선,중계,11706,10645,22351,20201226
20201223,7호선,노원,15240,16087,31327,20201226
20201223,7호선,마들,10233,9792,20025,20201226
20201223,7호선,수락산,10179,10252,20431,20201226
20201223,7호선,도봉산,7301,8815,16116,20201226
20201223,7호선,장암,1896,704,2600,20201226
20201223,6호선,봉화산(서울의료원),7352,6843,14195,20201226
20201223,6호선,화랑대(서울여대입구),9073,7197,16270,20201226
20201223,6호선,태릉입구,4325,4588,8913,20201226
20201223,6호선,석계,10123,10395,20518,20201226
20201223,6호선,돌곶이,7050,6575,13625,20201226
20201223,6호선,상월곡(한국과학기술연구원),5087,4606,9693,20201226
20201223,6호선,월곡(동덕여대),9076,9153,18229,20201226
20201223,6호선,고려대(종암),6228,6075,12303,20201226
20201223,6호선,안암(고대병원앞),7831,7561,15392,20201226
20201223,6호선,보문,6078,5725,11803,20201226
20201223,6호선,창신,2921,2325,5246,20201226
20201223,6호선,동묘앞,6715,6961,13676,20201226
20201223,6호선,신당,6557,7008,13565,20201226
20201223,6호선,청구,3130,3326,6456,20201226
20201223,6호선,약수,2772,2866,5638,20201226
20201223,6호선,버티고개,1773,1700,3473,20201226
20201223,6호선,한강진,5228,5889,11117,20201226
20201223,6호선,이태원,6539,6669,13208,20201226
20201223,6호선,녹사평(용산구청),3481,3450,6931,20201226
20201223,6호선,삼각지,4325,3729,8054,20201226
20201223,6호선,효창공원앞,5766,5265,11031,20201226
20201223,6호선,공덕,15059,14593,29652,20201226
20201223,6호선,대흥(서강대앞),6105,6358,12463,20201226
20201223,6호선,광흥창(서강),6874,6755,13629,20201226
20201223,6호선,상수,5726,6040,11766,20201226
20201223,6호선,합정,9533,9467,19000,20201226
20201223,6호선,망원,10943,11811,22754,20201226
20201223,2호선,낙성대(강감찬),22101,21457,43558,20201226
20201223,6호선,마포구청,11568,10447,22015,20201226
20201223,6호선,월드컵경기장(성산),3509,3731,7240,20201226
20201223,6호선,디지털미디어시티,11372,12207,23579,20201226
20201223,6호선,증산(명지대앞),8298,8273,16571,20201226
20201223,6호선,새절(신사),10527,9810,20337,20201226
20201223,6호선,구산,6119,4679,10798,20201226
20201223,6호선,독바위,2280,2471,4751,20201226
20201223,6호선,불광,3619,3723,7342,20201226
20201223,6호선,역촌,3124,3699,6823,20201226
20201223,6호선,응암,14591,14702,29293,20201226
20201223,5호선,하남풍산,3894,3845,7739,20201226
20201223,5호선,미사,10727,10702,21429,20201226
20201223,5호선,마천,4860,4883,9743,20201226
20201223,5호선,거여,6367,6151,12518,20201226
20201223,5호선,개롱,5046,5320,10366,20201226
20201223,5호선,오금,3055,3013,6068,20201226
20201223,5호선,방이,5443,5600,11043,20201226
20201223,5호선,올림픽공원(한국체대),3318,2835,6153,20201226
20201223,5호선,둔촌동,6763,6906,13669,20201226
20201223,5호선,상일동,13056,11911,24967,20201226
20201223,5호선,고덕,7469,7251,14720,20201226
20201223,5호선,명일,6603,6726,13329,20201226
20201223,5호선,굽은다리(강동구민회관앞),7607,7339,14946,20201226
20201223,5호선,길동,6392,6630,13022,20201226
20201223,5호선,강동,16051,15050,31101,20201226
20201223,5호선,천호(풍납토성),14818,14798,29616,20201226
20201223,5호선,광나루(장신대),10511,9527,20038,20201226
20201223,5호선,아차산(어린이대공원후문),11691,11658,23349,20201226
20201223,5호선,군자(능동),9031,9794,18825,20201226
20201223,5호선,장한평,15400,15274,30674,20201226
20201223,5호선,답십리,13479,12295,25774,20201226
20201223,5호선,마장,4564,4294,8858,20201226
20201223,5호선,왕십리(성동구청),3647,3922,7569,20201226
20201223,5호선,행당,6654,5952,12606,20201226
20201223,5호선,신금호,4968,5187,10155,20201226
20201223,5호선,청구,3352,3077,6429,20201226
20201223,5호선,동대문역사문화공원(DDP),2486,2816,5302,20201226
20201223,5호선,을지로4가,5361,5385,10746,20201226
20201223,5호선,종로3가,7630,7685,15315,20201226
20201223,5호선,광화문(세종문화회관),24048,24837,48885,20201226
20201223,5호선,서대문,15146,15446,30592,20201226
20201223,5호선,충정로(경기대입구),4006,4062,8068,20201226
20201223,5호선,애오개,5595,5649,11244,20201226
20201223,5호선,공덕,11491,12529,24020,20201226
20201223,5호선,마포,11507,11818,23325,20201226
20201223,5호선,여의나루,6210,6258,12468,20201226
20201223,5호선,여의도,21311,21999,43310,20201226
20201223,5호선,신길,3286,3706,6992,20201226
20201223,5호선,영등포시장,7668,7849,15517,20201226
20201223,5호선,영등포구청,3439,3514,6953,20201226
20201223,5호선,양평,6514,6460,12974,20201226
20201223,5호선,오목교(목동운동장앞),17734,19072,36806,20201226
20201223,5호선,목동,13598,15135,28733,20201226
20201223,5호선,신정(은행정),11717,9401,21118,20201226
20201223,5호선,까치산,24158,23525,47683,20201226
20201223,5호선,화곡,23499,22217,45716,20201226
20201223,5호선,우장산,11615,11548,23163,20201226
20201223,5호선,발산,14780,15108,29888,20201226
20201223,5호선,마곡,7756,7523,15279,20201226
20201223,5호선,송정,5412,5157,10569,20201226
20201223,5호선,김포공항,5239,5074,10313,20201226
20201223,5호선,개화산,4246,4156,8402,20201226
20201223,5호선,방화,5440,5252,10692,20201226
20201223,4호선,쌍문,24740,22935,47675,20201226
20201223,4호선,창동,21077,22320,43397,20201226
20201223,4호선,노원,14980,16687,31667,20201226
20201223,4호선,상계,15994,14891,30885,20201226
20201223,4호선,당고개,10082,9288,19370,20201226
20201223,4호선,남태령,964,1049,2013,20201226
20201223,4호선,사당,18303,15254,33557,20201226
20201223,4호선,총신대입구(이수),15060,16377,31437,20201226
20201223,4호선,동작(현충원),1878,2050,3928,20201226
20201223,4호선,이촌(국립중앙박물관),5142,5687,10829,20201226
20201223,4호선,신용산,11675,12341,24016,20201226
20201223,4호선,삼각지,3592,3988,7580,20201226
20201223,4호선,숙대입구(갈월),9798,9625,19423,20201226
20201223,4호선,서울역,8416,11231,19647,20201226
20201223,4호선,회현(남대문시장),18742,19623,38365,20201226
20201223,2호선,사당,27316,29996,57312,20201226
20201223,4호선,명동,14034,14534,28568,20201226
20201223,4호선,충무로,22388,23079,45467,20201226
20201223,4호선,동대문역사문화공원(DDP),11759,10996,22755,20201226
20201223,4호선,동대문,16862,17137,33999,20201226
20201223,4호선,혜화,23147,22736,45883,20201226
20201223,4호선,한성대입구(삼선교),10776,10518,21294,20201226
20201223,4호선,성신여대입구(돈암),15309,14606,29915,20201226
20201223,4호선,길음,16288,15963,32251,20201226
20201223,4호선,미아사거리,23082,22925,46007,20201226
20201223,4호선,미아(서울사이버대학),13055,12586,25641,20201226
20201223,4호선,수유(강북구청),28525,28425,56950,20201226
20201223,3호선,오금,5018,4499,9517,20201226
20201223,3호선,경찰병원,6249,6239,12488,20201226
20201223,3호선,가락시장,7187,7110,14297,20201226
20201223,3호선,수서,12234,12831,25065,20201226
20201223,3호선,일원,8020,7764,15784,20201226
20201223,3호선,대청,7814,7248,15062,20201226
20201223,3호선,학여울,1337,1366,2703,20201226
20201223,3호선,대치,7465,7396,14861,20201226
20201223,3호선,도곡,4360,4412,8772,20201226
20201223,3호선,매봉,10289,9811,20100,20201226
20201223,3호선,양재(서초구청),31542,33570,65112,20201226
20201223,3호선,남부터미널(예술의전당),22707,23565,46272,20201226
20201223,3호선,교대(법원.검찰청),11187,7473,18660,20201226
20201223,3호선,고속터미널,30057,29802,59859,20201226
20201223,3호선,잠원,3617,3631,7248,20201226
20201223,3호선,신사,24011,24956,48967,20201226
20201223,3호선,압구정,26328,27340,53668,20201226
20201223,3호선,옥수,6923,7436,14359,20201226
20201223,3호선,금호,6547,6317,12864,20201226
20201223,3호선,약수,10251,10095,20346,20201226
20201223,3호선,동대입구,5543,5727,11270,20201226
20201223,3호선,을지로3가,8552,8855,17407,20201226
20201223,3호선,종로3가,8036,9061,17097,20201226
20201223,3호선,안국,14330,14760,29090,20201226
20201223,3호선,경복궁(정부서울청사),13807,13395,27202,20201226
20201223,3호선,독립문,5926,5975,11901,20201226
20201223,3호선,무악재,3246,3234,6480,20201226
20201223,3호선,홍제,14151,13638,27789,20201226
20201223,3호선,녹번,12287,11396,23683,20201226
20201223,3호선,불광,13251,14145,27396,20201226
20201223,3호선,연신내,30718,29133,59851,20201226
20201223,3호선,구파발,16615,15736,32351,20201226
20201223,3호선,지축,2696,2634,5330,20201226
20201223,2호선,용두(동대문구청),2041,2167,4208,20201226
20201223,2호선,신정네거리,7787,8103,15890,20201226
20201223,2호선,양천구청,5230,5667,10897,20201226
20201223,2호선,도림천,1214,1299,2513,20201226
20201223,2호선,방배,13073,13710,26783,20201226
20201223,2호선,서초,17130,16904,34034,20201226
20201223,2호선,교대(법원.검찰청),27175,30061,57236,20201226
20201223,2호선,강남,60452,59007,119459,20201226
20201223,우이신설선,솔샘,4556,4327,8883,20201226
20201223,1호선,서울역,31054,29320,60374,20201226
20201223,1호선,동묘앞,6244,6404,12648,20201226
20201223,1호선,시청,17327,17014,34341,20201226
20201223,1호선,종각,26446,25313,51759,20201226
20201223,1호선,종로3가,18248,16573,34821,20201226
20201223,1호선,종로5가,17845,17726,35571,20201226
20201223,1호선,동대문,9200,8675,17875,20201226
20201223,1호선,신설동,11492,11491,22983,20201226
20201223,1호선,제기동,14194,14627,28821,20201226
20201223,1호선,청량리(서울시립대입구),16456,16281,32737,20201226
20201223,2호선,시청,19113,18514,37627,20201226
20201223,2호선,을지로입구,31773,32157,63930,20201226
20201223,2호선,을지로3가,16794,16788,33582,20201226
20201223,2호선,을지로4가,11363,11193,22556,20201226
20201223,2호선,동대문역사문화공원(DDP),9361,10358,19719,20201226
20201223,2호선,신당,11215,11497,22712,20201226
20201223,2호선,상왕십리,11244,10995,22239,20201226
20201223,2호선,왕십리(성동구청),12092,9844,21936,20201226
20201223,2호선,한양대,5422,5599,11021,20201226
20201223,2호선,뚝섬,16502,17750,34252,20201226
20201223,2호선,성수,28172,30888,59060,20201226
20201223,2호선,건대입구,24589,26400,50989,20201226
20201223,2호선,구의(광진구청),19490,19252,38742,20201226
20201223,2호선,강변(동서울터미널),22789,22834,45623,20201226
20201223,2호선,잠실나루,11355,11086,22441,20201226
20201223,2호선,잠실(송파구청),49240,48977,98217,20201226
20201223,2호선,잠실새내,15530,15331,30861,20201226
20201223,2호선,종합운동장,5290,5542,10832,20201226
20201223,2호선,삼성(무역센터),38813,39322,78135,20201226
20201223,2호선,선릉,46047,41296,87343,20201226
20201223,2호선,역삼,40509,43464,83973,20201226
20201223,2호선,신답,1295,1485,2780,20201226
20201223,7호선,건대입구,9954,9910,19864,20201226
20201223,2호선,신설동,2589,2572,5161,20201226
20201223,2호선,용답,2190,2105,4295,20201226
20201223,2호선,충정로(경기대입구),8266,8536,16802,20201226
20201223,2호선,아현,8097,7785,15882,20201226
20201223,2호선,이대,9088,9355,18443,20201226
20201223,2호선,신촌,23252,23996,47248,20201226
20201223,2호선,홍대입구,33789,35142,68931,20201226
20201223,2호선,합정,22356,23164,45520,20201226
20201223,2호선,당산,15096,17480,32576,20201226
20201223,2호선,영등포구청,19581,19776,39357,20201226
20201223,2호선,문래,17251,17465,34716,20201226
20201224,경의선,서강대,1640,1484,3124,20201227
20201224,중앙선,지평,25,22,47,20201227
20201224,중앙선,용문,1022,1152,2174,20201227
20201224,중앙선,원덕,208,223,431,20201227
20201224,중앙선,양평,1795,1817,3612,20201227
20201224,중앙선,오빈,201,214,415,20201227
20201224,중앙선,아신,351,378,729,20201227
20201224,중앙선,국수,450,491,941,20201227
20201224,중앙선,신원,131,141,272,20201227
20201224,중앙선,양수,1185,1244,2429,20201227
20201224,중앙선,운길산,481,434,915,20201227
20201224,중앙선,팔당,578,648,1226,20201227
20201224,중앙선,도심,1814,1423,3237,20201227
20201224,중앙선,덕소,4278,4365,8643,20201227
20201224,중앙선,양정,605,547,1152,20201227
20201224,중앙선,도농,7680,7126,14806,20201227
20201224,중앙선,구리,10607,10893,21500,20201227
20201224,중앙선,양원,1126,1073,2199,20201227
20201224,중앙선,망우,6242,6104,12346,20201227
20201224,중앙선,상봉(시외버스터미널),4737,4765,9502,20201227
20201224,중앙선,중랑,4622,4420,9042,20201227
20201224,중앙선,회기,19066,17946,37012,20201227
20201224,장항선,신창(순천향대),1027,898,1925,20201227
20201224,장항선,온양온천,3137,3187,6324,20201227
20201224,장항선,배방,906,818,1724,20201227
20201224,장항선,아산,2330,2476,4806,20201227
20201224,장항선,쌍용(나사렛대),1478,1341,2819,20201227
20201224,장항선,봉명,1032,965,1997,20201227
20201224,일산선,대화,9990,8429,18419,20201227
20201224,일산선,주엽,6561,6808,13369,20201227
20201224,일산선,정발산,5436,5526,10962,20201227
20201224,일산선,마두,5739,5959,11698,20201227
20201224,일산선,백석,8436,8759,17195,20201227
20201224,일산선,대곡,1331,982,2313,20201227
20201224,일산선,화정,13138,13657,26795,20201227
20201224,일산선,원당,8667,8333,17000,20201227
20201224,일산선,삼송,14426,14633,29059,20201227
20201224,일산선,원흥,7278,6972,14250,20201227
20201224,우이신설선,신설동,1837,1721,3558,20201227
20201224,우이신설선,보문,1285,1284,2569,20201227
20201224,우이신설선,성신여대입구(돈암),2469,2670,5139,20201227
20201224,우이신설선,정릉,3628,3495,7123,20201227
20201224,우이신설선,북한산보국문,4650,4462,9112,20201227
20201224,우이신설선,솔샘,4516,4167,8683,20201227
20201224,우이신설선,삼양사거리,1977,2000,3977,20201227
20201224,우이신설선,삼양,1639,1874,3513,20201227
20201224,우이신설선,화계,2776,2463,5239,20201227
20201224,우이신설선,가오리,3241,3219,6460,20201227
20201224,우이신설선,4.19민주묘지,2216,2133,4349,20201227
20201224,우이신설선,솔밭공원,1908,1905,3813,20201227
20201224,우이신설선,북한산우이,1868,1647,3515,20201227
20201224,안산선,수리산,3454,2713,6167,20201227
20201224,안산선,오이도,6775,6784,13559,20201227
20201224,안산선,정왕,6232,6597,12829,20201227
20201224,안산선,신길온천,1315,1255,2570,20201227
20201224,안산선,안산,10222,9234,19456,20201227
20201224,안산선,초지,3544,3512,7056,20201227
20201224,안산선,고잔,6738,6607,13345,20201227
20201224,안산선,중앙,12721,13584,26305,20201227
20201224,안산선,한대앞,6597,6641,13238,20201227
20201224,안산선,상록수,13215,13330,26545,20201227
20201224,안산선,반월,3511,3337,6848,20201227
20201224,안산선,대야미,4031,3514,7545,20201227
20201224,안산선,산본,12392,13576,25968,20201227
20201224,수인선,인천,846,1353,2199,20201227
20201224,수인선,신포,1288,1380,2668,20201227
20201224,수인선,숭의,3231,3010,6241,20201227
20201224,수인선,인하대,4401,4169,8570,20201227
20201224,수인선,송도,1973,1754,3727,20201227
20201224,수인선,연수,3339,3327,6666,20201227
20201224,수인선,원인재,3525,3595,7120,20201227
20201224,수인선,남동인더스파크,2051,2242,4293,20201227
20201224,수인선,호구포,3156,3235,6391,20201227
20201224,수인선,인천논현,4233,4520,8753,20201227
20201224,수인선,소래포구,3592,3584,7176,20201227
20201224,수인선,월곶,2053,1949,4002,20201227
20201224,수인선,달월,79,48,127,20201227
20201224,수인선,사리,2740,2590,5330,20201227
20201224,수인선,야목,157,137,294,20201227
20201224,수인선,어천,505,426,931,20201227
20201224,수인선,오목천,1639,1531,3170,20201227
20201224,수인선,고색,2776,2565,5341,20201227
20201224,분당선,매교,2250,2259,4509,20201227
20201224,분당선,수원시청,9647,10858,20505,20201227
20201224,분당선,매탄권선,3874,3621,7495,20201227
20201224,분당선,망포,11772,10861,22633,20201227
20201224,분당선,영통,6191,6510,12701,20201227
20201224,분당선,청명,3141,3001,6142,20201227
20201224,분당선,상갈,4054,3916,7970,20201227
20201224,분당선,기흥,7300,7171,14471,20201227
20201224,분당선,신갈,3344,3405,6749,20201227
20201224,분당선,구성,3639,3946,7585,20201227
20201224,분당선,죽전,10927,11719,22646,20201227
20201224,분당선,보정,1745,1499,3244,20201227
20201224,분당선,이매,3747,3612,7359,20201227
20201224,분당선,오리,9411,7861,17272,20201227
20201224,분당선,미금,12028,12913,24941,20201227
20201224,분당선,정자,11930,12589,24519,20201227
20201224,분당선,수내,10092,10093,20185,20201227
20201224,분당선,서현,19327,19640,38967,20201227
20201224,분당선,야탑,19999,21168,41167,20201227
20201224,분당선,모란,17850,17941,35791,20201227
20201224,분당선,태평,11162,11004,22166,20201227
20201224,분당선,가천대,5022,5592,10614,20201227
20201224,분당선,선정릉,6200,6685,12885,20201227
20201224,분당선,강남구청,7365,8361,15726,20201227
20201224,분당선,압구정로데오,15161,15932,31093,20201227
20201224,분당선,서울숲,6664,6523,13187,20201227
20201224,분당선,수원,6304,5365,11669,20201227
20201224,분당선,수서,9427,10337,19764,20201227
20201224,분당선,대모산입구,2842,2623,5465,20201227
20201224,분당선,개포동,2876,3014,5890,20201227
20201224,분당선,구룡,1305,1215,2520,20201227
20201224,분당선,도곡,5257,5219,10476,20201227
20201224,분당선,한티,10292,10734,21026,20201227
20201224,분당선,선릉,10433,14839,25272,20201227
20201224,과천선,범계,19837,19677,39514,20201227
20201224,과천선,평촌,14151,14285,28436,20201227
20201224,과천선,인덕원,18499,18989,37488,20201227
20201224,과천선,정부과천청사,6861,6952,13813,20201227
20201224,과천선,과천,3984,3586,7570,20201227
20201224,과천선,대공원,1478,1533,3011,20201227
20201224,과천선,경마공원,918,906,1824,20201227
20201224,과천선,선바위,6572,5783,12355,20201227
20201224,공항철도 1호선,영종,2181,2379,4560,20201227
20201224,공항철도 1호선,인천공항2터미널,1696,1591,3287,20201227
20201224,공항철도 1호선,인천공항1터미널,3047,3391,6438,20201227
20201224,공항철도 1호선,공항화물청사,2026,2269,4295,20201227
20201224,공항철도 1호선,운서,4943,5092,10035,20201227
20201224,공항철도 1호선,청라국제도시,4929,4650,9579,20201227
20201224,공항철도 1호선,검암,5604,5580,11184,20201227
20201224,공항철도 1호선,계양,7305,6898,14203,20201227
20201224,공항철도 1호선,김포공항,8501,5321,13822,20201227
20201224,공항철도 1호선,마곡나루(서울식물원),5323,5110,10433,20201227
20201224,공항철도 1호선,디지털미디어시티,10231,9105,19336,20201227
20201224,공항철도 1호선,홍대입구,6299,6487,12786,20201227
20201224,공항철도 1호선,공덕,1696,2170,3866,20201227
20201224,공항철도 1호선,서울역,5365,4979,10344,20201227
20201224,경춘선,춘천,906,837,1743,20201227
20201224,경춘선,남춘천,1691,1914,3605,20201227
20201224,경춘선,김유정,144,175,319,20201227
20201224,경춘선,강촌,241,272,513,20201227
20201224,경춘선,백양리,111,61,172,20201227
20201224,경춘선,굴봉산,69,71,140,20201227
20201224,경춘선,가평,1110,1251,2361,20201227
20201224,경춘선,상천,138,173,311,20201227
20201224,경춘선,청평,1082,1195,2277,20201227
20201224,경춘선,대성리,352,330,682,20201227
20201224,경춘선,마석,2958,2884,5842,20201227
20201224,경춘선,천마산,1256,1170,2426,20201227
20201224,경춘선,평내호평,4513,4689,9202,20201227
20201224,경춘선,금곡,1194,1103,2297,20201227
20201224,경춘선,사릉,2692,2645,5337,20201227
20201224,경춘선,퇴계원,2864,2674,5538,20201227
20201224,경춘선,별내,2205,2198,4403,20201227
20201224,경춘선,갈매,2483,2229,4712,20201227
20201224,경춘선,신내,1194,1166,2360,20201227
20201224,경인선,도화,3288,3046,6334,20201227
20201224,경인선,중동,7422,7069,14491,20201227
20201224,경인선,온수(성공회대입구),5414,5150,10564,20201227
20201224,경인선,도원,2260,2355,4615,20201227
20201224,경인선,간석,4607,4426,9033,20201227
20201224,경인선,부개,6965,6587,13552,20201227
20201224,경인선,소사,7593,6761,14354,20201227
20201224,경인선,구일,5105,5318,10423,20201227
20201224,경인선,인천,2573,2012,4585,20201227
20201224,경인선,동인천,11073,10595,21668,20201227
20201224,경인선,제물포,7792,7502,15294,20201227
20201224,경인선,주안,15052,13952,29004,20201227
20201224,경인선,동암,12651,12908,25559,20201227
20201224,경인선,백운,5797,5637,11434,20201227
20201224,경인선,부평,24156,26103,50259,20201227
20201224,경인선,송내,21950,21849,43799,20201227
20201224,경인선,부천,27157,28050,55207,20201227
20201224,경인선,역곡,21928,22104,44032,20201227
20201224,경인선,오류동,9826,9556,19382,20201227
20201224,경인선,개봉,17526,18515,36041,20201227
20201224,경의선,임진강,9,10,19,20201227
20201224,경의선,문산,3837,3917,7754,20201227
20201224,경의선,파주,906,632,1538,20201227
20201224,경의선,월롱,1856,1503,3359,20201227
20201224,경의선,금촌,4934,4873,9807,20201227
20201224,경의선,금릉,3462,3363,6825,20201227
20201224,경의선,운정,4520,4505,9025,20201227
20201224,경의선,야당,4465,4396,8861,20201227
20201224,경의선,탄현,5725,5722,11447,20201227
20201224,경의선,일산,6792,7001,13793,20201227
20201224,경의선,풍산,4160,4000,8160,20201227
20201224,경의선,백마,5070,4890,9960,20201227
20201224,경의선,곡산,405,460,865,20201227
20201224,경의선,능곡,2838,2571,5409,20201227
20201224,경의선,행신,5932,6101,12033,20201227
20201224,경의선,강매,2359,2003,4362,20201227
20201224,경의선,화전,1373,1160,2533,20201227
20201224,경의선,수색,1913,1918,3831,20201227
20201224,경의선,디지털미디어시티,1955,1965,3920,20201227
20201224,경의선,가좌,4191,3957,8148,20201227
20201224,경의선,홍대입구,1196,1341,2537,20201227
20201224,경의선,공덕,2671,2405,5076,20201227
20201224,경의선,효창공원앞,2284,2686,4970,20201227
20201224,경의선,신촌,628,799,1427,20201227
20201224,경의선,서울역,3150,3890,7040,20201227
20201224,경원선,소요산,2034,1810,3844,20201227
20201224,경원선,동두천,1530,1741,3271,20201227
20201224,경원선,보산,1206,1227,2433,20201227
20201224,경원선,동두천중앙,2406,2389,4795,20201227
20201224,경원선,지행,5041,5056,10097,20201227
20201224,경원선,덕정,4235,4175,8410,20201227
20201224,경원선,양주,5870,5557,11427,20201227
20201224,경원선,녹양,3617,3504,7121,20201227
20201224,경원선,가능,5199,4987,10186,20201227
20201224,경원선,의정부,14911,15569,30480,20201227
20201224,경원선,회룡,9828,9904,19732,20201227
20201224,경원선,망월사,5908,6061,11969,20201227
20201224,경원선,도봉산,6208,3680,9888,20201227
20201224,경원선,도봉,4967,4705,9672,20201227
20201224,경원선,방학,7878,7841,15719,20201227
20201224,경원선,녹천,3828,3195,7023,20201227
20201224,경원선,월계,5050,4818,9868,20201227
20201224,경원선,광운대,6526,6307,12833,20201227
20201224,경원선,석계,6707,7589,14296,20201227
20201224,경원선,신이문,7310,6768,14078,20201227
20201224,경원선,외대앞,5999,5960,11959,20201227
20201224,경원선,청량리(서울시립대입구),11447,12700,24147,20201227
20201224,경원선,왕십리(성동구청),11458,13517,24975,20201227
20201224,경원선,응봉,1358,1131,2489,20201227
20201224,경원선,옥수,31,23,54,20201227
20201224,경원선,한남,3541,3250,6791,20201227
20201224,경원선,서빙고,1509,1351,2860,20201227
20201224,경원선,이촌(국립중앙박물관),2919,2287,5206,20201227
20201224,경부선,광명,2336,2221,4557,20201227
20201224,경부선,서동탄,1176,1040,2216,20201227
20201224,경부선,당정,4712,4554,9266,20201227
20201224,경부선,천안,4214,4466,8680,20201227
20201224,경부선,두정,4293,4288,8581,20201227
20201224,경부선,직산,603,566,1169,20201227
20201224,경부선,성환,2819,2639,5458,20201227
20201224,경부선,평택,9451,9241,18692,20201227
20201224,경부선,지제,2462,2302,4764,20201227
20201224,경부선,서정리,5310,4543,9853,20201227
20201224,경부선,송탄,3511,3292,6803,20201227
20201224,경부선,진위,1423,1184,2607,20201227
20201224,경부선,오산,7998,7745,15743,20201227
20201224,경부선,오산대,2453,2285,4738,20201227
20201224,경부선,세마,2033,1837,3870,20201227
20201224,경부선,병점,10896,10474,21370,20201227
20201224,경부선,세류,2441,2344,4785,20201227
20201224,경부선,독산,14128,14926,29054,20201227
20201224,경부선,수원,26541,29073,55614,20201227
20201224,경부선,화서,5647,5579,11226,20201227
20201224,경부선,성균관대,10827,10546,21373,20201227
20201224,경부선,의왕,7101,6922,14023,20201227
20201224,경부선,군포,6565,6542,13107,20201227
20201224,경부선,금정,20835,21202,42037,20201227
20201224,경부선,명학,7469,7281,14750,20201227
20201224,경부선,안양,16669,17042,33711,20201227
20201224,경부선,관악,5755,5257,11012,20201227
20201224,경부선,석수,8302,7149,15451,20201227
20201224,경부선,금천구청,9615,9701,19316,20201227
20201224,경부선,가산디지털단지,14192,16668,30860,20201227
20201224,경부선,구로,16147,15971,32118,20201227
20201224,경부선,신길,7755,6384,14139,20201227
20201224,경부선,신도림,3286,3218,6504,20201227
20201224,경부선,영등포,33091,34938,68029,20201227
20201224,경부선,대방,10343,10518,20861,20201227
20201224,경부선,노량진,7319,7580,14899,20201227
20201224,경부선,용산,26060,27143,53203,20201227
20201224,경부선,남영,7460,7703,15163,20201227
20201224,경부선,서울역,3345,1344,4689,20201227
20201224,경강선,여주,1178,1377,2555,20201227
20201224,경강선,세종대왕릉,200,193,393,20201227
20201224,경강선,부발,1835,1237,3072,20201227
20201224,경강선,이천,1840,1930,3770,20201227
20201224,경강선,신둔도예촌,895,872,1767,20201227
20201224,경강선,곤지암,1705,1584,3289,20201227
20201224,경강선,초월,2351,2267,4618,20201227
20201224,경강선,경기광주,5457,5259,10716,20201227
20201224,경강선,삼동,1812,1719,3531,20201227
20201224,경강선,이매,716,664,1380,20201227
20201224,경강선,판교,3571,3405,6976,20201227
20201224,9호선2~3단계,중앙보훈병원,7448,6553,14001,20201227
20201224,9호선2~3단계,둔촌오륜,1024,868,1892,20201227
20201224,9호선2~3단계,올림픽공원(한국체대),4062,4050,8112,20201227
20201224,9호선2~3단계,한성백제,1823,1672,3495,20201227
20201224,9호선2~3단계,송파나루,3626,3868,7494,20201227
20201224,9호선2~3단계,석촌,6112,5322,11434,20201227
20201224,9호선2~3단계,석촌고분,4554,4556,9110,20201227
20201224,9호선2~3단계,삼전,5274,5165,10439,20201227
20201224,9호선2~3단계,종합운동장,3238,3155,6393,20201227
20201224,9호선2~3단계,봉은사,11518,11312,22830,20201227
20201224,9호선2~3단계,삼성중앙,5235,5152,10387,20201227
20201224,9호선2~3단계,선정릉,7269,7540,14809,20201227
20201224,9호선2~3단계,언주,8197,7765,15962,20201227
20201224,9호선,신논현,23897,23332,47229,20201227
20201224,9호선,사평,2429,2390,4819,20201227
20201224,9호선,고속터미널,9349,13266,22615,20201227
20201224,9호선,신반포,2415,2382,4797,20201227
20201224,9호선,구반포,2068,2138,4206,20201227
20201224,9호선,동작(현충원),1298,953,2251,20201227
20201224,9호선,흑석(중앙대입구),6135,6355,12490,20201227
20201224,9호선,노들,3379,2972,6351,20201227
20201224,9호선,노량진,19050,18115,37165,20201227
20201224,9호선,샛강,4233,4291,8524,20201227
20201224,9호선,여의도,18302,16835,35137,20201227
20201224,9호선,국회의사당,11854,11426,23280,20201227
20201224,9호선,당산,13920,13388,27308,20201227
20201224,9호선,선유도,6095,5820,11915,20201227
20201224,9호선,신목동,2900,2622,5522,20201227
20201224,9호선,염창,13455,13454,26909,20201227
20201224,9호선,등촌,8852,8761,17613,20201227
20201224,9호선,증미,6017,6343,12360,20201227
20201224,9호선,가양,16450,16086,32536,20201227
20201224,9호선,양천향교,7370,7422,14792,20201227
20201224,9호선,마곡나루(서울식물원),8115,8172,16287,20201227
20201224,9호선,신방화,5392,5450,10842,20201227
20201224,9호선,공항시장,2327,2452,4779,20201227
20201224,9호선,김포공항,6141,9868,16009,20201227
20201224,9호선,개화,2002,1422,3424,20201227
20201224,8호선,모란,4031,2955,6986,20201227
20201224,8호선,수진,4283,3956,8239,20201227
20201224,8호선,신흥,3902,4229,8131,20201227
20201224,8호선,단대오거리,8688,8267,16955,20201227
20201224,8호선,남한산성입구(성남법원.검찰청),11212,10092,21304,20201227
20201224,8호선,산성,5529,5515,11044,20201227
20201224,8호선,복정,8342,7198,15540,20201227
20201224,8호선,장지,14219,13875,28094,20201227
20201224,8호선,문정,17259,17846,35105,20201227
20201224,8호선,가락시장,6931,7702,14633,20201227
20201224,8호선,송파,6578,6571,13149,20201227
20201224,8호선,석촌,6367,7258,13625,20201227
20201224,8호선,잠실(송파구청),12426,14032,26458,20201227
20201224,8호선,몽촌토성(평화의문),4441,4587,9028,20201227
20201224,8호선,강동구청,8697,8901,17598,20201227
20201224,8호선,천호(풍납토성),13379,15619,28998,20201227
20201224,8호선,암사,15553,13896,29449,20201227
20201224,7호선,부평구청,9312,7754,17066,20201227
20201224,7호선,굴포천,6953,7488,14441,20201227
20201224,7호선,삼산체육관,3713,3340,7053,20201227
20201224,7호선,상동,9593,10154,19747,20201227
20201224,7호선,부천시청,10445,10626,21071,20201227
20201224,7호선,신중동,11582,11481,23063,20201227
20201224,7호선,춘의,8380,8139,16519,20201227
20201224,7호선,부천종합운동장,3888,3305,7193,20201227
20201224,7호선,까치울,5958,5788,11746,20201227
20201224,7호선,온수(성공회대입구),8813,8053,16866,20201227
20201224,7호선,천왕,8771,8395,17166,20201227
20201224,7호선,광명사거리,19050,19166,38216,20201227
20201224,7호선,철산,17426,17902,35328,20201227
20201224,7호선,가산디지털단지,39003,38062,77065,20201227
20201224,7호선,남구로,13582,14284,27866,20201227
20201224,7호선,대림(구로구청),6377,6365,12742,20201227
20201224,7호선,신풍,9472,9126,18598,20201227
20201224,7호선,보라매,7941,7817,15758,20201227
20201224,7호선,신대방삼거리,13819,13486,27305,20201227
20201224,7호선,장승배기,8052,7849,15901,20201227
20201224,7호선,상도,8380,8139,16519,20201227
20201224,7호선,숭실대입구(살피재),9304,9464,18768,20201227
20201224,7호선,남성,9336,8470,17806,20201227
20201224,7호선,이수,12396,12267,24663,20201227
20201224,7호선,내방,12100,12078,24178,20201227
20201224,7호선,고속터미널,12175,11236,23411,20201227
20201224,7호선,반포,4667,4488,9155,20201227
20201224,7호선,논현,15913,17144,33057,20201227
20201224,7호선,학동,19255,19986,39241,20201227
20201224,7호선,강남구청,13078,13992,27070,20201227
20201224,7호선,청담,15601,17010,32611,20201227
20201224,7호선,뚝섬유원지,5563,5593,11156,20201227
20201224,7호선,건대입구,10847,10819,21666,20201227
20201224,7호선,어린이대공원(세종대),9233,8828,18061,20201227
20201224,7호선,군자(능동),12065,9566,21631,20201227
20201224,7호선,중곡,8313,7891,16204,20201227
20201224,7호선,용마산(용마폭포공원),5041,4790,9831,20201227
20201224,7호선,사가정,13800,13727,27527,20201227
20201224,7호선,면목,12836,12736,25572,20201227
20201224,7호선,상봉(시외버스터미널),14240,13924,28164,20201227
20201224,7호선,중화,9056,9001,18057,20201227
20201224,7호선,먹골,8648,8443,17091,20201227
20201224,7호선,태릉입구,6558,5907,12465,20201227
20201224,7호선,공릉(서울과학기술대),9354,9373,18727,20201227
20201224,7호선,하계,14083,13515,27598,20201227
20201224,7호선,중계,11598,10328,21926,20201227
20201224,7호선,노원,16040,16922,32962,20201227
20201224,7호선,마들,9999,9634,19633,20201227
20201224,7호선,수락산,10448,10304,20752,20201227
20201224,7호선,도봉산,7014,8382,15396,20201227
20201224,7호선,장암,1768,750,2518,20201227
20201224,6호선,봉화산(서울의료원),7283,6882,14165,20201227
20201224,6호선,화랑대(서울여대입구),8793,6825,15618,20201227
20201224,6호선,태릉입구,4275,4517,8792,20201227
20201224,6호선,석계,10089,10363,20452,20201227
20201224,6호선,돌곶이,6820,6363,13183,20201227
20201224,6호선,상월곡(한국과학기술연구원),5092,4420,9512,20201227
20201224,6호선,월곡(동덕여대),9303,9441,18744,20201227
20201224,6호선,고려대(종암),6298,6005,12303,20201227
20201224,6호선,안암(고대병원앞),7779,7343,15122,20201227
20201224,6호선,보문,6199,5547,11746,20201227
20201224,6호선,창신,2775,2190,4965,20201227
20201224,6호선,동묘앞,7164,7026,14190,20201227
20201224,6호선,신당,6723,6926,13649,20201227
20201224,6호선,청구,3099,3276,6375,20201227
20201224,6호선,약수,2917,2969,5886,20201227
20201224,6호선,버티고개,1868,1702,3570,20201227
20201224,6호선,한강진,5865,6588,12453,20201227
20201224,6호선,이태원,7046,7402,14448,20201227
20201224,6호선,녹사평(용산구청),3945,3820,7765,20201227
20201224,6호선,삼각지,4142,3629,7771,20201227
20201224,6호선,효창공원앞,5753,5124,10877,20201227
20201224,6호선,공덕,15027,14320,29347,20201227
20201224,6호선,대흥(서강대앞),5977,5969,11946,20201227
20201224,6호선,광흥창(서강),6573,6500,13073,20201227
20201224,6호선,상수,5941,6492,12433,20201227
20201224,6호선,합정,9970,9805,19775,20201227
20201224,6호선,망원,11532,12718,24250,20201227
20201224,6호선,마포구청,11557,10597,22154,20201227
20201224,6호선,월드컵경기장(성산),4045,4184,8229,20201227
20201224,6호선,디지털미디어시티,11049,11928,22977,20201227
20201224,6호선,증산(명지대앞),8393,8216,16609,20201227
20201224,6호선,새절(신사),10586,9909,20495,20201227
20201224,6호선,구산,5901,4656,10557,20201227
20201224,6호선,독바위,2255,2384,4639,20201227
20201224,6호선,불광,3502,3696,7198,20201227
20201224,6호선,역촌,3083,3518,6601,20201227
20201224,6호선,응암,14703,15045,29748,20201227
20201224,5호선,하남풍산,4043,4071,8114,20201227
20201224,5호선,미사,10515,10781,21296,20201227
20201224,5호선,마천,4735,4713,9448,20201227
20201224,5호선,거여,6275,6049,12324,20201227
20201224,5호선,개롱,4746,5056,9802,20201227
20201224,5호선,오금,2990,2949,5939,20201227
20201224,5호선,방이,5292,5395,10687,20201227
20201224,5호선,올림픽공원(한국체대),3267,2688,5955,20201227
20201224,5호선,둔촌동,6720,6788,13508,20201227
20201224,5호선,상일동,12461,11462,23923,20201227
20201224,5호선,고덕,6914,7031,13945,20201227
20201224,5호선,명일,6453,6794,13247,20201227
20201224,5호선,굽은다리(강동구민회관앞),7708,7264,14972,20201227
20201224,5호선,길동,6513,6828,13341,20201227
20201224,5호선,강동,15907,14542,30449,20201227
20201224,5호선,천호(풍납토성),15677,15520,31197,20201227
20201224,5호선,광나루(장신대),10069,9019,19088,20201227
20201224,5호선,아차산(어린이대공원후문),11561,11403,22964,20201227
20201224,5호선,군자(능동),9001,9907,18908,20201227
20201224,5호선,장한평,14879,14975,29854,20201227
20201224,5호선,답십리,13198,12311,25509,20201227
20201224,5호선,마장,4743,4384,9127,20201227
20201224,5호선,왕십리(성동구청),3763,4205,7968,20201227
20201224,5호선,행당,6494,5823,12317,20201227
20201224,5호선,신금호,4946,5133,10079,20201227
20201224,5호선,청구,3275,3110,6385,20201227
20201224,5호선,동대문역사문화공원(DDP),2411,2715,5126,20201227
20201224,5호선,을지로4가,4902,5019,9921,20201227
20201224,5호선,종로3가,7968,8120,16088,20201227
20201224,5호선,광화문(세종문화회관),23193,23427,46620,20201227
20201224,5호선,서대문,14433,14398,28831,20201227
20201224,5호선,충정로(경기대입구),3761,3771,7532,20201227
20201224,5호선,애오개,5274,5265,10539,20201227
20201224,5호선,공덕,11254,12048,23302,20201227
20201224,5호선,마포,11152,11503,22655,20201227
20201224,5호선,여의나루,6053,5925,11978,20201227
20201224,5호선,여의도,21184,21169,42353,20201227
20201224,5호선,신길,3194,3497,6691,20201227
20201224,5호선,영등포시장,7821,8010,15831,20201227
20201224,5호선,영등포구청,3406,3450,6856,20201227
20201224,5호선,양평,6211,6279,12490,20201227
20201224,5호선,오목교(목동운동장앞),18064,19974,38038,20201227
20201224,5호선,목동,13508,14890,28398,20201227
20201224,5호선,신정(은행정),11597,9146,20743,20201227
20201224,5호선,까치산,24328,23834,48162,20201227
20201224,5호선,화곡,23508,22079,45587,20201227
20201224,5호선,우장산,11281,11324,22605,20201227
20201224,5호선,발산,14768,15066,29834,20201227
20201224,5호선,마곡,7641,7389,15030,20201227
20201224,5호선,송정,5560,5230,10790,20201227
20201224,5호선,김포공항,6089,6447,12536,20201227
20201224,5호선,개화산,4334,4197,8531,20201227
20201224,5호선,방화,5371,5083,10454,20201227
20201224,4호선,쌍문,24908,23013,47921,20201227
20201224,4호선,창동,21474,23026,44500,20201227
20201224,4호선,노원,15341,17170,32511,20201227
20201224,4호선,상계,15902,14766,30668,20201227
20201224,4호선,당고개,10170,9268,19438,20201227
20201224,4호선,남태령,942,747,1689,20201227
20201224,4호선,사당,18352,15187,33539,20201227
20201224,4호선,총신대입구(이수),14933,16149,31082,20201227
20201224,4호선,동작(현충원),1948,2039,3987,20201227
20201224,4호선,이촌(국립중앙박물관),4912,5520,10432,20201227
20201224,4호선,신용산,11698,12363,24061,20201227
20201224,4호선,삼각지,3605,3926,7531,20201227
20201224,4호선,숙대입구(갈월),9783,9521,19304,20201227
20201224,4호선,서울역,8285,11692,19977,20201227
20201224,4호선,회현(남대문시장),19562,19979,39541,20201227
20201224,4호선,명동,15388,16228,31616,20201227
20201224,4호선,충무로,21716,22137,43853,20201227
20201224,4호선,동대문역사문화공원(DDP),11916,11255,23171,20201227
20201224,4호선,동대문,16557,17018,33575,20201227
20201224,4호선,혜화,23887,22784,46671,20201227
20201224,4호선,한성대입구(삼선교),10849,10758,21607,20201227
20201224,4호선,성신여대입구(돈암),15673,15281,30954,20201227
20201224,4호선,길음,15890,15636,31526,20201227
20201224,4호선,미아사거리,23493,23729,47222,20201227
20201224,4호선,미아(서울사이버대학),13102,12729,25831,20201227
20201224,4호선,수유(강북구청),29050,29119,58169,20201227
20201224,3호선,오금,4816,4334,9150,20201227
20201224,3호선,경찰병원,6049,5914,11963,20201227
20201224,3호선,가락시장,7378,7241,14619,20201227
20201224,3호선,수서,11969,12403,24372,20201227
20201224,3호선,일원,7698,7305,15003,20201227
20201224,3호선,대청,7431,6965,14396,20201227
20201224,3호선,학여울,1311,1255,2566,20201227
20201224,3호선,대치,7511,7410,14921,20201227
20201224,3호선,도곡,4234,4312,8546,20201227
20201224,3호선,매봉,9934,9253,19187,20201227
20201224,3호선,양재(서초구청),30678,31382,62060,20201227
20201224,3호선,남부터미널(예술의전당),23320,24299,47619,20201227
20201224,3호선,교대(법원.검찰청),10490,6773,17263,20201227
20201224,3호선,고속터미널,34817,39504,74321,20201227
20201224,3호선,잠원,3515,3585,7100,20201227
20201224,3호선,신사,24427,24929,49356,20201227
20201224,3호선,압구정,26392,27557,53949,20201227
20201224,3호선,옥수,7116,7434,14550,20201227
20201224,3호선,금호,6594,6240,12834,20201227
20201224,3호선,약수,10647,10269,20916,20201227
20201224,3호선,동대입구,5710,5803,11513,20201227
20201224,3호선,을지로3가,8140,8607,16747,20201227
20201224,3호선,종로3가,8064,9361,17425,20201227
20201224,3호선,안국,13490,13392,26882,20201227
20201224,3호선,경복궁(정부서울청사),13591,12923,26514,20201227
20201224,3호선,독립문,5613,5661,11274,20201227
20201224,3호선,무악재,3128,3218,6346,20201227
20201224,3호선,홍제,14044,13640,27684,20201227
20201224,3호선,녹번,12126,11159,23285,20201227
20201224,3호선,불광,13418,14112,27530,20201227
20201224,3호선,연신내,31232,29368,60600,20201227
20201224,3호선,구파발,16438,15761,32199,20201227
20201224,3호선,지축,2549,2514,5063,20201227
20201224,2호선,용두(동대문구청),2078,2221,4299,20201227
20201224,2호선,신정네거리,7893,8317,16210,20201227
20201224,2호선,양천구청,5160,5679,10839,20201227
20201224,2호선,도림천,1156,1183,2339,20201227
20201224,2호선,신설동,2736,2512,5248,20201227
20201224,2호선,신답,1240,1382,2622,20201227
20201224,2호선,용답,2215,2085,4300,20201227
20201224,2호선,충정로(경기대입구),7924,8183,16107,20201227
20201224,2호선,아현,8165,8049,16214,20201227
20201224,2호선,신촌,24878,25941,50819,20201227
20201224,2호선,홍대입구,36869,38708,75577,20201227
20201224,2호선,합정,23008,24150,47158,20201227
20201224,2호선,당산,14649,16804,31453,20201227
20201224,2호선,영등포구청,19175,19150,38325,20201227
20201224,2호선,문래,16805,17072,33877,20201227
20201224,2호선,신도림,40406,39243,79649,20201227
20201224,2호선,대림(구로구청),20227,20897,41124,20201227
20201224,2호선,구로디지털단지,48685,49049,97734,20201227
20201224,2호선,신대방,22119,21141,43260,20201227
20201224,2호선,신림,52721,51197,103918,20201227
20201224,2호선,봉천,19885,18386,38271,20201227
20201224,2호선,서울대입구(관악구청),38069,36705,74774,20201227
20201224,2호선,낙성대(강감찬),22328,20933,43261,20201227
20201224,2호선,사당,27554,29382,56936,20201227
20201224,2호선,방배,12513,13091,25604,20201227
20201224,2호선,서초,16659,16111,32770,20201227
20201224,2호선,교대(법원.검찰청),25687,28361,54048,20201227
20201224,2호선,강남,59395,57529,116924,20201227
20201224,2호선,역삼,37943,40197,78140,20201227
20201224,2호선,선릉,42956,38152,81108,20201227
20201224,2호선,삼성(무역센터),38837,38308,77145,20201227
20201224,2호선,종합운동장,4821,5280,10101,20201227
20201224,2호선,잠실새내,15837,16015,31852,20201227
20201224,2호선,잠실(송파구청),51283,51482,102765,20201227
20201224,2호선,잠실나루,11195,10676,21871,20201227
20201224,2호선,강변(동서울터미널),23468,25168,48636,20201227
20201224,2호선,구의(광진구청),19561,18993,38554,20201227
20201224,2호선,건대입구,25761,28301,54062,20201227
20201224,2호선,성수,27384,29509,56893,20201227
20201224,2호선,뚝섬,16327,17278,33605,20201227
20201224,2호선,한양대,5204,5039,10243,20201227
20201224,2호선,왕십리(성동구청),12248,9986,22234,20201227
20201224,2호선,상왕십리,11322,10835,22157,20201227
20201224,2호선,신당,11412,11814,23226,20201227
20201224,2호선,동대문역사문화공원(DDP),9403,10576,19979,20201227
20201224,2호선,을지로4가,10843,10738,21581,20201227
20201224,2호선,을지로3가,16300,16094,32394,20201227
20201224,2호선,을지로입구,33410,32493,65903,20201227
20201224,2호선,시청,18300,17398,35698,20201227
20201224,1호선,청량리(서울시립대입구),17180,17352,34532,20201227
20201224,1호선,제기동,14477,14618,29095,20201227
20201224,1호선,신설동,11486,11221,22707,20201227
20201224,1호선,동대문,9331,8751,18082,20201227
20201224,1호선,종로5가,18228,17750,35978,20201227
20201224,1호선,종로3가,18880,17287,36167,20201227
20201224,1호선,종각,25090,23653,48743,20201227
20201224,1호선,시청,16780,16400,33180,20201227
20201224,1호선,동묘앞,6397,6569,12966,20201227
20201224,1호선,서울역,31786,30815,62601,20201227
20201224,2호선,이대,9162,9374,18536,20201227
20201224,경원선,덕계,2122,1933,4055,20201227
20201225,6호선,녹사평(용산구청),2070,2109,4179,20201228
20201225,6호선,삼각지,1739,1401,3140,20201228
20201225,6호선,효창공원앞,2269,1980,4249,20201228
20201225,6호선,공덕,4505,4242,8747,20201228
20201225,6호선,대흥(서강대앞),2368,2295,4663,20201228
20201225,6호선,광흥창(서강),2409,2234,4643,20201228
20201225,6호선,상수,2989,3398,6387,20201228
20201225,6호선,합정,5117,4905,10022,20201228
20201225,6호선,망원,5668,6190,11858,20201228
20201225,6호선,마포구청,4979,4312,9291,20201228
20201225,6호선,월드컵경기장(성산),2718,2601,5319,20201228
20201225,6호선,디지털미디어시티,3716,3788,7504,20201228
20201225,6호선,증산(명지대앞),4227,4217,8444,20201228
20201225,6호선,새절(신사),4721,4489,9210,20201228
20201225,6호선,구산,2720,2053,4773,20201228
20201225,6호선,독바위,1081,1298,2379,20201228
20201225,6호선,불광,2037,1906,3943,20201228
20201225,6호선,역촌,1428,1591,3019,20201228
20201225,6호선,응암,6814,6890,13704,20201228
20201225,5호선,하남풍산,1786,1972,3758,20201228
20201225,5호선,미사,4764,4715,9479,20201228
20201225,5호선,마천,2268,2395,4663,20201228
20201225,5호선,거여,2585,2504,5089,20201228
20201225,5호선,개롱,1925,2026,3951,20201228
20201225,5호선,오금,952,927,1879,20201228
20201225,5호선,방이,2094,2040,4134,20201228
20201225,5호선,올림픽공원(한국체대),1310,1134,2444,20201228
20201225,5호선,둔촌동,2895,2976,5871,20201228
20201225,5호선,상일동,4653,4382,9035,20201228
20201225,5호선,고덕,2507,2584,5091,20201228
20201225,5호선,명일,2647,2601,5248,20201228
20201225,5호선,굽은다리(강동구민회관앞),3670,3494,7164,20201228
20201225,5호선,길동,3094,3129,6223,20201228
20201225,5호선,강동,6355,5890,12245,20201228
20201225,5호선,천호(풍납토성),8774,8173,16947,20201228
20201225,5호선,광나루(장신대),4548,4368,8916,20201228
20201225,5호선,아차산(어린이대공원후문),6321,6336,12657,20201228
20201225,5호선,군자(능동),4473,4605,9078,20201228
20201225,5호선,장한평,5649,5517,11166,20201228
20201225,5호선,답십리,5587,5161,10748,20201228
20201225,5호선,마장,2055,1969,4024,20201228
20201225,5호선,왕십리(성동구청),1751,1930,3681,20201228
20201225,5호선,행당,2585,2263,4848,20201228
20201225,5호선,신금호,2079,2160,4239,20201228
20201225,5호선,청구,1441,1233,2674,20201228
20201225,5호선,동대문역사문화공원(DDP),543,747,1290,20201228
20201225,5호선,을지로4가,1639,1759,3398,20201228
20201225,5호선,종로3가,4216,4107,8323,20201228
20201225,5호선,광화문(세종문화회관),6783,6442,13225,20201228
20201225,5호선,서대문,3129,3124,6253,20201228
20201225,5호선,충정로(경기대입구),1014,911,1925,20201228
20201225,5호선,애오개,1657,1604,3261,20201228
20201225,5호선,공덕,2886,3026,5912,20201228
20201225,5호선,마포,3207,3238,6445,20201228
20201225,5호선,여의나루,2700,2577,5277,20201228
20201225,5호선,여의도,3744,4071,7815,20201228
20201225,5호선,신길,1286,1350,2636,20201228
20201225,5호선,영등포시장,3165,3247,6412,20201228
20201225,5호선,영등포구청,967,913,1880,20201228
20201225,5호선,양평,1770,1748,3518,20201228
20201225,5호선,오목교(목동운동장앞),7511,7837,15348,20201228
20201225,5호선,목동,5058,5112,10170,20201228
20201225,5호선,신정(은행정),4600,4060,8660,20201228
20201225,5호선,까치산,11520,11207,22727,20201228
20201225,5호선,화곡,10384,9657,20041,20201228
20201225,5호선,우장산,4408,4500,8908,20201228
20201225,5호선,발산,5412,5630,11042,20201228
20201225,5호선,마곡,2267,2195,4462,20201228
20201225,5호선,송정,2729,2657,5386,20201228
20201225,5호선,김포공항,4316,4671,8987,20201228
20201225,5호선,개화산,2022,2069,4091,20201228
20201225,5호선,방화,2425,2409,4834,20201228
20201225,4호선,쌍문,11566,10571,22137,20201228
20201225,4호선,창동,10022,10774,20796,20201228
20201225,4호선,노원,8078,8914,16992,20201228
20201225,4호선,상계,7140,6782,13922,20201228
20201225,4호선,당고개,5286,5106,10392,20201228
20201225,4호선,남태령,357,313,670,20201228
20201225,4호선,사당,8462,7330,15792,20201228
20201225,4호선,총신대입구(이수),6638,7142,13780,20201228
20201225,4호선,동작(현충원),985,962,1947,20201228
20201225,4호선,이촌(국립중앙박물관),1976,2285,4261,20201228
20201225,4호선,신용산,4090,4537,8627,20201228
20201225,4호선,삼각지,1125,1307,2432,20201228
20201225,4호선,숙대입구(갈월),3809,3572,7381,20201228
20201225,4호선,서울역,2617,4589,7206,20201228
20201225,4호선,회현(남대문시장),8849,9201,18050,20201228
20201225,4호선,명동,8055,9543,17598,20201228
20201225,4호선,충무로,5823,5633,11456,20201228
20201225,4호선,동대문역사문화공원(DDP),6252,6108,12360,20201228
20201225,4호선,동대문,8150,8484,16634,20201228
20201225,4호선,혜화,11041,11124,22165,20201228
20201225,4호선,한성대입구(삼선교),5119,4782,9901,20201228
20201225,4호선,성신여대입구(돈암),8277,7957,16234,20201228
20201225,4호선,길음,6663,6443,13106,20201228
20201225,4호선,미아사거리,12212,11593,23805,20201228
20201225,4호선,미아(서울사이버대학),6190,5899,12089,20201228
20201225,4호선,수유(강북구청),14812,14079,28891,20201228
20201225,3호선,오금,1571,1482,3053,20201228
20201225,3호선,경찰병원,1755,1734,3489,20201228
20201225,3호선,가락시장,3049,3036,6085,20201228
20201225,3호선,수서,4983,5458,10441,20201228
20201225,3호선,일원,1881,1963,3844,20201228
20201225,3호선,대청,2792,2510,5302,20201228
20201225,3호선,학여울,463,437,900,20201228
20201225,3호선,대치,2754,2663,5417,20201228
20201225,3호선,도곡,1360,1285,2645,20201228
20201225,3호선,매봉,2633,2495,5128,20201228
20201225,3호선,양재(서초구청),7045,7814,14859,20201228
20201225,3호선,남부터미널(예술의전당),7961,8260,16221,20201228
20201225,3호선,교대(법원.검찰청),2124,1392,3516,20201228
20201225,3호선,고속터미널,20800,22429,43229,20201228
20201225,3호선,잠원,1318,1247,2565,20201228
20201225,3호선,신사,7898,8346,16244,20201228
20201225,3호선,압구정,8877,9179,18056,20201228
20201225,3호선,옥수,3116,3181,6297,20201228
20201225,3호선,금호,2877,2741,5618,20201228
20201225,3호선,약수,4328,4116,8444,20201228
20201225,3호선,동대입구,3089,3461,6550,20201228
20201225,3호선,을지로3가,2037,2141,4178,20201228
20201225,3호선,종로3가,2103,3055,5158,20201228
20201225,3호선,안국,4358,4794,9152,20201228
20201225,3호선,경복궁(정부서울청사),4856,4965,9821,20201228
20201225,3호선,독립문,2461,2536,4997,20201228
20201225,3호선,무악재,1320,1342,2662,20201228
20201225,3호선,홍제,6320,6035,12355,20201228
20201225,3호선,녹번,4769,4275,9044,20201228
20201225,3호선,불광,6567,7292,13859,20201228
20201225,3호선,연신내,15738,14745,30483,20201228
20201225,3호선,구파발,7137,7290,14427,20201228
20201225,3호선,지축,989,994,1983,20201228
20201225,2호선,용두(동대문구청),907,937,1844,20201228
20201225,2호선,신정네거리,3280,3330,6610,20201228
20201225,2호선,양천구청,1940,2057,3997,20201228
20201225,2호선,도림천,304,358,662,20201228
20201225,2호선,신설동,1469,1428,2897,20201228
20201225,2호선,신답,494,496,990,20201228
20201225,2호선,용답,1247,1134,2381,20201228
20201225,2호선,충정로(경기대입구),2559,2577,5136,20201228
20201225,2호선,아현,3776,3601,7377,20201228
20201225,2호선,이대,4303,4217,8520,20201228
20201225,2호선,신촌,13818,13924,27742,20201228
20201225,2호선,홍대입구,23228,23749,46977,20201228
20201225,2호선,합정,10437,11151,21588,20201228
20201225,2호선,당산,5622,6006,11628,20201228
20201225,2호선,영등포구청,5762,5832,11594,20201228
20201225,2호선,신도림,18008,17754,35762,20201228
20201225,2호선,대림(구로구청),10226,10688,20914,20201228
20201225,2호선,구로디지털단지,17699,17576,35275,20201228
20201225,2호선,신대방,11081,10757,21838,20201228
20201225,2호선,신림,27536,26023,53559,20201228
20201225,2호선,봉천,9007,8378,17385,20201228
20201225,2호선,서울대입구(관악구청),18472,17706,36178,20201228
20201225,2호선,낙성대(강감찬),10724,9684,20408,20201228
20201225,2호선,사당,12324,13098,25422,20201228
20201225,2호선,방배,4049,4104,8153,20201228
20201225,2호선,서초,4531,4225,8756,20201228
20201225,2호선,교대(법원.검찰청),6259,6829,13088,20201228
20201225,2호선,강남,19074,19110,38184,20201228
20201225,2호선,역삼,8363,8788,17151,20201228
20201225,2호선,선릉,9431,8287,17718,20201228
20201225,2호선,삼성(무역센터),13956,14065,28021,20201228
20201225,2호선,종합운동장,1917,2025,3942,20201228
20201225,2호선,잠실새내,6907,7372,14279,20201228
20201225,2호선,잠실(송파구청),30543,28991,59534,20201228
20201225,2호선,잠실나루,3139,3016,6155,20201228
20201225,2호선,강변(동서울터미널),11204,11791,22995,20201228
20201225,2호선,구의(광진구청),8451,8122,16573,20201228
20201225,2호선,건대입구,15492,16834,32326,20201228
20201225,2호선,성수,6574,7291,13865,20201228
20201225,2호선,뚝섬,4995,5055,10050,20201228
20201225,2호선,한양대,1459,1316,2775,20201228
20201225,2호선,왕십리(성동구청),6278,5163,11441,20201228
20201225,2호선,상왕십리,4776,4505,9281,20201228
20201225,2호선,신당,5773,5924,11697,20201228
20201225,2호선,동대문역사문화공원(DDP),5188,5831,11019,20201228
20201225,2호선,을지로4가,3593,3559,7152,20201228
20201225,2호선,을지로3가,4212,4065,8277,20201228
20201225,2호선,을지로입구,12907,12634,25541,20201228
20201225,2호선,시청,3882,2982,6864,20201228
20201225,1호선,청량리(서울시립대입구),10081,9971,20052,20201228
20201225,1호선,제기동,7981,8236,16217,20201228
20201225,1호선,신설동,4960,4678,9638,20201228
20201225,1호선,동대문,6276,5936,12212,20201228
20201225,1호선,종로5가,7944,7851,15795,20201228
20201225,1호선,종로3가,8850,8300,17150,20201228
20201225,1호선,종각,7252,6847,14099,20201228
20201225,1호선,시청,5166,5036,10202,20201228
20201225,1호선,동묘앞,5728,5786,11514,20201228
20201225,1호선,서울역,12716,13466,26182,20201228
20201225,일산선,대화,4276,3876,8152,20201228
20201225,일산선,주엽,2776,2854,5630,20201228
20201225,중앙선,양평,1012,1126,2138,20201228
20201225,중앙선,원덕,122,155,277,20201228
20201225,중앙선,용문,949,1076,2025,20201228
20201225,중앙선,지평,19,27,46,20201228
20201225,중앙선,오빈,123,122,245,20201228
20201225,장항선,아산,1272,1405,2677,20201228
20201225,장항선,쌍용(나사렛대),760,728,1488,20201228
20201225,장항선,봉명,394,353,747,20201228
20201225,수인선,사리,1455,1297,2752,20201228
20201225,수인선,야목,92,89,181,20201228
20201225,수인선,어천,274,243,517,20201228
20201225,수인선,오목천,908,776,1684,20201228
20201225,수인선,고색,1025,963,1988,20201228
20201225,분당선,매교,972,969,1941,20201228
20201225,일산선,정발산,3309,3327,6636,20201228
20201225,일산선,마두,2179,2278,4457,20201228
20201225,일산선,백석,4065,4041,8106,20201228
20201225,일산선,대곡,635,550,1185,20201228
20201225,일산선,화정,6350,6629,12979,20201228
20201225,일산선,원당,4120,4031,8151,20201228
20201225,일산선,삼송,7362,7406,14768,20201228
20201225,일산선,원흥,3330,3139,6469,20201228
20201225,분당선,수원시청,4889,5348,10237,20201228
20201225,우이신설선,신설동,819,810,1629,20201228
20201225,우이신설선,보문,707,647,1354,20201228
20201225,우이신설선,성신여대입구(돈암),1365,1564,2929,20201228
20201225,분당선,매탄권선,1609,1570,3179,20201228
20201225,2호선,문래,4679,4798,9477,20201228
20201225,분당선,망포,4518,4136,8654,20201228
20201225,분당선,영통,3307,3128,6435,20201228
20201225,분당선,청명,1163,1170,2333,20201228
20201225,분당선,상갈,1990,2016,4006,20201228
20201225,분당선,기흥,3480,3397,6877,20201228
20201225,분당선,신갈,1183,1226,2409,20201228
20201225,분당선,구성,1478,1594,3072,20201228
20201225,분당선,죽전,5491,6084,11575,20201228
20201225,분당선,보정,679,596,1275,20201228
20201225,분당선,이매,1552,1585,3137,20201228
20201225,분당선,오리,3720,3154,6874,20201228
20201225,분당선,미금,5108,5161,10269,20201228
20201225,분당선,정자,4765,4853,9618,20201228
20201225,분당선,수내,4249,3950,8199,20201228
20201225,분당선,서현,9672,9485,19157,20201228
20201225,분당선,야탑,7964,8630,16594,20201228
20201225,분당선,모란,8560,8532,17092,20201228
20201225,분당선,태평,5855,5731,11586,20201228
20201225,분당선,가천대,2373,2634,5007,20201228
20201225,분당선,선정릉,1404,1331,2735,20201228
20201225,분당선,강남구청,1823,2122,3945,20201228
20201225,분당선,압구정로데오,6699,7430,14129,20201228
20201225,분당선,서울숲,2509,2441,4950,20201228
20201225,분당선,수원,4211,3328,7539,20201228
20201225,분당선,수서,3619,4587,8206,20201228
20201225,분당선,대모산입구,1235,1125,2360,20201228
20201225,분당선,개포동,985,1003,1988,20201228
20201225,분당선,구룡,542,514,1056,20201228
20201225,분당선,도곡,1638,1586,3224,20201228
20201225,분당선,한티,4218,4177,8395,20201228
20201225,분당선,선릉,2007,2713,4720,20201228
20201225,과천선,범계,9065,8736,17801,20201228
20201225,과천선,평촌,4050,4044,8094,20201228
20201225,과천선,인덕원,7212,7245,14457,20201228
20201225,과천선,정부과천청사,2274,2366,4640,20201228
20201225,과천선,과천,1810,1572,3382,20201228
20201225,과천선,대공원,1608,1617,3225,20201228
20201225,과천선,경마공원,308,310,618,20201228
20201225,과천선,선바위,2075,2010,4085,20201228
20201225,공항철도 1호선,영종,1313,1402,2715,20201228
20201225,공항철도 1호선,인천공항2터미널,1321,1306,2627,20201228
20201225,공항철도 1호선,인천공항1터미널,2842,3117,5959,20201228
20201225,공항철도 1호선,공항화물청사,1020,1054,2074,20201228
20201225,공항철도 1호선,운서,3354,3523,6877,20201228
20201225,공항철도 1호선,청라국제도시,1824,1728,3552,20201228
20201225,공항철도 1호선,검암,2419,2452,4871,20201228
20201225,공항철도 1호선,계양,3114,2909,6023,20201228
20201225,우이신설선,정릉,1815,1559,3374,20201228
20201225,우이신설선,북한산보국문,2404,2179,4583,20201228
20201225,우이신설선,솔샘,1897,1704,3601,20201228
20201225,우이신설선,삼양사거리,1095,1102,2197,20201228
20201225,우이신설선,삼양,864,916,1780,20201228
20201225,우이신설선,화계,1429,1320,2749,20201228
20201225,우이신설선,가오리,1576,1557,3133,20201228
20201225,우이신설선,4.19민주묘지,1299,1228,2527,20201228
20201225,우이신설선,솔밭공원,1026,955,1981,20201228
20201225,우이신설선,북한산우이,1511,1554,3065,20201228
20201225,안산선,수리산,1479,1317,2796,20201228
20201225,안산선,오이도,4286,4371,8657,20201228
20201225,안산선,정왕,3383,3405,6788,20201228
20201225,안산선,신길온천,759,684,1443,20201228
20201225,안산선,안산,5853,5754,11607,20201228
20201225,안산선,초지,1546,1631,3177,20201228
20201225,안산선,고잔,2728,2580,5308,20201228
20201225,안산선,중앙,7078,7600,14678,20201228
20201225,안산선,한대앞,3402,3430,6832,20201228
20201225,안산선,상록수,6565,6641,13206,20201228
20201225,안산선,반월,1686,1554,3240,20201228
20201225,안산선,대야미,1974,1762,3736,20201228
20201225,안산선,산본,5775,4945,10720,20201228
20201225,수인선,인천,826,1270,2096,20201228
20201225,수인선,신포,809,826,1635,20201228
20201225,수인선,숭의,1505,1384,2889,20201228
20201225,수인선,인하대,2277,2251,4528,20201228
20201225,수인선,송도,1123,1103,2226,20201228
20201225,수인선,연수,2020,2019,4039,20201228
20201225,수인선,원인재,1923,2061,3984,20201228
20201225,수인선,남동인더스파크,577,519,1096,20201228
20201225,수인선,호구포,1390,1398,2788,20201228
20201225,공항철도 1호선,김포공항,5135,3446,8581,20201228
20201225,수인선,인천논현,2214,2299,4513,20201228
20201225,수인선,소래포구,2999,3125,6124,20201228
20201225,수인선,월곶,1240,1202,2442,20201228
20201225,공항철도 1호선,마곡나루(서울식물원),1222,1207,2429,20201228
20201225,공항철도 1호선,디지털미디어시티,2444,2291,4735,20201228
20201225,공항철도 1호선,홍대입구,4051,3808,7859,20201228
20201225,공항철도 1호선,공덕,664,836,1500,20201228
20201225,공항철도 1호선,서울역,2785,3023,5808,20201228
20201225,경춘선,춘천,685,694,1379,20201228
20201225,경춘선,남춘천,1210,1305,2515,20201228
20201225,경춘선,김유정,193,192,385,20201228
20201225,경춘선,강촌,250,266,516,20201228
20201225,경춘선,백양리,68,59,127,20201228
20201225,경춘선,굴봉산,67,62,129,20201228
20201225,경춘선,가평,883,904,1787,20201228
20201225,경춘선,상천,201,153,354,20201228
20201225,경춘선,청평,810,798,1608,20201228
20201225,경춘선,대성리,296,274,570,20201228
20201225,경춘선,마석,1542,1620,3162,20201228
20201225,경춘선,천마산,790,793,1583,20201228
20201225,경춘선,평내호평,2195,2248,4443,20201228
20201225,경춘선,금곡,614,566,1180,20201228
20201225,경춘선,사릉,1211,1189,2400,20201228
20201225,경춘선,퇴계원,1447,1369,2816,20201228
20201225,경춘선,별내,1092,1119,2211,20201228
20201225,경춘선,갈매,962,842,1804,20201228
20201225,경춘선,신내,557,602,1159,20201228
20201225,경인선,도화,1581,1476,3057,20201228
20201225,경인선,중동,3417,3280,6697,20201228
20201225,경인선,온수(성공회대입구),2342,2316,4658,20201228
20201225,경인선,도원,1215,1206,2421,20201228
20201225,경인선,간석,2257,2157,4414,20201228
20201225,경인선,부개,3269,3119,6388,20201228
20201225,경인선,소사,3940,3599,7539,20201228
20201225,경인선,구일,2133,1982,4115,20201228
20201225,경인선,인천,2364,1922,4286,20201228
20201225,경인선,동인천,6156,6162,12318,20201228
20201225,경인선,제물포,3704,3652,7356,20201228
20201225,경인선,주안,8349,7566,15915,20201228
20201225,경인선,동암,6922,7053,13975,20201228
20201225,경인선,백운,2863,2844,5707,20201228
20201225,경인선,부평,15007,16216,31223,20201228
20201225,경인선,송내,8649,8783,17432,20201228
20201225,경인선,부천,16088,16518,32606,20201228
20201225,경인선,역곡,10430,10426,20856,20201228
20201225,경인선,오류동,4865,4642,9507,20201228
20201225,경인선,개봉,8661,8695,17356,20201228
20201225,경의선,임진강,18,12,30,20201228
20201225,경의선,문산,2054,2103,4157,20201228
20201225,경의선,파주,402,362,764,20201228
20201225,경의선,월롱,716,649,1365,20201228
20201225,경의선,금촌,2654,2678,5332,20201228
20201225,경의선,금릉,1544,1564,3108,20201228
20201225,경의선,운정,1998,1919,3917,20201228
20201225,경의선,야당,2306,2246,4552,20201228
20201225,경의선,탄현,2605,2608,5213,20201228
20201225,경의선,일산,2895,2902,5797,20201228
20201225,경의선,풍산,1940,1961,3901,20201228
20201225,경의선,백마,1873,1901,3774,20201228
20201225,경의선,곡산,150,180,330,20201228
20201225,경의선,능곡,1337,1344,2681,20201228
20201225,경의선,행신,2393,2503,4896,20201228
20201225,경의선,강매,897,837,1734,20201228
20201225,경의선,화전,523,455,978,20201228
20201225,경의선,수색,647,659,1306,20201228
20201225,경의선,디지털미디어시티,890,848,1738,20201228
20201225,경의선,가좌,1891,1673,3564,20201228
20201225,경의선,홍대입구,753,917,1670,20201228
20201225,경의선,서강대,795,692,1487,20201228
20201225,경의선,공덕,962,851,1813,20201228
20201225,경의선,효창공원앞,924,964,1888,20201228
20201225,경의선,신촌,176,191,367,20201228
20201225,경의선,서울역,583,562,1145,20201228
20201225,경원선,소요산,1843,1669,3512,20201228
20201225,경원선,동두천,803,1040,1843,20201228
20201225,경원선,보산,785,773,1558,20201228
20201225,경원선,동두천중앙,1417,1459,2876,20201228
20201225,경원선,지행,2746,2792,5538,20201228
20201225,경원선,덕정,2231,2150,4381,20201228
20201225,경원선,덕계,1141,1052,2193,20201228
20201225,경원선,양주,3155,3030,6185,20201228
20201225,경원선,녹양,1783,1811,3594,20201228
20201225,경원선,가능,2802,2707,5509,20201228
20201225,장항선,배방,472,480,952,20201228
20201225,장항선,온양온천,2020,2004,4024,20201228
20201225,장항선,신창(순천향대),631,541,1172,20201228
20201225,중앙선,회기,9865,8938,18803,20201228
20201225,중앙선,중랑,2431,2276,4707,20201228
20201225,중앙선,상봉(시외버스터미널),2697,2626,5323,20201228
20201225,중앙선,망우,3216,3197,6413,20201228
20201225,중앙선,양원,584,579,1163,20201228
20201225,경원선,의정부,9197,9484,18681,20201228
20201225,경원선,회룡,4654,4808,9462,20201228
20201225,경원선,망월사,3011,3068,6079,20201228
20201225,경원선,도봉산,4878,3232,8110,20201228
20201225,경원선,도봉,2376,2360,4736,20201228
20201225,경원선,방학,4140,4071,8211,20201228
20201225,경원선,녹천,1783,1458,3241,20201228
20201225,경원선,월계,2644,2636,5280,20201228
20201225,경원선,광운대,3271,3064,6335,20201228
20201225,경원선,석계,3691,3729,7420,20201228
20201225,경원선,신이문,3605,3254,6859,20201228
20201225,경원선,외대앞,3440,3235,6675,20201228
20201225,경원선,청량리(서울시립대입구),7112,8112,15224,20201228
20201225,경원선,왕십리(성동구청),6175,7333,13508,20201228
20201225,경원선,응봉,715,620,1335,20201228
20201225,경원선,옥수,23,9,32,20201228
20201225,경원선,한남,1485,1360,2845,20201228
20201225,경원선,서빙고,611,560,1171,20201228
20201225,경원선,이촌(국립중앙박물관),1215,902,2117,20201228
20201225,경부선,광명,1018,1081,2099,20201228
20201225,경부선,서동탄,455,501,956,20201228
20201225,경부선,당정,2003,1905,3908,20201228
20201225,경부선,천안,2999,3233,6232,20201228
20201225,경부선,두정,2546,2555,5101,20201228
20201225,경부선,직산,349,312,661,20201228
20201225,경부선,성환,1554,1507,3061,20201228
20201225,경부선,평택,6395,6419,12814,20201228
20201225,경부선,지제,1319,1371,2690,20201228
20201225,경부선,서정리,3222,2843,6065,20201228
20201225,경부선,송탄,2354,2251,4605,20201228
20201225,경부선,진위,622,511,1133,20201228
20201225,경부선,오산,5060,4881,9941,20201228
20201225,경부선,오산대,1324,1179,2503,20201228
20201225,수인선,달월,36,38,74,20201228
20201225,중앙선,구리,5057,5296,10353,20201228
20201225,중앙선,도농,3221,3177,6398,20201228
20201225,중앙선,양정,286,275,561,20201228
20201225,중앙선,덕소,2287,2342,4629,20201228
20201225,중앙선,도심,843,734,1577,20201228
20201225,중앙선,팔당,678,710,1388,20201228
20201225,중앙선,운길산,497,491,988,20201228
20201225,중앙선,양수,913,867,1780,20201228
20201225,중앙선,신원,129,114,243,20201228
20201225,중앙선,국수,297,325,622,20201228
20201225,경부선,세마,1086,966,2052,20201228
20201225,경부선,병점,5863,5865,11728,20201228
20201225,경부선,세류,1285,1379,2664,20201228
20201225,경부선,독산,4661,4668,9329,20201228
20201225,경부선,수원,18690,20526,39216,20201228
20201225,경부선,화서,2488,2406,4894,20201228
20201225,경부선,성균관대,5010,4961,9971,20201228
20201225,경부선,의왕,3109,3038,6147,20201228
20201225,경부선,군포,2604,2445,5049,20201228
20201225,경부선,금정,9302,9515,18817,20201228
20201225,경부선,명학,2846,2722,5568,20201228
20201225,경부선,안양,8810,9056,17866,20201228
20201225,경부선,관악,2926,2842,5768,20201228
20201225,경부선,석수,3549,3379,6928,20201228
20201225,경부선,금천구청,4180,4283,8463,20201228
20201225,경부선,가산디지털단지,3164,4235,7399,20201228
20201225,경부선,구로,6846,6820,13666,20201228
20201225,경부선,신길,3380,2712,6092,20201228
20201225,경부선,신도림,1373,1287,2660,20201228
20201225,경부선,영등포,22643,23322,45965,20201228
20201225,경부선,대방,3852,3854,7706,20201228
20201225,경부선,노량진,4660,4592,9252,20201228
20201225,경부선,용산,14018,15984,30002,20201228
20201225,경부선,남영,2776,2833,5609,20201228
20201225,경부선,서울역,1499,695,2194,20201228
20201225,경강선,여주,816,878,1694,20201228
20201225,경강선,세종대왕릉,116,134,250,20201228
20201225,경강선,부발,800,624,1424,20201228
20201225,경강선,이천,1172,1189,2361,20201228
20201225,경강선,신둔도예촌,450,433,883,20201228
20201225,경강선,곤지암,877,780,1657,20201228
20201225,경강선,초월,1079,1018,2097,20201228
20201225,경강선,경기광주,2355,2362,4717,20201228
20201225,경강선,삼동,712,646,1358,20201228
20201225,경강선,이매,346,210,556,20201228
20201225,경강선,판교,1529,1425,2954,20201228
20201225,9호선2~3단계,중앙보훈병원,1919,1808,3727,20201228
20201225,9호선2~3단계,둔촌오륜,274,272,546,20201228
20201225,9호선2~3단계,올림픽공원(한국체대),1617,1614,3231,20201228
20201225,9호선2~3단계,한성백제,783,643,1426,20201228
20201225,9호선2~3단계,송파나루,1686,1703,3389,20201228
20201225,9호선2~3단계,석촌,2717,2272,4989,20201228
20201225,9호선2~3단계,석촌고분,2078,2031,4109,20201228
20201225,9호선2~3단계,삼전,2491,2308,4799,20201228
20201225,9호선2~3단계,종합운동장,1269,1147,2416,20201228
20201225,9호선2~3단계,봉은사,4767,4702,9469,20201228
20201225,9호선2~3단계,삼성중앙,1347,1311,2658,20201228
20201225,9호선2~3단계,선정릉,1798,1965,3763,20201228
20201225,9호선2~3단계,언주,2106,2004,4110,20201228
20201225,9호선,신논현,8704,8426,17130,20201228
20201225,9호선,사평,792,746,1538,20201228
20201225,9호선,고속터미널,4817,6652,11469,20201228
20201225,9호선,신반포,720,732,1452,20201228
20201225,9호선,구반포,699,776,1475,20201228
20201225,9호선,동작(현충원),578,474,1052,20201228
20201225,중앙선,아신,270,280,550,20201228
20201225,9호선,흑석(중앙대입구),2556,2527,5083,20201228
20201225,9호선,노들,1536,1352,2888,20201228
20201225,9호선,노량진,9713,9515,19228,20201228
20201225,9호선,샛강,1119,1056,2175,20201228
20201225,9호선,여의도,3436,3305,6741,20201228
20201225,9호선,국회의사당,2010,1928,3938,20201228
20201225,9호선,당산,5172,4936,10108,20201228
20201225,9호선,선유도,1660,1560,3220,20201228
20201225,9호선,신목동,968,871,1839,20201228
20201225,9호선,염창,5497,5232,10729,20201228
20201225,9호선,등촌,3607,3471,7078,20201228
20201225,9호선,증미,2349,2348,4697,20201228
20201225,9호선,가양,6723,6488,13211,20201228
20201225,9호선,양천향교,2718,2657,5375,20201228
20201225,9호선,마곡나루(서울식물원),3267,3136,6403,20201228
20201225,9호선,신방화,2365,2257,4622,20201228
20201225,9호선,공항시장,1258,1283,2541,20201228
20201225,9호선,김포공항,4218,6935,11153,20201228
20201225,9호선,개화,720,603,1323,20201228
20201225,8호선,모란,1998,1625,3623,20201228
20201225,8호선,수진,2273,1975,4248,20201228
20201225,8호선,신흥,2155,2280,4435,20201228
20201225,8호선,단대오거리,4115,3746,7861,20201228
20201225,8호선,남한산성입구(성남법원.검찰청),5061,4406,9467,20201228
20201225,8호선,산성,2787,2769,5556,20201228
20201225,8호선,복정,3376,3114,6490,20201228
20201225,8호선,장지,6591,6784,13375,20201228
20201225,8호선,문정,3484,3356,6840,20201228
20201225,8호선,가락시장,3303,3808,7111,20201228
20201225,8호선,송파,2486,2501,4987,20201228
20201225,8호선,석촌,2806,3286,6092,20201228
20201225,8호선,잠실(송파구청),7414,8091,15505,20201228
20201225,8호선,몽촌토성(평화의문),2246,2201,4447,20201228
20201225,8호선,강동구청,3162,3177,6339,20201228
20201225,8호선,천호(풍납토성),7100,7936,15036,20201228
20201225,8호선,암사,6650,6241,12891,20201228
20201225,7호선,부평구청,3448,3082,6530,20201228
20201225,7호선,굴포천,3073,3264,6337,20201228
20201225,7호선,삼산체육관,1464,1374,2838,20201228
20201225,7호선,상동,4203,4183,8386,20201228
20201225,7호선,부천시청,4863,4879,9742,20201228
20201225,7호선,신중동,4628,4443,9071,20201228
20201225,7호선,춘의,2780,2689,5469,20201228
20201225,7호선,부천종합운동장,1647,1546,3193,20201228
20201225,7호선,까치울,2494,2598,5092,20201228
20201225,7호선,온수(성공회대입구),2830,2850,5680,20201228
20201225,7호선,천왕,3353,3243,6596,20201228
20201225,7호선,광명사거리,9224,9246,18470,20201228
20201225,7호선,철산,7084,7211,14295,20201228
20201225,7호선,가산디지털단지,8140,7388,15528,20201228
20201225,7호선,남구로,5130,5247,10377,20201228
20201225,7호선,대림(구로구청),3946,3918,7864,20201228
20201225,7호선,신풍,4063,3912,7975,20201228
20201225,7호선,보라매,2878,2720,5598,20201228
20201225,7호선,신대방삼거리,5780,5493,11273,20201228
20201225,7호선,장승배기,3614,3431,7045,20201228
20201225,7호선,상도,3664,3434,7098,20201228
20201225,7호선,숭실대입구(살피재),3818,3810,7628,20201228
20201225,7호선,남성,4009,3768,7777,20201228
20201225,7호선,이수,5198,4839,10037,20201228
20201225,7호선,내방,3711,3622,7333,20201228
20201225,7호선,고속터미널,5222,4724,9946,20201228
20201225,7호선,반포,1908,1825,3733,20201228
20201225,7호선,논현,4506,4732,9238,20201228
20201225,7호선,학동,3709,3834,7543,20201228
20201225,7호선,강남구청,3557,3784,7341,20201228
20201225,7호선,청담,4495,4865,9360,20201228
20201225,7호선,뚝섬유원지,3011,2855,5866,20201228
20201225,7호선,건대입구,5848,5575,11423,20201228
20201225,7호선,어린이대공원(세종대),4329,3979,8308,20201228
20201225,7호선,군자(능동),5618,4314,9932,20201228
20201225,7호선,중곡,3691,3600,7291,20201228
20201225,7호선,용마산(용마폭포공원),2451,2472,4923,20201228
20201225,7호선,사가정,6820,6595,13415,20201228
20201225,7호선,면목,6199,6188,12387,20201228
20201225,7호선,상봉(시외버스터미널),7079,6956,14035,20201228
20201225,7호선,중화,4308,4179,8487,20201228
20201225,7호선,먹골,4014,3956,7970,20201228
20201225,7호선,태릉입구,3086,2789,5875,20201228
20201225,7호선,공릉(서울과학기술대),4480,4343,8823,20201228
20201225,7호선,하계,6013,5685,11698,20201228
20201225,7호선,중계,4617,4280,8897,20201228
20201225,7호선,노원,7545,7656,15201,20201228
20201225,7호선,마들,4466,4207,8673,20201228
20201225,7호선,수락산,5121,5142,10263,20201228
20201225,7호선,도봉산,3123,4652,7775,20201228
20201225,7호선,장암,633,431,1064,20201228
20201225,6호선,봉화산(서울의료원),2682,2637,5319,20201228
20201225,6호선,화랑대(서울여대입구),3042,2628,5670,20201228
20201225,6호선,태릉입구,1960,2119,4079,20201228
20201225,6호선,석계,4699,4626,9325,20201228
20201225,6호선,돌곶이,3136,2842,5978,20201228
20201225,6호선,상월곡(한국과학기술연구원),2368,2052,4420,20201228
20201225,6호선,월곡(동덕여대),4002,3964,7966,20201228
20201225,6호선,고려대(종암),2830,2539,5369,20201228
20201225,6호선,안암(고대병원앞),2968,2811,5779,20201228
20201225,6호선,보문,2761,2547,5308,20201228
20201225,6호선,창신,1155,998,2153,20201228
20201225,6호선,동묘앞,3982,3531,7513,20201228
20201225,6호선,신당,3133,2853,5986,20201228
20201225,6호선,청구,1320,1394,2714,20201228
20201225,6호선,약수,1122,1142,2264,20201228
20201225,6호선,버티고개,752,753,1505,20201228
20201225,6호선,한강진,2758,3311,6069,20201228
20201225,6호선,이태원,4829,4990,9819,20201228
20201226,경부선,성환,1690,1662,3352,20201229
20201226,경부선,두정,2609,2605,5214,20201229
20201226,경부선,천안,3137,3136,6273,20201229
20201226,경부선,당정,2175,2157,4332,20201229
20201226,경부선,서동탄,531,537,1068,20201229
20201226,경부선,광명,1194,1038,2232,20201229
20201226,경원선,이촌(국립중앙박물관),1677,1265,2942,20201229
20201226,경원선,서빙고,697,649,1346,20201229
20201226,경원선,한남,1676,1528,3204,20201229
20201226,경원선,옥수,21,13,34,20201229
20201226,경원선,응봉,879,762,1641,20201229
20201226,경원선,왕십리(성동구청),6349,7479,13828,20201229
20201226,경원선,청량리(서울시립대입구),7753,8552,16305,20201229
20201226,경원선,외대앞,3548,3449,6997,20201229
20201226,경원선,신이문,3911,3774,7685,20201229
20201226,경원선,석계,3879,4357,8236,20201229
20201226,경원선,광운대,3523,3433,6956,20201229
20201226,경원선,월계,2971,2926,5897,20201229
20201226,경원선,녹천,2045,1822,3867,20201229
20201226,경원선,방학,4762,4787,9549,20201229
20201226,경원선,도봉,2940,2799,5739,20201229
20201226,경원선,도봉산,6250,4107,10357,20201229
20201226,경원선,망월사,3445,3565,7010,20201229
20201226,경원선,회룡,5754,5816,11570,20201229
20201226,경원선,의정부,9917,10205,20122,20201229
20201226,경원선,가능,3206,3076,6282,20201229
20201226,경원선,녹양,2098,2054,4152,20201229
20201226,경원선,양주,3501,3417,6918,20201229
20201226,경원선,덕계,1294,1216,2510,20201229
20201226,경원선,덕정,2457,2414,4871,20201229
20201226,경원선,지행,3010,2990,6000,20201229
20201226,경원선,동두천중앙,1646,1641,3287,20201229
20201226,경원선,보산,976,1005,1981,20201229
20201226,경원선,동두천,920,1122,2042,20201229
20201226,경원선,소요산,2358,2146,4504,20201229
20201226,경의선,서울역,631,694,1325,20201229
20201226,경의선,신촌,214,236,450,20201229
20201226,경의선,효창공원앞,975,1102,2077,20201229
20201226,4호선,수유(강북구청),16259,15834,32093,20201229
20201226,경의선,공덕,1338,1073,2411,20201229
20201226,경의선,서강대,972,918,1890,20201229
20201226,경의선,홍대입구,837,834,1671,20201229
20201226,경의선,가좌,2215,2112,4327,20201229
20201226,경의선,디지털미디어시티,1018,945,1963,20201229
20201226,경의선,수색,699,708,1407,20201229
20201226,경의선,화전,567,557,1124,20201229
20201226,경의선,강매,1024,991,2015,20201229
20201226,경의선,행신,2745,2675,5420,20201229
20201226,경의선,능곡,1587,1575,3162,20201229
20201226,경의선,곡산,234,230,464,20201229
20201226,경의선,백마,2165,2125,4290,20201229
20201226,경의선,풍산,2233,2315,4548,20201229
20201226,경의선,일산,3283,3239,6522,20201229
20201226,경의선,탄현,2897,2814,5711,20201229
20201226,경의선,야당,2595,2574,5169,20201229
20201226,경의선,운정,2261,2193,4454,20201229
20201226,경의선,금릉,1862,1893,3755,20201229
20201226,경의선,금촌,3144,3102,6246,20201229
20201226,경의선,월롱,662,695,1357,20201229
20201226,경의선,파주,507,411,918,20201229
20201226,경의선,문산,2384,2353,4737,20201229
20201226,경의선,임진강,25,22,47,20201229
20201226,경인선,개봉,9489,9869,19358,20201229
20201226,경인선,오류동,5539,5341,10880,20201229
20201226,경인선,역곡,11835,12281,24116,20201229
20201226,경인선,부천,17667,18180,35847,20201229
20201226,경인선,송내,10109,10439,20548,20201229
20201226,경인선,부평,15749,16802,32551,20201229
20201226,경인선,백운,3413,3367,6780,20201229
20201226,경인선,동암,7918,8186,16104,20201229
20201226,경인선,주안,9101,8216,17317,20201229
20201226,경인선,제물포,4229,4192,8421,20201229
20201226,경인선,동인천,6912,6789,13701,20201229
20201226,경인선,인천,2188,1743,3931,20201229
20201226,경인선,구일,2422,2400,4822,20201229
20201226,경인선,소사,4683,4142,8825,20201229
20201226,경인선,부개,3712,3619,7331,20201229
20201226,경인선,간석,2408,2350,4758,20201229
20201226,경인선,도원,1383,1409,2792,20201229
20201226,경인선,온수(성공회대입구),2832,2740,5572,20201229
20201226,경인선,중동,3945,3819,7764,20201229
20201226,경인선,도화,1925,1762,3687,20201229
20201226,경춘선,신내,616,624,1240,20201229
20201226,경춘선,갈매,1119,1051,2170,20201229
20201226,경춘선,별내,1238,1210,2448,20201229
20201226,경춘선,퇴계원,1616,1572,3188,20201229
20201226,경춘선,사릉,1372,1396,2768,20201229
20201226,경춘선,금곡,646,620,1266,20201229
20201226,경춘선,평내호평,2449,2448,4897,20201229
20201226,경춘선,천마산,821,831,1652,20201229
20201226,경춘선,마석,1688,1774,3462,20201229
20201226,경춘선,대성리,352,306,658,20201229
20201226,경춘선,청평,838,813,1651,20201229
20201226,경춘선,상천,204,168,372,20201229
20201226,경춘선,가평,877,770,1647,20201229
20201226,경춘선,굴봉산,86,100,186,20201229
20201226,경춘선,백양리,64,57,121,20201229
20201226,경춘선,강촌,289,293,582,20201229
20201226,경춘선,김유정,176,171,347,20201229
20201226,경춘선,남춘천,1178,1127,2305,20201229
20201226,경춘선,춘천,709,644,1353,20201229
20201226,공항철도 1호선,서울역,3048,2723,5771,20201229
20201226,공항철도 1호선,공덕,759,1119,1878,20201229
20201226,공항철도 1호선,홍대입구,4124,3867,7991,20201229
20201226,공항철도 1호선,디지털미디어시티,2584,2476,5060,20201229
20201226,공항철도 1호선,마곡나루(서울식물원),1368,1427,2795,20201229
20201226,공항철도 1호선,김포공항,5281,2960,8241,20201229
20201226,공항철도 1호선,계양,3404,3387,6791,20201229
20201226,공항철도 1호선,검암,2591,2759,5350,20201229
20201226,공항철도 1호선,청라국제도시,1995,1924,3919,20201229
20201226,공항철도 1호선,운서,3660,3470,7130,20201229
20201226,공항철도 1호선,공항화물청사,1073,1135,2208,20201229
20201226,공항철도 1호선,인천공항1터미널,2365,2458,4823,20201229
20201226,공항철도 1호선,인천공항2터미널,1340,1197,2537,20201229
20201226,공항철도 1호선,영종,1569,1508,3077,20201229
20201226,과천선,선바위,2566,2560,5126,20201229
20201226,과천선,경마공원,596,584,1180,20201229
20201226,과천선,대공원,1813,2051,3864,20201229
20201226,과천선,과천,2296,2081,4377,20201229
20201226,과천선,정부과천청사,2784,2863,5647,20201229
20201226,과천선,인덕원,7980,8036,16016,20201229
20201226,과천선,평촌,4898,4910,9808,20201229
20201226,과천선,범계,10475,10142,20617,20201229
20201226,분당선,선릉,2807,3939,6746,20201229
20201226,분당선,한티,5613,5705,11318,20201229
20201226,분당선,도곡,2347,2196,4543,20201229
20201226,분당선,구룡,662,638,1300,20201229
20201226,분당선,개포동,1467,1455,2922,20201229
20201226,분당선,대모산입구,1557,1445,3002,20201229
20201226,분당선,수서,4663,4871,9534,20201229
20201226,분당선,수원,4020,3332,7352,20201229
20201226,분당선,서울숲,2900,2734,5634,20201229
20201226,분당선,압구정로데오,8859,9504,18363,20201229
20201226,분당선,강남구청,2660,3142,5802,20201229
20201226,분당선,선정릉,1956,1897,3853,20201229
20201226,분당선,가천대,2669,3124,5793,20201229
20201226,분당선,태평,6913,6745,13658,20201229
20201226,분당선,모란,9841,10046,19887,20201229
20201226,분당선,야탑,9477,10083,19560,20201229
20201226,분당선,서현,10517,10246,20763,20201229
20201226,분당선,수내,5031,4937,9968,20201229
20201226,분당선,정자,5805,5948,11753,20201229
20201226,분당선,미금,6564,6803,13367,20201229
20201226,분당선,오리,4636,3905,8541,20201229
20201226,분당선,이매,1935,1921,3856,20201229
20201226,분당선,보정,834,740,1574,20201229
20201226,분당선,죽전,6998,7397,14395,20201229
20201226,분당선,구성,1780,1849,3629,20201229
20201226,분당선,신갈,1498,1512,3010,20201229
20201226,분당선,기흥,3721,3623,7344,20201229
20201226,5호선,방화,2869,2685,5554,20201229
20201226,4호선,쌍문,13168,12311,25479,20201229
20201226,4호선,창동,11769,12773,24542,20201229
20201226,4호선,노원,9048,9802,18850,20201229
20201226,4호선,상계,8559,8169,16728,20201229
20201226,4호선,당고개,5929,5677,11606,20201229
20201226,4호선,남태령,391,335,726,20201229
20201226,4호선,사당,9499,8489,17988,20201229
20201226,4호선,총신대입구(이수),8410,9290,17700,20201229
20201226,4호선,동작(현충원),1292,1283,2575,20201229
20201226,4호선,이촌(국립중앙박물관),2534,2847,5381,20201229
20201226,4호선,신용산,4765,4915,9680,20201229
20201226,4호선,삼각지,1311,1537,2848,20201229
20201226,4호선,숙대입구(갈월),4461,4302,8763,20201229
20201226,4호선,서울역,2887,4585,7472,20201229
20201226,4호선,회현(남대문시장),9501,9615,19116,20201229
20201226,4호선,명동,7296,7542,14838,20201229
20201226,4호선,충무로,6498,6589,13087,20201229
20201226,4호선,동대문역사문화공원(DDP),6143,5118,11261,20201229
20201226,4호선,동대문,7627,7625,15252,20201229
20201226,4호선,혜화,10721,10534,21255,20201229
20201226,4호선,한성대입구(삼선교),5802,5593,11395,20201229
20201226,4호선,성신여대입구(돈암),8966,8473,17439,20201229
20201226,4호선,길음,7655,7512,15167,20201229
20201226,4호선,미아사거리,13403,13295,26698,20201229
20201226,4호선,미아(서울사이버대학),7019,6925,13944,20201229
20201226,수인선,사리,1561,1450,3011,20201229
20201226,수인선,야목,94,74,168,20201229
20201226,수인선,어천,279,259,538,20201229
20201226,수인선,오목천,896,882,1778,20201229
20201226,수인선,고색,1114,1174,2288,20201229
20201226,분당선,매교,1129,1180,2309,20201229
20201226,분당선,수원시청,5826,5537,11363,20201229
20201226,분당선,매탄권선,1819,1758,3577,20201229
20201226,분당선,망포,4711,4506,9217,20201229
20201226,분당선,영통,3321,3354,6675,20201229
20201226,분당선,청명,1379,1432,2811,20201229
20201226,분당선,상갈,2164,2151,4315,20201229
20201226,2호선,한양대,1640,1697,3337,20201229
20201226,2호선,대림(구로구청),11457,12476,23933,20201229
20201226,2호선,구로디지털단지,20180,20562,40742,20201229
20201226,2호선,신대방,12365,12260,24625,20201229
20201226,2호선,신림,30021,28919,58940,20201229
20201226,2호선,봉천,10437,9961,20398,20201229
20201226,2호선,서울대입구(관악구청),20465,20312,40777,20201229
20201226,2호선,낙성대(강감찬),11740,11371,23111,20201229
20201226,2호선,사당,14689,16051,30740,20201229
20201226,2호선,방배,5432,5527,10959,20201229
20201226,2호선,서초,5085,4767,9852,20201229
20201226,2호선,교대(법원.검찰청),8787,9680,18467,20201229
20201226,2호선,강남,27724,27126,54850,20201229
20201226,2호선,역삼,10469,10863,21332,20201229
20201226,2호선,선릉,13188,11485,24673,20201229
20201226,5호선,명일,3233,3372,6605,20201229
20201226,5호선,고덕,3293,3172,6465,20201229
20201226,2호선,삼성(무역센터),14008,13729,27737,20201229
20201226,5호선,상일동,5478,5196,10674,20201229
20201226,5호선,화곡,11963,11312,23275,20201229
20201226,5호선,까치산,12877,12778,25655,20201229
20201226,5호선,둔촌동,3645,3693,7338,20201229
20201226,5호선,올림픽공원(한국체대),1704,1506,3210,20201229
20201226,5호선,방이,2668,2642,5310,20201229
20201226,5호선,오금,1209,1171,2380,20201229
20201226,5호선,개롱,2393,2585,4978,20201229
20201226,5호선,거여,3038,3040,6078,20201229
20201226,5호선,마천,2838,2953,5791,20201229
20201226,5호선,미사,5552,5450,11002,20201229
20201226,5호선,하남풍산,2063,2090,4153,20201229
20201226,6호선,응암,7842,8092,15934,20201229
20201226,6호선,역촌,1579,1829,3408,20201229
20201226,6호선,불광,2327,2294,4621,20201229
20201226,6호선,독바위,1318,1531,2849,20201229
20201226,6호선,구산,3119,2516,5635,20201229
20201226,6호선,새절(신사),5358,5243,10601,20201229
20201226,6호선,증산(명지대앞),4737,4836,9573,20201229
20201226,6호선,디지털미디어시티,4311,4512,8823,20201229
20201226,6호선,월드컵경기장(성산),3074,2992,6066,20201229
20201226,6호선,마포구청,5630,5147,10777,20201229
20201226,6호선,망원,6780,7355,14135,20201229
20201226,6호선,합정,5671,5210,10881,20201229
20201226,6호선,상수,3161,3581,6742,20201229
20201226,6호선,광흥창(서강),2899,2619,5518,20201229
20201226,6호선,대흥(서강대앞),2845,2869,5714,20201229
20201226,6호선,공덕,5647,5481,11128,20201229
20201226,6호선,효창공원앞,2658,2325,4983,20201229
20201226,6호선,삼각지,1958,1616,3574,20201229
20201226,6호선,녹사평(용산구청),2204,2123,4327,20201229
20201226,6호선,이태원,4782,4942,9724,20201229
20201226,6호선,한강진,2855,3236,6091,20201229
20201226,6호선,버티고개,915,947,1862,20201229
20201226,6호선,약수,1511,1470,2981,20201229
20201226,6호선,청구,1469,1541,3010,20201229
20201226,6호선,신당,2920,2539,5459,20201229
20201226,1호선,서울역,13733,13264,26997,20201229
20201226,1호선,동묘앞,7777,8079,15856,20201229
20201226,1호선,시청,5183,4842,10025,20201229
20201226,1호선,종각,8381,7655,16036,20201229
20201226,1호선,종로3가,10569,9684,20253,20201229
20201226,1호선,종로5가,9435,9408,18843,20201229
20201226,1호선,동대문,6417,5956,12373,20201229
20201226,1호선,신설동,5952,5745,11697,20201229
20201226,1호선,제기동,10097,10661,20758,20201229
20201226,1호선,청량리(서울시립대입구),11861,11717,23578,20201229
20201226,2호선,시청,4145,3362,7507,20201229
20201226,2호선,을지로입구,12277,11924,24201,20201229
20201226,2호선,을지로3가,4498,4191,8689,20201229
20201226,2호선,을지로4가,4462,4407,8869,20201229
20201226,중앙선,국수,375,407,782,20201229
20201226,2호선,동대문역사문화공원(DDP),5097,5108,10205,20201229
20201226,2호선,신당,6538,6753,13291,20201229
20201226,2호선,상왕십리,5339,5237,10576,20201229
20201226,2호선,왕십리(성동구청),6798,5604,12402,20201229
20201226,2호선,뚝섬,5226,5584,10810,20201229
20201226,2호선,성수,7284,8116,15400,20201229
20201226,2호선,건대입구,15579,16690,32269,20201229
20201226,2호선,구의(광진구청),9444,9603,19047,20201229
20201226,2호선,강변(동서울터미널),12677,12666,25343,20201229
20201226,2호선,잠실나루,3927,3824,7751,20201229
20201226,2호선,잠실(송파구청),28999,27825,56824,20201229
20201226,2호선,잠실새내,8530,8804,17334,20201229
20201226,2호선,종합운동장,2289,2421,4710,20201229
20201226,중앙선,팔당,823,820,1643,20201229
20201226,5호선,신정(은행정),5422,4777,10199,20201229
20201226,5호선,목동,6196,6536,12732,20201229
20201226,8호선,석촌,3285,3832,7117,20201229
20201226,중앙선,도심,989,881,1870,20201229
20201226,중앙선,덕소,2634,2722,5356,20201229
20201226,중앙선,양정,337,294,631,20201229
20201226,중앙선,도농,3722,3646,7368,20201229
20201226,중앙선,구리,5740,6013,11753,20201229
20201226,중앙선,양원,635,624,1259,20201229
20201226,중앙선,망우,3647,3727,7374,20201229
20201226,중앙선,상봉(시외버스터미널),2911,2887,5798,20201229
20201226,중앙선,중랑,2808,2680,5488,20201229
20201226,중앙선,회기,10282,9660,19942,20201229
20201226,장항선,신창(순천향대),580,494,1074,20201229
20201226,안산선,안산,6347,6671,13018,20201229
20201226,안산선,초지,1647,1777,3424,20201229
20201226,안산선,고잔,3285,3132,6417,20201229
20201226,안산선,중앙,7513,7791,15304,20201229
20201226,안산선,한대앞,3752,3845,7597,20201229
20201226,안산선,상록수,7458,7513,14971,20201229
20201226,안산선,반월,1968,1949,3917,20201229
20201226,안산선,대야미,2390,2118,4508,20201229
20201226,안산선,산본,6918,7443,14361,20201229
20201226,수인선,인천,711,1048,1759,20201229
20201226,수인선,신포,880,880,1760,20201229
20201226,수인선,숭의,1711,1548,3259,20201229
20201226,수인선,인하대,2472,2311,4783,20201229
20201226,수인선,송도,1241,1148,2389,20201229
20201226,수인선,연수,2306,2289,4595,20201229
20201226,수인선,원인재,2177,2285,4462,20201229
20201226,수인선,남동인더스파크,621,616,1237,20201229
20201226,수인선,호구포,1596,1471,3067,20201229
20201226,수인선,인천논현,2617,2758,5375,20201229
20201226,수인선,소래포구,3191,3180,6371,20201229
20201226,수인선,월곶,1318,1238,2556,20201229
20201226,수인선,달월,48,54,102,20201229
20201226,중앙선,운길산,731,655,1386,20201229
20201226,중앙선,양수,984,969,1953,20201229
20201226,중앙선,신원,145,91,236,20201229
20201226,중앙선,아신,331,285,616,20201229
20201226,중앙선,오빈,153,148,301,20201229
20201226,중앙선,양평,1182,1242,2424,20201229
20201226,중앙선,원덕,200,185,385,20201229
20201226,중앙선,용문,952,964,1916,20201229
20201226,중앙선,지평,12,25,37,20201229
20201226,5호선,발산,6575,6727,13302,20201229
20201226,5호선,마곡,2613,2591,5204,20201229
20201226,5호선,송정,3133,3142,6275,20201229
20201226,5호선,김포공항,4133,4102,8235,20201229
20201226,5호선,개화산,2239,2319,4558,20201229
20201226,6호선,동묘앞,4611,4340,8951,20201229
20201226,2호선,신도림,21313,21043,42356,20201229
20201226,2호선,문래,5818,6010,11828,20201229
20201226,2호선,영등포구청,7105,7294,14399,20201229
20201226,2호선,당산,6785,7484,14269,20201229
20201226,2호선,합정,11836,12293,24129,20201229
20201226,2호선,홍대입구,22322,22765,45087,20201229
20201226,2호선,신촌,16200,15686,31886,20201229
20201226,2호선,이대,4748,4798,9546,20201229
20201226,2호선,아현,4293,4242,8535,20201229
20201226,2호선,충정로(경기대입구),3049,3168,6217,20201229
20201226,2호선,용답,1264,1187,2451,20201229
20201226,2호선,신답,549,619,1168,20201229
20201226,2호선,신설동,1968,1903,3871,20201229
20201226,2호선,도림천,503,533,1036,20201229
20201226,2호선,양천구청,2425,2559,4984,20201229
20201226,2호선,신정네거리,4175,4293,8468,20201229
20201226,2호선,용두(동대문구청),1019,1072,2091,20201229
20201226,3호선,지축,1321,1299,2620,20201229
20201226,3호선,구파발,8448,8479,16927,20201229
20201226,3호선,연신내,18372,17524,35896,20201229
20201226,3호선,불광,8029,8973,17002,20201229
20201226,3호선,녹번,5885,5422,11307,20201229
20201226,3호선,홍제,7865,7742,15607,20201229
20201226,3호선,무악재,1617,1673,3290,20201229
20201226,3호선,독립문,3202,3462,6664,20201229
20201226,3호선,경복궁(정부서울청사),5862,5718,11580,20201229
20201226,3호선,안국,4776,4952,9728,20201229
20201226,3호선,종로3가,2453,3080,5533,20201229
20201226,3호선,을지로3가,2511,2588,5099,20201229
20201226,3호선,동대입구,3240,3612,6852,20201229
20201226,3호선,약수,5268,5017,10285,20201229
20201226,3호선,금호,3664,3516,7180,20201229
20201226,3호선,옥수,3884,3951,7835,20201229
20201226,3호선,압구정,14626,14871,29497,20201229
20201226,3호선,신사,12756,12926,25682,20201229
20201226,3호선,잠원,1846,1753,3599,20201229
20201226,3호선,고속터미널,23053,22990,46043,20201229
20201226,3호선,교대(법원.검찰청),2996,1918,4914,20201229
20201226,3호선,남부터미널(예술의전당),9792,10077,19869,20201229
20201226,3호선,양재(서초구청),9785,10656,20441,20201229
20201226,3호선,매봉,3328,3186,6514,20201229
20201226,3호선,도곡,1788,1747,3535,20201229
20201226,3호선,대치,4095,3942,8037,20201229
20201226,3호선,학여울,599,630,1229,20201229
20201226,3호선,대청,3196,3046,6242,20201229
20201226,3호선,일원,2490,2487,4977,20201229
20201226,3호선,수서,6307,6447,12754,20201229
20201226,3호선,가락시장,3870,3611,7481,20201229
20201226,3호선,경찰병원,2181,2205,4386,20201229
20201226,3호선,오금,1983,1886,3869,20201229
20201226,5호선,오목교(목동운동장앞),8846,9317,18163,20201229
20201226,5호선,양평,2129,2095,4224,20201229
20201226,5호선,영등포구청,1178,1183,2361,20201229
20201226,5호선,영등포시장,4024,4189,8213,20201229
20201226,5호선,신길,1429,1616,3045,20201229
20201226,5호선,여의도,4571,4696,9267,20201229
20201226,5호선,여의나루,2534,2385,4919,20201229
20201226,5호선,마포,3973,4050,8023,20201229
20201226,5호선,공덕,3669,3823,7492,20201229
20201226,5호선,애오개,2126,2127,4253,20201229
20201226,5호선,충정로(경기대입구),1116,1080,2196,20201229
20201226,5호선,서대문,3929,3826,7755,20201229
20201226,5호선,광화문(세종문화회관),6827,6437,13264,20201229
20201226,5호선,종로3가,4280,4163,8443,20201229
20201226,5호선,을지로4가,2062,2134,4196,20201229
20201226,5호선,동대문역사문화공원(DDP),644,689,1333,20201229
20201226,5호선,청구,1529,1385,2914,20201229
20201226,5호선,신금호,2432,2602,5034,20201229
20201226,5호선,행당,3152,2848,6000,20201229
20201226,5호선,왕십리(성동구청),1970,2193,4163,20201229
20201226,5호선,마장,2453,2267,4720,20201229
20201226,5호선,답십리,6273,6016,12289,20201229
20201226,5호선,장한평,6473,6414,12887,20201229
20201226,5호선,군자(능동),4751,5216,9967,20201229
20201226,5호선,아차산(어린이대공원후문),7481,7531,15012,20201229
20201226,5호선,광나루(장신대),5774,5677,11451,20201229
20201226,5호선,천호(풍납토성),10087,9642,19729,20201229
20201226,5호선,강동,7502,7215,14717,20201229
20201226,5호선,길동,3561,3714,7275,20201229
20201226,5호선,굽은다리(강동구민회관앞),4213,4057,8270,20201229
20201226,우이신설선,솔샘,2203,2063,4266,20201229
20201226,우이신설선,북한산보국문,2639,2548,5187,20201229
20201226,우이신설선,정릉,2062,1856,3918,20201229
20201226,우이신설선,성신여대입구(돈암),1565,1774,3339,20201229
20201226,우이신설선,보문,722,708,1430,20201229
20201226,5호선,우장산,5454,5685,11139,20201229
20201226,우이신설선,신설동,1055,933,1988,20201229
20201226,일산선,원흥,3971,3819,7790,20201229
20201226,일산선,삼송,8052,8106,16158,20201229
20201226,일산선,원당,4882,4772,9654,20201229
20201226,일산선,화정,7556,7873,15429,20201229
20201226,일산선,대곡,689,590,1279,20201229
20201226,일산선,백석,4665,4813,9478,20201229
20201226,일산선,마두,3021,3062,6083,20201229
20201226,일산선,정발산,3606,3572,7178,20201229
20201226,일산선,주엽,3576,3665,7241,20201229
20201226,일산선,대화,4862,4544,9406,20201229
20201226,장항선,봉명,473,418,891,20201229
20201226,장항선,쌍용(나사렛대),820,758,1578,20201229
20201226,장항선,아산,1317,1184,2501,20201229
20201226,장항선,배방,474,463,937,20201229
20201226,장항선,온양온천,2030,2081,4111,20201229
20201226,안산선,신길온천,791,772,1563,20201229
20201226,안산선,정왕,3640,3662,7302,20201229
20201226,안산선,오이도,4247,4302,8549,20201229
20201226,안산선,수리산,1765,1744,3509,20201229
20201226,우이신설선,북한산우이,1811,1863,3674,20201229
20201226,우이신설선,솔밭공원,1177,1191,2368,20201229
20201226,우이신설선,4.19민주묘지,1440,1207,2647,20201229
20201226,우이신설선,가오리,1798,1796,3594,20201229
20201226,우이신설선,화계,1679,1601,3280,20201229
20201226,우이신설선,삼양,1043,1173,2216,20201229
20201226,우이신설선,삼양사거리,1260,1357,2617,20201229
20201226,6호선,창신,1319,1150,2469,20201229
20201226,6호선,보문,2987,2754,5741,20201229
20201226,6호선,안암(고대병원앞),4032,4066,8098,20201229
20201226,6호선,고려대(종암),3706,3402,7108,20201229
20201226,6호선,월곡(동덕여대),4560,4612,9172,20201229
20201226,6호선,상월곡(한국과학기술연구원),2558,2290,4848,20201229
20201226,6호선,돌곶이,3479,3326,6805,20201229
20201226,6호선,석계,5199,5132,10331,20201229
20201226,6호선,태릉입구,2307,2468,4775,20201229
20201226,6호선,화랑대(서울여대입구),3648,3240,6888,20201229
20201226,6호선,봉화산(서울의료원),3093,3152,6245,20201229
20201226,7호선,장암,878,609,1487,20201229
20201226,7호선,도봉산,3822,5749,9571,20201229
20201226,7호선,수락산,6300,6489,12789,20201229
20201226,7호선,마들,5396,5249,10645,20201229
20201226,7호선,노원,9339,9541,18880,20201229
20201226,7호선,중계,5605,5011,10616,20201229
20201226,7호선,하계,7165,6877,14042,20201229
20201226,7호선,공릉(서울과학기술대),4911,5014,9925,20201229
20201226,7호선,태릉입구,3703,3426,7129,20201229
20201226,7호선,먹골,4795,4746,9541,20201229
20201226,7호선,중화,4994,4948,9942,20201229
20201226,7호선,상봉(시외버스터미널),8117,7741,15858,20201229
20201226,7호선,면목,7083,7196,14279,20201229
20201226,7호선,사가정,8037,8066,16103,20201229
20201226,7호선,용마산(용마폭포공원),2810,2791,5601,20201229
20201226,7호선,중곡,4344,4300,8644,20201229
20201226,7호선,군자(능동),6570,5201,11771,20201229
20201226,7호선,어린이대공원(세종대),4724,4409,9133,20201229
20201226,7호선,건대입구,6005,5873,11878,20201229
20201226,7호선,뚝섬유원지,3520,3350,6870,20201229
20201226,7호선,청담,6853,6858,13711,20201229
20201226,7호선,강남구청,5639,5937,11576,20201229
20201226,7호선,학동,6001,6106,12107,20201229
20201226,7호선,논현,7038,7414,14452,20201229
20201226,7호선,반포,2688,2484,5172,20201229
20201226,7호선,고속터미널,6705,5553,12258,20201229
20201226,7호선,내방,4690,4583,9273,20201229
20201226,7호선,이수,6603,6330,12933,20201229
20201226,7호선,남성,4799,4597,9396,20201229
20201226,7호선,숭실대입구(살피재),4622,4667,9289,20201229
20201226,7호선,상도,4431,4128,8559,20201229
20201226,7호선,장승배기,4403,4295,8698,20201229
20201226,7호선,신대방삼거리,6964,6716,13680,20201229
20201226,7호선,보라매,3329,3347,6676,20201229
20201226,7호선,신풍,5000,4931,9931,20201229
20201226,7호선,대림(구로구청),4333,4606,8939,20201229
20201226,7호선,남구로,5837,6317,12154,20201229
20201226,7호선,가산디지털단지,9410,8539,17949,20201229
20201226,7호선,철산,8529,8706,17235,20201229
20201226,7호선,광명사거리,10863,11133,21996,20201229
20201226,7호선,천왕,3896,3833,7729,20201229
20201226,7호선,온수(성공회대입구),3573,3622,7195,20201229
20201226,7호선,까치울,2962,3083,6045,20201229
20201226,7호선,부천종합운동장,1910,1761,3671,20201229
20201226,7호선,춘의,3231,3286,6517,20201229
20201226,7호선,신중동,5527,5490,11017,20201229
20201226,7호선,부천시청,5338,5355,10693,20201229
20201226,7호선,상동,5003,5119,10122,20201229
20201226,7호선,삼산체육관,1586,1482,3068,20201229
20201226,7호선,굴포천,3552,3810,7362,20201229
20201226,7호선,부평구청,4056,3669,7725,20201229
20201226,8호선,암사,7838,7483,15321,20201229
20201226,8호선,천호(풍납토성),7785,8812,16597,20201229
20201226,8호선,강동구청,3727,3894,7621,20201229
20201226,8호선,몽촌토성(평화의문),2412,2471,4883,20201229
20201226,8호선,잠실(송파구청),6876,7310,14186,20201229
20201226,8호선,송파,3037,3150,6187,20201229
20201226,8호선,가락시장,3766,3777,7543,20201229
20201226,8호선,문정,4315,4413,8728,20201229
20201226,8호선,장지,7262,7476,14738,20201229
20201226,8호선,복정,3762,3508,7270,20201229
20201226,8호선,산성,3274,3404,6678,20201229
20201226,8호선,남한산성입구(성남법원.검찰청),5611,5329,10940,20201229
20201226,8호선,단대오거리,4380,4370,8750,20201229
20201226,8호선,신흥,2560,2699,5259,20201229
20201226,8호선,수진,2659,2488,5147,20201229
20201226,8호선,모란,2289,1875,4164,20201229
20201226,9호선,개화,808,673,1481,20201229
20201226,9호선,김포공항,4112,5740,9852,20201229
20201226,9호선,공항시장,1446,1517,2963,20201229
20201226,9호선,신방화,2734,2726,5460,20201229
20201226,9호선,마곡나루(서울식물원),3747,3677,7424,20201229
20201226,9호선,양천향교,3216,3234,6450,20201229
20201226,9호선,가양,8077,7821,15898,20201229
20201226,9호선,증미,2637,2623,5260,20201229
20201226,9호선,등촌,4282,4308,8590,20201229
20201226,9호선,염창,6416,6254,12670,20201229
20201226,9호선,신목동,1189,1095,2284,20201229
20201226,9호선,선유도,1905,1866,3771,20201229
20201226,9호선,당산,6379,5930,12309,20201229
20201226,9호선,국회의사당,2025,2017,4042,20201229
20201226,9호선,여의도,4006,3874,7880,20201229
20201226,9호선,샛강,1305,1291,2596,20201229
20201226,9호선,노량진,10456,10551,21007,20201229
20201226,9호선,노들,1806,1624,3430,20201229
20201226,9호선,흑석(중앙대입구),3165,3217,6382,20201229
20201226,9호선,동작(현충원),658,551,1209,20201229
20201226,9호선,구반포,991,1017,2008,20201229
20201226,9호선,신반포,1183,1149,2332,20201229
20201226,9호선,고속터미널,5896,7462,13358,20201229
20201226,9호선,사평,1050,1013,2063,20201229
20201226,9호선,신논현,12813,12339,25152,20201229
20201226,9호선2~3단계,언주,3196,3141,6337,20201229
20201226,9호선2~3단계,선정릉,2558,2672,5230,20201229
20201226,9호선2~3단계,삼성중앙,1585,1547,3132,20201229
20201226,9호선2~3단계,봉은사,4846,4722,9568,20201229
20201226,9호선2~3단계,종합운동장,1521,1429,2950,20201229
20201226,9호선2~3단계,삼전,2879,2771,5650,20201229
20201226,9호선2~3단계,석촌고분,2424,2414,4838,20201229
20201226,9호선2~3단계,석촌,3136,2700,5836,20201229
20201226,9호선2~3단계,송파나루,1916,1883,3799,20201229
20201226,9호선2~3단계,한성백제,937,829,1766,20201229
20201226,9호선2~3단계,올림픽공원(한국체대),2006,2008,4014,20201229
20201226,9호선2~3단계,둔촌오륜,371,338,709,20201229
20201226,9호선2~3단계,중앙보훈병원,2209,2133,4342,20201229
20201226,경강선,판교,1709,1595,3304,20201229
20201226,경강선,이매,445,331,776,20201229
20201226,경강선,삼동,870,803,1673,20201229
20201226,경강선,경기광주,2626,2681,5307,20201229
20201226,경강선,초월,1170,1172,2342,20201229
20201226,경강선,곤지암,951,973,1924,20201229
20201226,경강선,신둔도예촌,508,487,995,20201229
20201226,경강선,이천,1202,1329,2531,20201229
20201226,경강선,부발,841,794,1635,20201229
20201226,경강선,세종대왕릉,119,134,253,20201229
20201226,경강선,여주,982,1027,2009,20201229
20201226,경부선,서울역,1788,508,2296,20201229
20201226,경부선,남영,3080,3214,6294,20201229
20201226,경부선,용산,14794,14483,29277,20201229
20201226,경부선,노량진,4676,4591,9267,20201229
20201226,경부선,대방,4396,4439,8835,20201229
20201226,경부선,영등포,21309,21737,43046,20201229
20201226,경부선,신도림,1592,1638,3230,20201229
20201226,경부선,신길,3949,3185,7134,20201229
20201226,경부선,구로,7758,7925,15683,20201229
20201226,경부선,가산디지털단지,3440,4690,8130,20201229
20201226,경부선,금천구청,4770,4850,9620,20201229
20201226,경부선,석수,4057,3984,8041,20201229
20201226,경부선,관악,3462,3274,6736,20201229
20201226,경부선,안양,9480,9480,18960,20201229
20201226,경부선,명학,2996,3002,5998,20201229
20201226,경부선,금정,10681,10984,21665,20201229
20201226,경부선,군포,2798,2729,5527,20201229
20201226,경부선,의왕,3466,3486,6952,20201229
20201226,경부선,성균관대,5221,5471,10692,20201229
20201226,경부선,화서,2774,2848,5622,20201229
20201226,경부선,수원,18397,19238,37635,20201229
20201226,경부선,독산,5119,5270,10389,20201229
20201226,경부선,세류,1481,1454,2935,20201229
20201226,경부선,병점,6041,6058,12099,20201229
20201226,경부선,세마,1099,1007,2106,20201229
20201226,경부선,오산대,1435,1262,2697,20201229
20201226,경부선,오산,5089,5118,10207,20201229
20201226,경부선,진위,568,526,1094,20201229
20201226,경부선,송탄,2582,2371,4953,20201229
20201226,경부선,서정리,3672,3067,6739,20201229
20201226,경부선,지제,1533,1297,2830,20201229
20201226,경부선,평택,6870,6731,13601,20201229
20201226,경부선,직산,365,359,724,20201229
20201227,2호선,문래,3448,3567,7015,20201230
20201227,중앙선,지평,37,17,54,20201230
20201227,중앙선,용문,995,801,1796,20201230
20201227,중앙선,원덕,166,138,304,20201230
20201227,중앙선,양평,1034,904,1938,20201230
20201227,중앙선,오빈,112,102,214,20201230
20201227,중앙선,아신,265,235,500,20201230
20201227,중앙선,국수,332,309,641,20201230
20201227,1호선,서울역,13348,11318,24666,20201230
20201227,1호선,동묘앞,8395,8505,16900,20201230
20201227,1호선,시청,3840,3637,7477,20201230
20201227,1호선,종각,5669,5396,11065,20201230
20201227,1호선,종로3가,6869,6259,13128,20201230
20201227,1호선,종로5가,4127,4216,8343,20201230
20201227,1호선,동대문,5256,5831,11087,20201230
20201227,1호선,신설동,4463,4565,9028,20201230
20201227,1호선,제기동,6163,6545,12708,20201230
20201227,1호선,청량리(서울시립대입구),8205,7968,16173,20201230
20201227,2호선,시청,2830,2419,5249,20201230
20201227,2호선,을지로입구,9432,9052,18484,20201230
20201227,2호선,을지로3가,2920,2757,5677,20201230
20201227,2호선,을지로4가,1647,1591,3238,20201230
20201227,2호선,동대문역사문화공원(DDP),3807,4769,8576,20201230
20201227,2호선,신당,4872,5148,10020,20201230
20201227,2호선,상왕십리,3683,3800,7483,20201230
20201227,2호선,왕십리(성동구청),4636,3966,8602,20201230
20201227,2호선,한양대,1160,1293,2453,20201230
20201227,2호선,뚝섬,3717,3972,7689,20201230
20201227,2호선,성수,4758,5409,10167,20201230
20201227,2호선,건대입구,11947,12755,24702,20201230
20201227,2호선,구의(광진구청),6530,6798,13328,20201230
20201227,2호선,강변(동서울터미널),11294,10358,21652,20201230
20201227,2호선,잠실나루,2656,2765,5421,20201230
20201227,2호선,잠실(송파구청),21284,19793,41077,20201230
20201227,2호선,잠실새내,5241,5603,10844,20201230
20201227,2호선,종합운동장,1667,1794,3461,20201230
20201227,2호선,삼성(무역센터),10162,10093,20255,20201230
20201227,2호선,선릉,7071,6307,13378,20201230
20201227,2호선,역삼,6251,6904,13155,20201230
20201227,2호선,강남,14864,14335,29199,20201230
20201227,2호선,교대(법원.검찰청),5171,5715,10886,20201230
20201227,2호선,서초,3324,3121,6445,20201230
20201227,2호선,방배,3435,3644,7079,20201230
20201227,2호선,사당,10639,11875,22514,20201230
20201227,2호선,낙성대(강감찬),8536,9234,17770,20201230
20201227,2호선,서울대입구(관악구청),14771,15593,30364,20201230
20201227,2호선,봉천,7189,7039,14228,20201230
20201227,2호선,신림,21644,21775,43419,20201230
20201227,2호선,신대방,9250,9072,18322,20201230
20201227,2호선,구로디지털단지,13645,13641,27286,20201230
20201227,2호선,대림(구로구청),9054,8902,17956,20201230
20201227,2호선,신도림,14613,14411,29024,20201230
20201227,2호선,영등포구청,4224,4359,8583,20201230
20201227,2호선,당산,4730,5170,9900,20201230
20201227,2호선,합정,8752,9130,17882,20201230
20201227,2호선,홍대입구,17005,17059,34064,20201230
20201227,2호선,신촌,10080,10284,20364,20201230
20201227,2호선,이대,3231,3540,6771,20201230
20201227,2호선,아현,2902,2926,5828,20201230
20201227,2호선,충정로(경기대입구),2143,2195,4338,20201230
20201227,2호선,용답,948,988,1936,20201230
20201227,2호선,신답,398,443,841,20201230
20201227,2호선,신설동,1663,1737,3400,20201230
20201227,2호선,도림천,293,284,577,20201230
20201227,2호선,양천구청,1723,1759,3482,20201230
20201227,2호선,신정네거리,2731,2696,5427,20201230
20201227,2호선,용두(동대문구청),665,690,1355,20201230
20201227,3호선,지축,888,881,1769,20201230
20201227,3호선,구파발,6065,6032,12097,20201230
20201227,3호선,연신내,13041,12020,25061,20201230
20201227,3호선,불광,5673,6670,12343,20201230
20201227,3호선,녹번,3787,3595,7382,20201230
20201227,3호선,홍제,5207,5097,10304,20201230
20201227,3호선,무악재,1060,1067,2127,20201230
20201227,3호선,독립문,2268,2481,4749,20201230
20201227,3호선,경복궁(정부서울청사),4335,4518,8853,20201230
20201227,3호선,안국,3287,3628,6915,20201230
20201227,3호선,종로3가,1456,1866,3322,20201230
20201227,3호선,을지로3가,1261,1362,2623,20201230
20201227,3호선,동대입구,2555,2954,5509,20201230
20201227,3호선,약수,3566,3523,7089,20201230
20201227,3호선,금호,2581,2525,5106,20201230
20201227,3호선,옥수,2858,3018,5876,20201230
20201227,3호선,압구정,7278,7735,15013,20201230
20201227,3호선,신사,6565,6851,13416,20201230
20201227,3호선,잠원,1123,1130,2253,20201230
20201227,3호선,고속터미널,21271,18519,39790,20201230
20201227,3호선,교대(법원.검찰청),1838,1344,3182,20201230
20201227,3호선,남부터미널(예술의전당),7675,7487,15162,20201230
20201227,3호선,양재(서초구청),6208,7325,13533,20201230
20201227,3호선,매봉,2237,2207,4444,20201230
20201227,3호선,도곡,1120,1146,2266,20201230
20201227,3호선,대치,2363,2337,4700,20201230
20201227,3호선,학여울,442,393,835,20201230
20201227,3호선,대청,2237,2140,4377,20201230
20201227,3호선,일원,1723,1841,3564,20201230
20201227,3호선,수서,5210,5076,10286,20201230
20201227,3호선,가락시장,2139,2379,4518,20201230
20201227,3호선,경찰병원,1459,1546,3005,20201230
20201227,3호선,오금,1459,1358,2817,20201230
20201227,4호선,수유(강북구청),11814,11350,23164,20201230
20201227,4호선,미아(서울사이버대학),4693,4502,9195,20201230
20201227,4호선,미아사거리,9286,8918,18204,20201230
20201227,4호선,길음,5363,5349,10712,20201230
20201227,4호선,성신여대입구(돈암),6467,6295,12762,20201230
20201227,4호선,한성대입구(삼선교),4121,4230,8351,20201230
20201227,4호선,혜화,8024,8409,16433,20201230
20201227,4호선,동대문,3715,4338,8053,20201230
20201227,4호선,동대문역사문화공원(DDP),4688,5050,9738,20201230
20201227,4호선,충무로,4107,4138,8245,20201230
20201227,4호선,명동,4692,5066,9758,20201230
20201227,4호선,회현(남대문시장),5001,5195,10196,20201230
20201227,4호선,서울역,2305,3761,6066,20201230
20201227,4호선,숙대입구(갈월),3044,2984,6028,20201230
20201227,4호선,삼각지,876,1130,2006,20201230
20201227,4호선,신용산,3608,3484,7092,20201230
20201227,4호선,이촌(국립중앙박물관),1761,2093,3854,20201230
20201227,4호선,동작(현충원),1062,1016,2078,20201230
20201227,4호선,총신대입구(이수),5596,6111,11707,20201230
20201227,4호선,사당,7212,7076,14288,20201230
20201227,4호선,남태령,302,273,575,20201230
20201227,4호선,당고개,4709,4476,9185,20201230
20201227,4호선,상계,6178,5746,11924,20201230
20201227,4호선,노원,6223,6730,12953,20201230
20201227,4호선,창동,8266,8723,16989,20201230
20201227,4호선,쌍문,9346,8353,17699,20201230
20201227,5호선,방화,2101,2139,4240,20201230
20201227,5호선,개화산,1637,1680,3317,20201230
20201227,5호선,김포공항,4008,3565,7573,20201230
20201227,5호선,송정,2214,2252,4466,20201230
20201227,5호선,마곡,1840,1861,3701,20201230
20201227,5호선,발산,4281,4533,8814,20201230
20201227,5호선,우장산,3494,3640,7134,20201230
20201227,5호선,화곡,8240,7736,15976,20201230
20201227,5호선,까치산,9314,9218,18532,20201230
20201227,5호선,신정(은행정),3671,3378,7049,20201230
20201227,5호선,목동,4289,4447,8736,20201230
20201227,5호선,오목교(목동운동장앞),6238,6488,12726,20201230
20201227,5호선,양평,1421,1498,2919,20201230
20201227,5호선,영등포구청,718,719,1437,20201230
20201227,5호선,영등포시장,2453,2605,5058,20201230
20201227,5호선,신길,1019,1207,2226,20201230
20201227,5호선,여의도,2923,3273,6196,20201230
20201227,5호선,여의나루,2005,1976,3981,20201230
20201227,5호선,마포,2741,2659,5400,20201230
20201227,5호선,공덕,2311,2466,4777,20201230
20201227,5호선,애오개,1521,1511,3032,20201230
20201227,5호선,충정로(경기대입구),792,904,1696,20201230
20201227,5호선,서대문,2686,2659,5345,20201230
20201227,5호선,광화문(세종문화회관),5185,5075,10260,20201230
20201227,5호선,종로3가,2832,2743,5575,20201230
20201227,5호선,을지로4가,733,790,1523,20201230
20201227,5호선,동대문역사문화공원(DDP),420,446,866,20201230
20201227,5호선,청구,981,926,1907,20201230
20201227,5호선,신금호,1641,1851,3492,20201230
20201227,5호선,행당,2242,2054,4296,20201230
20201227,5호선,왕십리(성동구청),1295,1401,2696,20201230
20201227,5호선,마장,1674,1605,3279,20201230
20201227,5호선,답십리,4347,4083,8430,20201230
20201227,5호선,장한평,4119,4070,8189,20201230
20201227,5호선,군자(능동),3417,3688,7105,20201230
20201227,5호선,아차산(어린이대공원후문),5929,6131,12060,20201230
20201227,5호선,광나루(장신대),4449,4535,8984,20201230
20201227,5호선,천호(풍납토성),6781,6463,13244,20201230
20201227,5호선,강동,5343,5221,10564,20201230
20201227,5호선,길동,2490,2597,5087,20201230
20201227,5호선,굽은다리(강동구민회관앞),2922,2755,5677,20201230
20201227,5호선,명일,2220,2171,4391,20201230
20201227,5호선,고덕,2021,2073,4094,20201230
20201227,5호선,상일동,3784,3681,7465,20201230
20201227,5호선,둔촌동,2408,2539,4947,20201230
20201227,5호선,올림픽공원(한국체대),1164,1038,2202,20201230
20201227,5호선,방이,1859,1828,3687,20201230
20201227,5호선,오금,840,786,1626,20201230
20201227,5호선,개롱,1591,1738,3329,20201230
20201227,5호선,거여,2057,2059,4116,20201230
20201227,5호선,마천,2061,2211,4272,20201230
20201227,5호선,미사,3948,3805,7753,20201230
20201227,5호선,하남풍산,1555,1705,3260,20201230
20201227,6호선,응암,5428,5415,10843,20201230
20201227,6호선,역촌,1083,1291,2374,20201230
20201227,6호선,불광,1747,1678,3425,20201230
20201227,6호선,독바위,946,1264,2210,20201230
20201227,6호선,구산,2222,1643,3865,20201230
20201227,6호선,새절(신사),3909,3734,7643,20201230
20201227,6호선,증산(명지대앞),3398,3529,6927,20201230
20201227,6호선,디지털미디어시티,3116,3124,6240,20201230
20201227,6호선,월드컵경기장(성산),2011,1927,3938,20201230
20201227,6호선,마포구청,4223,3883,8106,20201230
20201227,중앙선,신원,179,131,310,20201230
20201227,중앙선,양수,904,831,1735,20201230
20201227,중앙선,운길산,714,610,1324,20201230
20201227,중앙선,팔당,833,862,1695,20201230
20201227,중앙선,도심,701,650,1351,20201230
20201227,중앙선,덕소,1984,1951,3935,20201230
20201227,중앙선,양정,248,209,457,20201230
20201227,중앙선,도농,2594,2575,5169,20201230
20201227,중앙선,구리,4127,4344,8471,20201230
20201227,중앙선,양원,484,538,1022,20201230
20201227,중앙선,망우,2588,2573,5161,20201230
20201227,중앙선,상봉(시외버스터미널),2306,2249,4555,20201230
20201227,중앙선,중랑,1909,1887,3796,20201230
20201227,중앙선,회기,8197,8376,16573,20201230
20201227,장항선,신창(순천향대),452,500,952,20201230
20201227,장항선,온양온천,1973,1954,3927,20201230
20201227,장항선,배방,420,498,918,20201230
20201227,장항선,아산,1666,1083,2749,20201230
20201227,장항선,쌍용(나사렛대),631,642,1273,20201230
20201227,장항선,봉명,349,364,713,20201230
20201227,일산선,대화,3534,3318,6852,20201230
20201227,일산선,주엽,2437,2318,4755,20201230
20201227,일산선,정발산,2758,2671,5429,20201230
20201227,일산선,마두,1890,1789,3679,20201230
20201227,일산선,백석,3395,3325,6720,20201230
20201227,일산선,대곡,538,473,1011,20201230
20201227,일산선,화정,5333,5496,10829,20201230
20201227,일산선,원당,3589,3510,7099,20201230
20201227,일산선,삼송,5795,5797,11592,20201230
20201227,일산선,원흥,2892,2733,5625,20201230
20201227,우이신설선,신설동,733,664,1397,20201230
20201227,우이신설선,보문,526,557,1083,20201230
20201227,우이신설선,성신여대입구(돈암),1072,1297,2369,20201230
20201227,우이신설선,정릉,1410,1267,2677,20201230
20201227,우이신설선,북한산보국문,2069,1912,3981,20201230
20201227,우이신설선,솔샘,1561,1410,2971,20201230
20201227,우이신설선,삼양사거리,905,931,1836,20201230
20201227,우이신설선,삼양,760,784,1544,20201230
20201227,우이신설선,화계,1268,1129,2397,20201230
20201227,우이신설선,가오리,1409,1388,2797,20201230
20201227,우이신설선,4.19민주묘지,1163,967,2130,20201230
20201227,우이신설선,솔밭공원,856,848,1704,20201230
20201227,우이신설선,북한산우이,1796,1851,3647,20201230
20201227,안산선,수리산,1249,1256,2505,20201230
20201227,안산선,오이도,3303,3175,6478,20201230
20201227,안산선,정왕,2862,3173,6035,20201230
20201227,안산선,신길온천,635,598,1233,20201230
20201227,안산선,안산,6328,5641,11969,20201230
20201227,안산선,초지,1305,1269,2574,20201230
20201227,안산선,고잔,2264,2109,4373,20201230
20201227,안산선,중앙,5813,5702,11515,20201230
20201227,안산선,한대앞,2976,2850,5826,20201230
20201227,안산선,상록수,5533,5313,10846,20201230
20201227,안산선,반월,1428,1481,2909,20201230
20201227,안산선,대야미,1703,1591,3294,20201230
20201227,안산선,산본,4675,4955,9630,20201230
20201227,수인선,인천,495,727,1222,20201230
20201227,수인선,신포,615,614,1229,20201230
20201227,수인선,숭의,1175,1052,2227,20201230
20201227,수인선,인하대,1821,1768,3589,20201230
20201227,수인선,송도,949,914,1863,20201230
20201227,수인선,연수,1785,1687,3472,20201230
20201227,수인선,원인재,1698,1668,3366,20201230
20201227,수인선,남동인더스파크,373,396,769,20201230
20201227,수인선,호구포,1150,1196,2346,20201230
20201227,수인선,인천논현,1750,1792,3542,20201230
20201227,수인선,소래포구,2661,2571,5232,20201230
20201227,수인선,월곶,1030,956,1986,20201230
20201227,수인선,달월,25,31,56,20201230
20201227,수인선,사리,1246,1076,2322,20201230
20201227,수인선,야목,83,84,167,20201230
20201227,수인선,어천,228,301,529,20201230
20201227,수인선,오목천,684,684,1368,20201230
20201227,수인선,고색,806,896,1702,20201230
20201227,분당선,매교,780,776,1556,20201230
20201227,분당선,수원시청,3686,3550,7236,20201230
20201227,분당선,매탄권선,1310,1260,2570,20201230
20201227,분당선,망포,3306,3575,6881,20201230
20201227,분당선,영통,2301,2366,4667,20201230
20201227,분당선,청명,1039,1048,2087,20201230
20201227,분당선,상갈,1588,1610,3198,20201230
20201227,분당선,기흥,2730,2680,5410,20201230
20201227,분당선,신갈,1065,1017,2082,20201230
20201227,분당선,구성,1197,1295,2492,20201230
20201227,분당선,죽전,5106,5151,10257,20201230
20201227,분당선,보정,506,490,996,20201230
20201227,분당선,이매,1372,1405,2777,20201230
20201227,분당선,오리,3241,2917,6158,20201230
20201227,분당선,미금,4038,4278,8316,20201230
20201227,분당선,정자,3964,4129,8093,20201230
20201227,분당선,수내,3548,3582,7130,20201230
20201227,분당선,서현,7269,7180,14449,20201230
20201227,분당선,야탑,7056,7341,14397,20201230
20201227,분당선,모란,6705,6836,13541,20201230
20201227,분당선,태평,4822,4612,9434,20201230
20201227,분당선,가천대,2020,2483,4503,20201230
20201227,분당선,선정릉,1120,1285,2405,20201230
20201227,분당선,강남구청,1596,1925,3521,20201230
20201227,분당선,압구정로데오,5167,5546,10713,20201230
20201227,분당선,서울숲,2202,2113,4315,20201230
20201227,분당선,수원,3201,2419,5620,20201230
20201227,분당선,수서,4351,4120,8471,20201230
20201227,분당선,대모산입구,945,862,1807,20201230
20201227,분당선,개포동,921,946,1867,20201230
20201227,분당선,구룡,334,388,722,20201230
20201227,분당선,도곡,1314,1356,2670,20201230
20201227,분당선,한티,3778,3933,7711,20201230
20201227,분당선,선릉,1612,2267,3879,20201230
20201227,과천선,범계,7405,7091,14496,20201230
20201227,과천선,평촌,3480,3439,6919,20201230
20201227,과천선,인덕원,5850,6007,11857,20201230
20201227,과천선,정부과천청사,1986,2056,4042,20201230
20201227,과천선,과천,1550,1422,2972,20201230
20201227,과천선,대공원,1818,1888,3706,20201230
20201227,과천선,경마공원,431,405,836,20201230
20201227,과천선,선바위,1794,1824,3618,20201230
20201227,공항철도 1호선,영종,1308,1240,2548,20201230
20201227,공항철도 1호선,인천공항2터미널,1286,1233,2519,20201230
20201227,공항철도 1호선,인천공항1터미널,2348,2503,4851,20201230
20201227,공항철도 1호선,공항화물청사,852,902,1754,20201230
20201227,공항철도 1호선,운서,3044,3270,6314,20201230
20201227,공항철도 1호선,청라국제도시,1600,1523,3123,20201230
20201227,공항철도 1호선,검암,2262,2221,4483,20201230
20201227,공항철도 1호선,계양,2740,2675,5415,20201230
20201227,공항철도 1호선,김포공항,6502,3151,9653,20201230
20201227,공항철도 1호선,마곡나루(서울식물원),1066,1047,2113,20201230
20201227,공항철도 1호선,디지털미디어시티,2042,2094,4136,20201230
20201227,공항철도 1호선,홍대입구,3369,3257,6626,20201230
20201227,공항철도 1호선,공덕,563,811,1374,20201230
20201227,공항철도 1호선,서울역,3530,2763,6293,20201230
20201227,경춘선,춘천,688,595,1283,20201230
20201227,경춘선,남춘천,1287,1276,2563,20201230
20201227,경춘선,김유정,189,186,375,20201230
20201227,경춘선,강촌,299,256,555,20201230
20201227,경춘선,백양리,47,46,93,20201230
20201227,경춘선,굴봉산,97,96,193,20201230
20201227,경춘선,가평,730,651,1381,20201230
20201227,경춘선,상천,222,183,405,20201230
20201227,경춘선,청평,803,639,1442,20201230
20201227,경춘선,대성리,314,223,537,20201230
20201227,경춘선,마석,1350,1372,2722,20201230
20201227,경춘선,천마산,669,611,1280,20201230
20201227,경춘선,평내호평,1835,1783,3618,20201230
20201227,경춘선,금곡,525,489,1014,20201230
20201227,경춘선,사릉,965,1016,1981,20201230
20201227,경춘선,퇴계원,1201,1114,2315,20201230
20201227,경춘선,별내,939,916,1855,20201230
20201227,경춘선,갈매,849,759,1608,20201230
20201227,경춘선,신내,442,441,883,20201230
20201227,경인선,도화,1389,1302,2691,20201230
20201227,경인선,중동,2852,2556,5408,20201230
20201227,경인선,온수(성공회대입구),1930,1829,3759,20201230
20201227,경인선,도원,922,963,1885,20201230
20201227,경인선,간석,1835,1735,3570,20201230
20201227,경인선,부개,2681,2498,5179,20201230
20201227,경인선,소사,3355,2973,6328,20201230
20201227,경인선,구일,1851,1830,3681,20201230
20201227,경인선,인천,1841,1512,3353,20201230
20201227,경인선,동인천,5216,5096,10312,20201230
20201227,경인선,제물포,3222,3032,6254,20201230
20201227,경인선,주안,6762,5960,12722,20201230
20201227,경인선,동암,5786,5747,11533,20201230
20201227,경인선,백운,2327,2317,4644,20201230
20201227,경인선,부평,12014,12217,24231,20201230
20201227,경인선,송내,7210,7114,14324,20201230
20201227,경인선,부천,12691,12275,24966,20201230
20201227,경인선,역곡,8331,8255,16586,20201230
20201227,경인선,오류동,3864,3646,7510,20201230
20201227,경인선,개봉,6632,6675,13307,20201230
20201227,경의선,임진강,19,22,41,20201230
20201227,경의선,문산,1884,1823,3707,20201230
20201227,경의선,파주,363,286,649,20201230
20201227,경의선,월롱,465,817,1282,20201230
20201227,경의선,금촌,2380,2454,4834,20201230
20201227,경의선,금릉,1395,1389,2784,20201230
20201227,경의선,운정,1707,1652,3359,20201230
20201227,경의선,야당,2037,1877,3914,20201230
20201227,경의선,탄현,2186,2060,4246,20201230
20201227,경의선,일산,2548,2387,4935,20201230
20201227,경의선,풍산,1870,1742,3612,20201230
20201227,경의선,백마,1685,1619,3304,20201230
20201227,경의선,곡산,149,155,304,20201230
20201227,경의선,능곡,1243,1237,2480,20201230
20201227,경의선,행신,2248,2215,4463,20201230
20201227,경의선,강매,775,745,1520,20201230
20201227,경의선,화전,465,460,925,20201230
20201227,경의선,수색,550,558,1108,20201230
20201227,경의선,디지털미디어시티,731,710,1441,20201230
20201227,경의선,가좌,1577,1527,3104,20201230
20201227,경의선,홍대입구,664,716,1380,20201230
20201227,경의선,서강대,671,637,1308,20201230
20201227,경의선,공덕,852,782,1634,20201230
20201227,경의선,효창공원앞,708,855,1563,20201230
20201227,경의선,신촌,129,141,270,20201230
20201227,경의선,서울역,511,455,966,20201230
20201227,경원선,소요산,2418,2019,4437,20201230
20201227,경원선,동두천,717,909,1626,20201230
20201227,경원선,보산,883,731,1614,20201230
20201227,경원선,동두천중앙,1294,1208,2502,20201230
20201227,경원선,지행,2359,2335,4694,20201230
20201227,경원선,덕정,1861,1852,3713,20201230
20201227,경원선,덕계,922,903,1825,20201230
20201227,경원선,양주,2776,2670,5446,20201230
20201227,경원선,녹양,1637,1565,3202,20201230
20201227,경원선,가능,2471,2336,4807,20201230
20201227,경원선,의정부,7734,7751,15485,20201230
20201227,경원선,회룡,4097,3976,8073,20201230
20201227,경원선,망월사,2586,2701,5287,20201230
20201227,경원선,도봉산,5904,4131,10035,20201230
20201227,경원선,도봉,2215,2044,4259,20201230
20201227,경원선,방학,3359,3305,6664,20201230
20201227,경원선,녹천,1715,1410,3125,20201230
20201227,경원선,월계,2085,1936,4021,20201230
20201227,경원선,광운대,2572,2621,5193,20201230
20201227,경원선,석계,3014,3265,6279,20201230
20201227,경원선,신이문,2941,2751,5692,20201230
20201227,경원선,외대앞,2729,2758,5487,20201230
20201227,경원선,청량리(서울시립대입구),6613,6352,12965,20201230
20201227,경원선,왕십리(성동구청),4220,5146,9366,20201230
20201227,경원선,응봉,595,544,1139,20201230
20201227,경원선,옥수,32,19,51,20201230
20201227,경원선,한남,1213,1190,2403,20201230
20201227,경원선,서빙고,488,498,986,20201230
20201227,경원선,이촌(국립중앙박물관),1067,858,1925,20201230
20201227,경부선,광명,1040,717,1757,20201230
20201227,경부선,서동탄,401,380,781,20201230
20201227,경부선,당정,1662,1684,3346,20201230
20201227,경부선,천안,3197,3031,6228,20201230
20201227,경부선,두정,2256,2477,4733,20201230
20201227,경부선,직산,297,340,637,20201230
20201227,경부선,성환,1420,1689,3109,20201230
20201227,경부선,평택,6456,6761,13217,20201230
20201227,경부선,지제,1222,1244,2466,20201230
20201227,경부선,서정리,2437,3860,6297,20201230
20201227,경부선,송탄,2211,2404,4615,20201230
20201227,경부선,진위,429,476,905,20201230
20201227,경부선,오산,4323,4895,9218,20201230
20201227,경부선,오산대,1101,1031,2132,20201230
20201227,경부선,세마,864,828,1692,20201230
20201227,경부선,병점,4831,5393,10224,20201230
20201227,경부선,세류,1113,1171,2284,20201230
20201227,경부선,독산,3481,3512,6993,20201230
20201227,경부선,수원,17327,16902,34229,20201230
20201227,경부선,화서,2147,2047,4194,20201230
20201227,경부선,성균관대,4190,4503,8693,20201230
20201227,경부선,의왕,2496,2561,5057,20201230
20201227,경부선,군포,2012,1969,3981,20201230
20201227,경부선,금정,7648,7951,15599,20201230
20201227,경부선,명학,2120,2171,4291,20201230
20201227,경부선,안양,7447,7196,14643,20201230
20201227,경부선,관악,2951,2601,5552,20201230
20201227,경부선,석수,3159,3195,6354,20201230
20201227,경부선,금천구청,3619,3556,7175,20201230
20201227,경부선,가산디지털단지,2728,3741,6469,20201230
20201227,경부선,구로,5724,5776,11500,20201230
20201227,경부선,신길,2885,2537,5422,20201230
20201227,경부선,신도림,1238,1248,2486,20201230
20201227,경부선,영등포,17115,16674,33789,20201230
20201227,경부선,대방,3196,3359,6555,20201230
20201227,경부선,노량진,3384,3355,6739,20201230
20201227,경부선,용산,14392,12584,26976,20201230
20201227,경부선,남영,2123,2327,4450,20201230
20201227,경부선,서울역,3036,571,3607,20201230
20201227,경강선,여주,970,807,1777,20201230
20201227,경강선,세종대왕릉,136,113,249,20201230
20201227,경강선,부발,597,1143,1740,20201230
20201227,경강선,이천,1078,1146,2224,20201230
20201227,경강선,신둔도예촌,429,391,820,20201230
20201227,경강선,곤지암,741,869,1610,20201230
20201227,경강선,초월,796,824,1620,20201230
20201227,경강선,경기광주,1969,2044,4013,20201230
20201227,경강선,삼동,583,602,1185,20201230
20201227,경강선,이매,333,224,557,20201230
20201227,경강선,판교,1314,1196,2510,20201230
20201227,9호선2~3단계,중앙보훈병원,1790,1714,3504,20201230
20201227,9호선2~3단계,둔촌오륜,241,237,478,20201230
20201227,9호선2~3단계,올림픽공원(한국체대),1519,1591,3110,20201230
20201227,9호선2~3단계,한성백제,693,678,1371,20201230
20201227,9호선2~3단계,송파나루,1357,1466,2823,20201230
20201227,9호선2~3단계,석촌,2270,2042,4312,20201230
20201227,9호선2~3단계,석촌고분,1714,1790,3504,20201230
20201227,9호선2~3단계,삼전,2027,2014,4041,20201230
20201227,9호선2~3단계,종합운동장,1039,1024,2063,20201230
20201227,9호선2~3단계,봉은사,3487,3445,6932,20201230
20201227,9호선2~3단계,삼성중앙,1103,1232,2335,20201230
20201227,9호선2~3단계,선정릉,1641,1859,3500,20201230
20201227,9호선2~3단계,언주,2008,2038,4046,20201230
20201227,9호선,신논현,7435,7276,14711,20201230
20201227,9호선,사평,594,640,1234,20201230
20201227,9호선,고속터미널,5151,5751,10902,20201230
20201227,9호선,신반포,653,627,1280,20201230
20201227,9호선,구반포,674,717,1391,20201230
20201227,9호선,동작(현충원),505,433,938,20201230
20201227,9호선,흑석(중앙대입구),2052,2167,4219,20201230
20201227,9호선,노들,1286,1177,2463,20201230
20201227,9호선,노량진,7328,8071,15399,20201230
20201227,9호선,샛강,865,860,1725,20201230
20201227,9호선,여의도,2874,2795,5669,20201230
20201227,9호선,국회의사당,1726,1628,3354,20201230
20201227,9호선,당산,4504,4485,8989,20201230
20201227,9호선,선유도,1366,1439,2805,20201230
20201227,9호선,신목동,899,874,1773,20201230
20201227,9호선,염창,4670,4720,9390,20201230
20201227,9호선,등촌,2866,2907,5773,20201230
20201227,9호선,증미,1459,1454,2913,20201230
20201227,9호선,가양,5349,5466,10815,20201230
20201227,9호선,양천향교,2248,2414,4662,20201230
20201227,9호선,마곡나루(서울식물원),2740,2820,5560,20201230
20201227,9호선,신방화,1905,1858,3763,20201230
20201227,9호선,공항시장,1012,1078,2090,20201230
20201227,9호선,김포공항,4174,5417,9591,20201230
20201227,9호선,개화,660,605,1265,20201230
20201227,8호선,모란,1536,1238,2774,20201230
20201227,8호선,수진,1861,1627,3488,20201230
20201227,8호선,신흥,1685,1847,3532,20201230
20201227,8호선,단대오거리,3224,3188,6412,20201230
20201227,8호선,남한산성입구(성남법원.검찰청),4197,3817,8014,20201230
20201227,8호선,산성,2322,2413,4735,20201230
20201227,8호선,복정,2613,2588,5201,20201230
20201227,8호선,장지,5353,5818,11171,20201230
20201227,8호선,문정,2952,3186,6138,20201230
20201227,8호선,가락시장,2058,2775,4833,20201230
20201227,8호선,송파,2024,2176,4200,20201230
20201227,8호선,석촌,2260,2707,4967,20201230
20201227,8호선,잠실(송파구청),5094,5175,10269,20201230
20201227,8호선,몽촌토성(평화의문),1704,1724,3428,20201230
20201227,8호선,강동구청,2591,2673,5264,20201230
20201227,8호선,천호(풍납토성),5296,5958,11254,20201230
20201227,8호선,암사,5361,5082,10443,20201230
20201227,7호선,부평구청,2849,2477,5326,20201230
20201227,7호선,굴포천,2474,2510,4984,20201230
20201227,7호선,삼산체육관,1252,1149,2401,20201230
20201227,7호선,상동,3579,3453,7032,20201230
20201227,7호선,부천시청,3630,3500,7130,20201230
20201227,7호선,신중동,3813,3706,7519,20201230
20201227,7호선,춘의,2156,2040,4196,20201230
20201227,7호선,부천종합운동장,1458,1317,2775,20201230
20201227,7호선,까치울,2185,2113,4298,20201230
20201227,7호선,온수(성공회대입구),2287,2245,4532,20201230
20201227,7호선,천왕,2693,2631,5324,20201230
20201227,7호선,광명사거리,7658,7549,15207,20201230
20201227,7호선,철산,5674,5684,11358,20201230
20201227,7호선,가산디지털단지,6493,6260,12753,20201230
20201227,7호선,남구로,4421,4344,8765,20201230
20201227,7호선,대림(구로구청),3743,3488,7231,20201230
20201227,7호선,신풍,3588,3467,7055,20201230
20201227,7호선,보라매,2367,2378,4745,20201230
20201227,7호선,신대방삼거리,4783,4865,9648,20201230
20201227,7호선,장승배기,3004,3003,6007,20201230
20201227,7호선,상도,3020,3086,6106,20201230
20201227,7호선,숭실대입구(살피재),3168,3472,6640,20201230
20201227,7호선,남성,3305,3360,6665,20201230
20201227,7호선,이수,4252,4208,8460,20201230
20201227,7호선,내방,2999,3081,6080,20201230
20201227,7호선,고속터미널,6995,4365,11360,20201230
20201227,7호선,반포,1605,1616,3221,20201230
20201227,7호선,논현,3956,4248,8204,20201230
20201227,7호선,학동,3391,3608,6999,20201230
20201227,7호선,강남구청,3034,3398,6432,20201230
20201227,7호선,청담,3925,4101,8026,20201230
20201227,7호선,뚝섬유원지,2842,2668,5510,20201230
20201227,7호선,건대입구,3983,4019,8002,20201230
20201227,7호선,어린이대공원(세종대),3663,3608,7271,20201230
20201227,7호선,군자(능동),4344,3660,8004,20201230
20201227,7호선,중곡,3021,2976,5997,20201230
20201227,7호선,용마산(용마폭포공원),2088,2172,4260,20201230
20201227,7호선,사가정,5716,5666,11382,20201230
20201227,7호선,면목,5049,5019,10068,20201230
20201227,7호선,상봉(시외버스터미널),5483,5064,10547,20201230
20201227,7호선,중화,3683,3483,7166,20201230
20201227,7호선,먹골,3371,3379,6750,20201230
20201227,7호선,태릉입구,2683,2463,5146,20201230
20201227,7호선,공릉(서울과학기술대),3586,3793,7379,20201230
20201227,7호선,하계,5041,4732,9773,20201230
20201227,7호선,중계,3949,3655,7604,20201230
20201227,7호선,노원,6093,6100,12193,20201230
20201227,7호선,마들,3352,3159,6511,20201230
20201227,7호선,수락산,5161,5182,10343,20201230
20201227,7호선,도봉산,3396,5046,8442,20201230
20201227,7호선,장암,773,560,1333,20201230
20201227,6호선,봉화산(서울의료원),2268,2232,4500,20201230
20201227,6호선,화랑대(서울여대입구),2718,2290,5008,20201230
20201227,6호선,태릉입구,1713,1789,3502,20201230
20201227,6호선,석계,3767,3819,7586,20201230
20201227,6호선,돌곶이,2496,2383,4879,20201230
20201227,6호선,상월곡(한국과학기술연구원),1848,1704,3552,20201230
20201227,6호선,월곡(동덕여대),3072,3040,6112,20201230
20201227,6호선,고려대(종암),2283,2299,4582,20201230
20201227,6호선,안암(고대병원앞),2410,2535,4945,20201230
20201227,6호선,보문,2200,2021,4221,20201230
20201227,6호선,창신,932,864,1796,20201230
20201227,6호선,동묘앞,3732,3626,7358,20201230
20201227,6호선,신당,1758,2679,4437,20201230
20201227,6호선,청구,985,986,1971,20201230
20201227,6호선,약수,925,909,1834,20201230
20201227,6호선,버티고개,597,656,1253,20201230
20201227,6호선,한강진,2179,2433,4612,20201230
20201227,6호선,이태원,3908,3796,7704,20201230
20201227,6호선,녹사평(용산구청),1763,1598,3361,20201230
20201227,6호선,삼각지,1453,1168,2621,20201230
20201227,6호선,효창공원앞,1907,1749,3656,20201230
20201227,6호선,공덕,3601,3427,7028,20201230
20201227,6호선,대흥(서강대앞),1953,2023,3976,20201230
20201227,6호선,광흥창(서강),1983,1999,3982,20201230
20201227,6호선,상수,2312,2726,5038,20201230
20201227,6호선,합정,4258,3832,8090,20201230
20201227,6호선,망원,4691,5016,9707,20201230
20201228,7호선,군자(능동),11912,9656,21568,20201231
20201228,7호선,중곡,8206,7833,16039,20201231
20201228,7호선,용마산(용마폭포공원),4913,4765,9678,20201231
20201228,4호선,남태령,841,734,1575,20201231
20201228,4호선,사당,17503,14778,32281,20201231
20201228,4호선,총신대입구(이수),14940,16352,31292,20201231
20201228,4호선,동작(현충원),2038,2034,4072,20201231
20201228,4호선,이촌(국립중앙박물관),4922,5579,10501,20201231
20201228,4호선,신용산,11584,11933,23517,20201231
20201228,4호선,삼각지,3553,3858,7411,20201231
20201228,4호선,숙대입구(갈월),9367,9356,18723,20201231
20201228,4호선,서울역,7995,10319,18314,20201231
20201228,4호선,회현(남대문시장),18405,19384,37789,20201231
20201228,4호선,명동,13029,13455,26484,20201231
20201228,4호선,충무로,21578,22367,43945,20201231
20201228,4호선,동대문역사문화공원(DDP),11504,10666,22170,20201231
20201228,4호선,동대문,16743,17269,34012,20201231
20201228,4호선,혜화,21003,20787,41790,20201231
20201228,4호선,한성대입구(삼선교),10189,9973,20162,20201231
20201228,4호선,성신여대입구(돈암),14491,14021,28512,20201231
20201228,4호선,길음,15943,15770,31713,20201231
20201228,4호선,미아사거리,22946,22576,45522,20201231
20201228,4호선,미아(서울사이버대학),12716,12392,25108,20201231
20201228,4호선,수유(강북구청),28275,28284,56559,20201231
20201228,3호선,오금,4971,4507,9478,20201231
20201228,3호선,경찰병원,6114,6135,12249,20201231
20201228,3호선,가락시장,7148,6921,14069,20201231
20201228,3호선,수서,11894,12339,24233,20201231
20201228,3호선,일원,7488,7365,14853,20201231
20201228,3호선,대청,7941,7260,15201,20201231
20201228,3호선,학여울,1272,1329,2601,20201231
20201228,3호선,대치,7830,7790,15620,20201231
20201228,3호선,도곡,4024,4140,8164,20201231
20201228,3호선,매봉,9903,9219,19122,20201231
20201228,3호선,양재(서초구청),29702,32219,61921,20201231
20201228,3호선,남부터미널(예술의전당),22290,22794,45084,20201231
20201228,3호선,교대(법원.검찰청),10821,7167,17988,20201231
20201228,3호선,고속터미널,27932,26458,54390,20201231
20201228,3호선,잠원,3578,3509,7087,20201231
20201228,3호선,신사,23470,24654,48124,20201231
20201228,3호선,압구정,25574,27072,52646,20201231
20201228,3호선,옥수,6791,7171,13962,20201231
20201228,3호선,금호,6393,6168,12561,20201231
20201228,3호선,약수,10253,10002,20255,20201231
20201228,3호선,동대입구,5398,5579,10977,20201231
20201228,3호선,충무로,1,0,1,20201231
20201228,3호선,을지로3가,8250,8506,16756,20201231
20201228,3호선,종로3가,7780,8900,16680,20201231
20201228,3호선,안국,13287,13561,26848,20201231
20201228,3호선,경복궁(정부서울청사),13116,12661,25777,20201231
20201228,3호선,독립문,5548,5722,11270,20201231
20201228,3호선,무악재,3045,3208,6253,20201231
20201228,3호선,홍제,13898,13476,27374,20201231
20201228,3호선,녹번,11999,11108,23107,20201231
20201228,3호선,불광,13407,14308,27715,20201231
20201228,3호선,연신내,30213,28520,58733,20201231
20201228,3호선,구파발,16055,15089,31144,20201231
20201228,3호선,지축,2564,2642,5206,20201231
20201228,2호선,용두(동대문구청),2022,2142,4164,20201231
20201228,2호선,신정네거리,7974,8243,16217,20201231
20201228,2호선,양천구청,5143,5550,10693,20201231
20201228,2호선,도림천,1117,1178,2295,20201231
20201228,2호선,신설동,2494,2492,4986,20201231
20201228,2호선,신답,1297,1514,2811,20201231
20201228,2호선,용답,2027,2000,4027,20201231
20201228,2호선,충정로(경기대입구),8018,8455,16473,20201231
20201228,2호선,아현,7969,7639,15608,20201231
20201228,2호선,이대,8458,8910,17368,20201231
20201228,2호선,신촌,22303,23287,45590,20201231
20201228,2호선,홍대입구,30874,31769,62643,20201231
20201228,2호선,합정,21027,22105,43132,20201231
20201228,2호선,당산,14867,17287,32154,20201231
20201228,2호선,영등포구청,19290,19532,38822,20201231
20201228,2호선,문래,16960,17346,34306,20201231
20201228,2호선,신도림,37926,36484,74410,20201231
20201228,2호선,대림(구로구청),20582,20922,41504,20201231
20201228,2호선,구로디지털단지,48944,49629,98573,20201231
20201228,2호선,신대방,21219,20815,42034,20201231
20201228,2호선,신림,49821,49058,98879,20201231
20201228,2호선,봉천,19371,18213,37584,20201231
20201228,2호선,서울대입구(관악구청),35742,35363,71105,20201231
20201228,2호선,낙성대(강감찬),20705,20724,41429,20201231
20201228,2호선,사당,26154,28939,55093,20201231
20201228,2호선,방배,12653,12997,25650,20201231
20201228,7호선,사가정,13633,13815,27448,20201231
20201228,7호선,면목,12779,12610,25389,20201231
20201228,7호선,상봉(시외버스터미널),13515,12901,26416,20201231
20201228,7호선,중화,9250,9168,18418,20201231
20201228,7호선,먹골,8211,8124,16335,20201231
20201228,2호선,서초,16664,16429,33093,20201231
20201228,2호선,교대(법원.검찰청),26357,29077,55434,20201231
20201228,2호선,강남,59746,58303,118049,20201231
20201228,2호선,역삼,38916,42310,81226,20201231
20201228,2호선,선릉,45066,40307,85373,20201231
20201228,2호선,삼성(무역센터),36629,36722,73351,20201231
20201228,2호선,종합운동장,4910,5387,10297,20201231
20201228,2호선,잠실새내,15257,15270,30527,20201231
20201228,2호선,잠실(송파구청),46347,46151,92498,20201231
20201228,2호선,잠실나루,11085,10807,21892,20201231
20201228,2호선,강변(동서울터미널),22563,22132,44695,20201231
20201228,2호선,구의(광진구청),18633,18772,37405,20201231
20201228,2호선,건대입구,23695,25680,49375,20201231
20201228,2호선,성수,27229,29538,56767,20201231
20201228,2호선,뚝섬,15629,16824,32453,20201231
20201228,2호선,한양대,5106,5386,10492,20201231
20201228,2호선,왕십리(성동구청),11152,9128,20280,20201231
20201228,2호선,상왕십리,10658,10543,21201,20201231
20201228,7호선,태릉입구,6290,5792,12082,20201231
20201228,7호선,공릉(서울과학기술대),9080,9082,18162,20201231
20201228,7호선,하계,13722,13000,26722,20201231
20201228,7호선,중계,11623,10667,22290,20201231
20201228,7호선,노원,15699,16774,32473,20201231
20201228,7호선,마들,9971,9759,19730,20201231
20201228,7호선,수락산,10370,10468,20838,20201231
20201228,7호선,도봉산,7250,8537,15787,20201231
20201228,7호선,장암,1856,658,2514,20201231
20201228,6호선,신내,1,0,1,20201231
20201228,6호선,봉화산(서울의료원),7339,6809,14148,20201231
20201228,6호선,화랑대(서울여대입구),8806,6950,15756,20201231
20201228,6호선,태릉입구,4166,4484,8650,20201231
20201228,6호선,석계,9871,10236,20107,20201231
20201228,6호선,돌곶이,6853,6515,13368,20201231
20201228,6호선,상월곡(한국과학기술연구원),5044,4478,9522,20201231
20201228,6호선,월곡(동덕여대),9008,9005,18013,20201231
20201228,6호선,고려대(종암),5998,5909,11907,20201231
20201228,6호선,안암(고대병원앞),7393,7427,14820,20201231
20201228,6호선,보문,5804,5527,11331,20201231
20201228,6호선,창신,2790,2160,4950,20201231
20201228,6호선,동묘앞,6403,6562,12965,20201231
20201228,6호선,신당,6028,6667,12695,20201231
20201228,6호선,청구,3105,3303,6408,20201231
20201228,6호선,약수,2862,2919,5781,20201231
20201228,6호선,버티고개,1761,1679,3440,20201231
20201228,6호선,한강진,4530,5132,9662,20201231
20201228,6호선,이태원,6331,6348,12679,20201231
20201228,6호선,녹사평(용산구청),3321,3240,6561,20201231
20201228,6호선,삼각지,4110,3534,7644,20201231
20201228,6호선,효창공원앞,5561,5068,10629,20201231
20201228,6호선,공덕,14306,13922,28228,20201231
20201228,6호선,대흥(서강대앞),5935,6153,12088,20201231
20201228,6호선,광흥창(서강),6671,6382,13053,20201231
20201228,6호선,상수,5064,5603,10667,20201231
20201228,6호선,합정,8911,8763,17674,20201231
20201228,6호선,망원,10289,11115,21404,20201231
20201228,2호선,신당,11159,11480,22639,20201231
20201228,2호선,동대문역사문화공원(DDP),8547,9561,18108,20201231
20201228,6호선,마포구청,11178,10251,21429,20201231
20201228,6호선,월드컵경기장(성산),3603,3749,7352,20201231
20201228,6호선,디지털미디어시티,11101,12068,23169,20201231
20201228,6호선,증산(명지대앞),8284,8171,16455,20201231
20201228,6호선,새절(신사),10338,9701,20039,20201231
20201228,6호선,구산,5858,4626,10484,20201231
20201228,6호선,독바위,2216,2457,4673,20201231
20201228,6호선,불광,3406,3566,6972,20201231
20201228,6호선,역촌,3058,3548,6606,20201231
20201228,6호선,응암,14204,14376,28580,20201231
20201228,5호선,하남풍산,3980,3936,7916,20201231
20201228,5호선,미사,10476,10434,20910,20201231
20201228,5호선,마천,4740,4729,9469,20201231
20201228,5호선,거여,6051,5879,11930,20201231
20201228,5호선,개롱,4742,5092,9834,20201231
20201228,5호선,오금,3074,2877,5951,20201231
20201228,5호선,방이,5279,5398,10677,20201231
20201228,5호선,올림픽공원(한국체대),3154,2718,5872,20201231
20201228,5호선,둔촌동,6530,6603,13133,20201231
20201228,5호선,상일동,12865,11629,24494,20201231
20201228,5호선,고덕,6870,6867,13737,20201231
20201228,5호선,명일,6540,6700,13240,20201231
20201228,5호선,굽은다리(강동구민회관앞),7287,6986,14273,20201231
20201228,5호선,길동,6258,6474,12732,20201231
20201228,5호선,강동,15169,14248,29417,20201231
20201228,5호선,천호(풍납토성),13984,14251,28235,20201231
20201228,5호선,광나루(장신대),9825,9074,18899,20201231
20201228,5호선,아차산(어린이대공원후문),11184,11071,22255,20201231
20201228,5호선,군자(능동),8615,9319,17934,20201231
20201228,5호선,답십리,13156,12325,25481,20201231
20201228,5호선,마장,4643,4438,9081,20201231
20201228,5호선,왕십리(성동구청),3421,3694,7115,20201231
20201228,5호선,행당,6452,5758,12210,20201231
20201228,1호선,동묘앞,6238,6596,12834,20201231
20201228,1호선,시청,16214,16239,32453,20201231
20201228,1호선,종각,24749,23878,48627,20201231
20201228,1호선,종로3가,18652,17061,35713,20201231
20201228,1호선,종로5가,18206,18194,36400,20201231
20201228,1호선,동대문,9071,8642,17713,20201231
20201228,1호선,신설동,11206,11157,22363,20201231
20201228,1호선,제기동,15235,15605,30840,20201231
20201228,1호선,청량리(서울시립대입구),17298,17442,34740,20201231
20201228,2호선,시청,18045,17375,35420,20201231
20201228,2호선,을지로입구,29813,30156,59969,20201231
20201228,2호선,을지로3가,16215,16027,32242,20201231
20201228,5호선,장한평,15005,15070,30075,20201231
20201228,7호선,부천종합운동장,3679,3219,6898,20201231
20201228,7호선,춘의,8465,8377,16842,20201231
20201228,7호선,신중동,11224,11055,22279,20201231
20201228,7호선,부천시청,9764,9577,19341,20201231
20201228,7호선,상동,9221,9451,18672,20201231
20201228,7호선,삼산체육관,3546,3216,6762,20201231
20201228,7호선,굴포천,6847,7326,14173,20201231
20201228,7호선,부평구청,9314,7682,16996,20201231
20201228,8호선,암사,15226,13592,28818,20201231
20201228,8호선,천호(풍납토성),12220,13645,25865,20201231
20201228,8호선,강동구청,8435,8984,17419,20201231
20201228,8호선,몽촌토성(평화의문),4266,4488,8754,20201231
20201228,8호선,잠실(송파구청),10359,11653,22012,20201231
20201228,8호선,석촌,5937,6807,12744,20201231
20201228,8호선,송파,6101,6161,12262,20201231
20201228,8호선,가락시장,6478,7227,13705,20201231
20201228,8호선,문정,17417,18258,35675,20201231
20201228,8호선,장지,13476,13330,26806,20201231
20201228,8호선,복정,7954,6891,14845,20201231
20201228,8호선,산성,5267,5360,10627,20201231
20201228,8호선,남한산성입구(성남법원.검찰청),10996,10088,21084,20201231
20201228,8호선,단대오거리,8118,8119,16237,20201231
20201228,8호선,신흥,3704,3946,7650,20201231
20201228,8호선,수진,4243,3864,8107,20201231
20201228,8호선,모란,3398,2430,5828,20201231
20201228,9호선,개화,1919,1396,3315,20201231
20201228,9호선,김포공항,5152,6707,11859,20201231
20201228,9호선,공항시장,2269,2509,4778,20201231
20201228,9호선,신방화,5241,5259,10500,20201231
20201228,9호선,마곡나루(서울식물원),7809,8036,15845,20201231
20201228,9호선,양천향교,7217,7524,14741,20201231
20201228,9호선,가양,16170,16068,32238,20201231
20201228,9호선,증미,5914,5906,11820,20201231
20201228,9호선,등촌,8716,8636,17352,20201231
20201228,9호선,염창,13165,13238,26403,20201231
20201228,9호선,신목동,2910,2670,5580,20201231
20201228,9호선,선유도,6015,5920,11935,20201231
20201228,9호선,당산,13310,13303,26613,20201231
20201228,9호선,국회의사당,11959,11995,23954,20201231
20201228,9호선,여의도,17571,17035,34606,20201231
20201228,9호선,샛강,4278,4442,8720,20201231
20201228,9호선,노량진,17276,16941,34217,20201231
20201228,9호선,노들,3363,3083,6446,20201231
20201228,9호선,흑석(중앙대입구),5742,6127,11869,20201231
20201228,9호선,동작(현충원),1209,974,2183,20201231
20201228,9호선,구반포,2062,2185,4247,20201231
20201228,9호선,신반포,2271,2209,4480,20201231
20201228,9호선,고속터미널,8138,9948,18086,20201231
20201228,9호선,사평,2332,2316,4648,20201231
20201228,9호선,신논현,22921,22474,45395,20201231
20201228,9호선2~3단계,언주,7638,7778,15416,20201231
20201228,9호선2~3단계,선정릉,7215,7660,14875,20201231
20201228,9호선2~3단계,삼성중앙,5132,5347,10479,20201231
20201228,9호선2~3단계,봉은사,10815,10778,21593,20201231
20201228,9호선2~3단계,종합운동장,3103,3104,6207,20201231
20201228,9호선2~3단계,삼전,4987,4855,9842,20201231
20201228,9호선2~3단계,석촌고분,4431,4411,8842,20201231
20201228,9호선2~3단계,석촌,5697,5096,10793,20201231
20201228,9호선2~3단계,송파나루,3359,3489,6848,20201231
20201228,9호선2~3단계,한성백제,1737,1580,3317,20201231
20201228,9호선2~3단계,올림픽공원(한국체대),3868,3913,7781,20201231
20201228,9호선2~3단계,둔촌오륜,811,721,1532,20201231
20201228,9호선2~3단계,중앙보훈병원,7444,6618,14062,20201231
20201228,경강선,판교,3171,3038,6209,20201231
20201228,경강선,이매,729,627,1356,20201231
20201228,경강선,삼동,1791,1648,3439,20201231
20201228,7호선,까치울,5907,5771,11678,20201231
20201228,경강선,경기광주,5142,5028,10170,20201231
20201228,경강선,초월,2217,2222,4439,20201231
20201228,경강선,곤지암,1475,1417,2892,20201231
20201228,경강선,신둔도예촌,870,815,1685,20201231
20201228,경강선,이천,1716,1854,3570,20201231
20201228,경강선,부발,1251,1276,2527,20201231
20201228,경강선,세종대왕릉,196,167,363,20201231
20201228,경강선,여주,1212,1188,2400,20201231
20201228,경부선,서울역,3485,1057,4542,20201231
20201228,경부선,남영,7321,7754,15075,20201231
20201228,경부선,용산,22757,22971,45728,20201231
20201228,경부선,노량진,6054,6499,12553,20201231
20201228,경부선,대방,10149,10562,20711,20201231
20201228,경부선,영등포,28276,29017,57293,20201231
20201228,경부선,신도림,3310,3290,6600,20201231
20201228,경부선,신길,7594,6263,13857,20201231
20201228,경부선,구로,15376,15321,30697,20201231
20201228,경부선,가산디지털단지,14494,17212,31706,20201231
20201228,경부선,금천구청,9565,9375,18940,20201231
20201228,경부선,석수,8069,7225,15294,20201231
20201228,경부선,관악,5796,5338,11134,20201231
20201228,경부선,안양,16241,16230,32471,20201231
20201228,경부선,명학,7459,7361,14820,20201231
20201228,경부선,금정,20739,21535,42274,20201231
20201228,경부선,군포,6584,6702,13286,20201231
20201228,경부선,의왕,6985,7074,14059,20201231
20201228,경부선,성균관대,10483,10571,21054,20201231
20201228,경부선,화서,5691,5486,11177,20201231
20201228,경부선,수원,23350,24784,48134,20201231
20201228,경부선,독산,14418,15245,29663,20201231
20201228,경부선,세류,2352,2212,4564,20201231
20201228,경부선,병점,9873,9777,19650,20201231
20201228,경부선,세마,1897,1732,3629,20201231
20201228,경부선,오산대,2414,2105,4519,20201231
20201228,경부선,오산,7159,7419,14578,20201231
20201228,경부선,진위,1252,1126,2378,20201231
20201228,경부선,송탄,3245,3091,6336,20201231
20201228,경부선,서정리,4253,4314,8567,20201231
20201228,경부선,지제,2095,2089,4184,20201231
20201228,경부선,평택,8324,8163,16487,20201231
20201228,경부선,성환,2428,2572,5000,20201231
20201228,경부선,직산,556,555,1111,20201231
20201228,경부선,두정,3717,3725,7442,20201231
20201228,경부선,천안,3477,3589,7066,20201231
20201228,경부선,당정,4819,4608,9427,20201231
20201228,경부선,서동탄,1175,953,2128,20201231
20201228,경부선,광명,2358,2054,4412,20201231
20201228,경원선,이촌(국립중앙박물관),2956,2259,5215,20201231
20201228,경원선,서빙고,1496,1307,2803,20201231
20201228,경원선,한남,3386,3176,6562,20201231
20201228,경원선,옥수,40,26,66,20201231
20201228,경원선,응봉,1379,1152,2531,20201231
20201228,경원선,왕십리(성동구청),9731,11447,21178,20201231
20201228,경원선,청량리(서울시립대입구),10641,11427,22068,20201231
20201228,경원선,외대앞,5596,5682,11278,20201231
20201228,경원선,신이문,7159,6686,13845,20201231
20201228,경원선,석계,6603,7567,14170,20201231
20201228,경원선,광운대,6347,6057,12404,20201231
20201228,경원선,월계,4894,4680,9574,20201231
20201228,경원선,녹천,3875,3269,7144,20201231
20201228,경원선,방학,7889,7855,15744,20201231
20201228,경원선,도봉,5038,4821,9859,20201231
20201228,경원선,도봉산,6289,3819,10108,20201231
20201228,경원선,망월사,5722,5941,11663,20201231
20201228,경원선,회룡,9885,9714,19599,20201231
20201228,경원선,의정부,14091,14169,28260,20201231
20201228,경원선,가능,5214,5134,10348,20201231
20201228,경원선,녹양,3675,3558,7233,20201231
20201228,경원선,양주,5968,5598,11566,20201231
20201228,경원선,덕계,2211,1945,4156,20201231
20201228,경원선,덕정,4206,4191,8397,20201231
20201228,경원선,지행,5064,4849,9913,20201231
20201228,경원선,동두천중앙,2594,2404,4998,20201231
20201228,경원선,보산,1165,1040,2205,20201231
20201228,경원선,동두천,1530,1754,3284,20201231
20201228,경원선,소요산,2171,1781,3952,20201231
20201228,경의선,서울역,3171,3893,7064,20201231
20201228,경의선,신촌,624,795,1419,20201231
20201228,경의선,효창공원앞,2369,2691,5060,20201231
20201228,경의선,공덕,2679,2467,5146,20201231
20201228,경의선,서강대,1594,1427,3021,20201231
20201228,경의선,홍대입구,1078,1122,2200,20201231
20201228,경의선,가좌,4093,3873,7966,20201231
20201228,경의선,디지털미디어시티,1853,1796,3649,20201231
20201228,경의선,수색,1977,1940,3917,20201231
20201228,경의선,화전,1175,1085,2260,20201231
20201228,경의선,강매,2393,2129,4522,20201231
20201228,경의선,행신,5901,6051,11952,20201231
20201228,경의선,능곡,2914,2636,5550,20201231
20201228,경의선,곡산,417,446,863,20201231
20201228,경의선,백마,5175,4905,10080,20201231
20201228,경의선,풍산,4071,3778,7849,20201231
20201228,경의선,일산,7627,7417,15044,20201231
20201228,경의선,탄현,5727,5672,11399,20201231
20201228,경의선,야당,4551,4390,8941,20201231
20201228,경의선,운정,4756,4577,9333,20201231
20201228,경의선,금릉,3447,3398,6845,20201231
20201228,경의선,금촌,4887,4882,9769,20201231
20201228,경의선,월롱,1565,1480,3045,20201231
20201228,경의선,파주,911,657,1568,20201231
20201228,경의선,문산,3748,3718,7466,20201231
20201228,경의선,임진강,5,2,7,20201231
20201228,경인선,개봉,17185,17813,34998,20201231
20201228,경인선,오류동,9782,9359,19141,20201231
20201228,경인선,역곡,21798,21646,43444,20201231
20201228,경인선,부천,26075,26177,52252,20201231
20201228,경인선,송내,22141,21958,44099,20201231
20201228,경인선,부평,22617,23576,46193,20201231
20201228,경인선,백운,5711,5665,11376,20201231
20201228,경인선,동암,12522,12428,24950,20201231
20201228,경인선,주안,14473,13213,27686,20201231
20201228,경인선,제물포,8094,7653,15747,20201231
20201228,경인선,동인천,10989,10472,21461,20201231
20201228,경인선,인천,2372,1707,4079,20201231
20201228,경인선,구일,4979,5190,10169,20201231
20201228,경인선,소사,7695,6811,14506,20201231
20201228,경인선,부개,6809,6478,13287,20201231
20201228,경인선,간석,4424,4256,8680,20201231
20201228,경인선,도원,2575,2627,5202,20201231
20201228,경인선,온수(성공회대입구),5169,5043,10212,20201231
20201228,경인선,중동,7513,7130,14643,20201231
20201228,경인선,도화,3353,2973,6326,20201231
20201228,경춘선,신내,1214,1228,2442,20201231
20201228,경춘선,갈매,2417,2163,4580,20201231
20201228,경춘선,별내,2140,2086,4226,20201231
20201228,경춘선,퇴계원,2925,2664,5589,20201231
20201228,경춘선,사릉,2796,2684,5480,20201231
20201228,경춘선,금곡,1221,1122,2343,20201231
20201228,경춘선,평내호평,4732,4600,9332,20201231
20201228,경춘선,천마산,1293,1258,2551,20201231
20201228,경춘선,마석,3146,3032,6178,20201231
20201228,경춘선,대성리,397,329,726,20201231
20201228,경춘선,청평,1125,1091,2216,20201231
20201228,경춘선,상천,200,192,392,20201231
20201228,경춘선,가평,1105,1124,2229,20201231
20201228,경춘선,굴봉산,74,71,145,20201231
20201228,경춘선,백양리,42,43,85,20201231
20201228,경춘선,강촌,240,247,487,20201231
20201228,경춘선,김유정,142,142,284,20201231
20201228,경춘선,남춘천,1560,1626,3186,20201231
20201228,경춘선,춘천,699,695,1394,20201231
20201228,공항철도 1호선,서울역,4602,4258,8860,20201231
20201228,공항철도 1호선,공덕,1629,2078,3707,20201231
20201228,공항철도 1호선,홍대입구,5221,5257,10478,20201231
20201228,공항철도 1호선,디지털미디어시티,10318,9218,19536,20201231
20201228,공항철도 1호선,마곡나루(서울식물원),5058,4859,9917,20201231
20201228,공항철도 1호선,김포공항,7381,4542,11923,20201231
20201228,공항철도 1호선,계양,7202,6675,13877,20201231
20201228,공항철도 1호선,검암,5548,5413,10961,20201231
20201228,공항철도 1호선,청라국제도시,4897,4518,9415,20201231
20201228,공항철도 1호선,운서,4584,4707,9291,20201231
20201228,공항철도 1호선,공항화물청사,2015,2181,4196,20201231
20201228,공항철도 1호선,인천공항1터미널,2769,2924,5693,20201231
20201228,공항철도 1호선,인천공항2터미널,1680,1550,3230,20201231
20201228,공항철도 1호선,영종,2224,2227,4451,20201231
20201228,과천선,선바위,6397,5716,12113,20201231
20201228,과천선,경마공원,707,716,1423,20201231
20201228,과천선,대공원,1348,1442,2790,20201231
20201228,과천선,과천,3714,3442,7156,20201231
20201228,과천선,정부과천청사,7252,7208,14460,20201231
20201228,과천선,인덕원,18240,19011,37251,20201231
20201228,과천선,평촌,14125,14009,28134,20201231
20201228,과천선,범계,18909,18463,37372,20201231
20201228,분당선,선릉,10964,15976,26940,20201231
20201228,분당선,한티,10053,10791,20844,20201231
20201228,분당선,도곡,5057,5077,10134,20201231
20201228,분당선,구룡,1193,1196,2389,20201231
20201228,분당선,개포동,2805,2838,5643,20201231
20201228,분당선,대모산입구,2806,2657,5463,20201231
20201228,분당선,수서,9518,9869,19387,20201231
20201228,분당선,수원,5806,4625,10431,20201231
20201228,분당선,서울숲,6289,6316,12605,20201231
20201228,분당선,압구정로데오,12550,13492,26042,20201231
20201228,분당선,강남구청,7249,8259,15508,20201231
20201228,분당선,선정릉,6212,6665,12877,20201231
20201228,분당선,가천대,4965,5824,10789,20201231
20201228,분당선,태평,10802,10595,21397,20201231
20201228,분당선,모란,16020,16172,32192,20201231
20201228,분당선,야탑,19335,20217,39552,20201231
20201228,분당선,서현,18425,18474,36899,20201231
20201228,분당선,수내,9965,9785,19750,20201231
20201228,분당선,정자,11729,12381,24110,20201231
20201228,분당선,미금,11894,12738,24632,20201231
20201228,분당선,오리,9263,7954,17217,20201231
20201228,분당선,이매,3814,3588,7402,20201231
20201228,분당선,보정,1764,1553,3317,20201231
20201228,분당선,죽전,9892,10884,20776,20201231
20201228,분당선,구성,3663,3769,7432,20201231
20201228,분당선,신갈,3510,3430,6940,20201231
20201228,분당선,기흥,6930,6689,13619,20201231
20201228,분당선,상갈,3861,3740,7601,20201231
20201228,분당선,청명,3067,2984,6051,20201231
20201228,분당선,영통,5773,5932,11705,20201231
20201228,분당선,망포,10269,9937,20206,20201231
20201228,분당선,매탄권선,3354,3253,6607,20201231
20201228,분당선,수원시청,9096,9600,18696,20201231
20201228,분당선,매교,2157,2130,4287,20201231
20201228,수인선,고색,2619,2589,5208,20201231
20201228,수인선,오목천,1633,1601,3234,20201231
20201228,수인선,어천,412,427,839,20201231
20201228,수인선,야목,158,132,290,20201231
20201228,수인선,사리,2569,2481,5050,20201231
20201228,수인선,달월,85,46,131,20201231
20201228,수인선,월곶,1996,1870,3866,20201231
20201228,수인선,소래포구,3670,3524,7194,20201231
20201228,수인선,인천논현,4332,4504,8836,20201231
20201228,수인선,호구포,3018,3219,6237,20201231
20201228,수인선,남동인더스파크,1940,2248,4188,20201231
20201228,수인선,원인재,3526,3456,6982,20201231
20201228,수인선,연수,3467,3349,6816,20201231
20201228,수인선,송도,2073,1870,3943,20201231
20201228,수인선,인하대,4262,3984,8246,20201231
20201228,수인선,숭의,3233,3053,6286,20201231
20201228,수인선,신포,1378,1321,2699,20201231
20201228,수인선,인천,780,1260,2040,20201231
20201228,안산선,산본,12428,13401,25829,20201231
20201228,안산선,대야미,3932,3567,7499,20201231
20201228,안산선,반월,3480,3319,6799,20201231
20201228,안산선,상록수,12978,13005,25983,20201231
20201228,안산선,한대앞,6552,6466,13018,20201231
20201228,안산선,중앙,12263,12447,24710,20201231
20201228,안산선,고잔,6787,6468,13255,20201231
20201228,안산선,초지,3445,3405,6850,20201231
20201228,안산선,안산,9902,8907,18809,20201231
20201228,안산선,신길온천,1298,1190,2488,20201231
20201228,안산선,정왕,5939,6526,12465,20201231
20201228,안산선,오이도,6430,6093,12523,20201231
20201228,중앙선,양원,1179,1201,2380,20201231
20201228,중앙선,구리,10678,10713,21391,20201231
20201228,중앙선,도농,7780,7105,14885,20201231
20201228,중앙선,양정,673,574,1247,20201231
20201228,중앙선,덕소,4372,4414,8786,20201231
20201228,중앙선,도심,1978,1523,3501,20201231
20201228,중앙선,팔당,641,606,1247,20201231
20201228,중앙선,운길산,533,492,1025,20201231
20201228,중앙선,양수,1255,1266,2521,20201231
20201228,중앙선,신원,183,157,340,20201231
20201228,중앙선,국수,543,556,1099,20201231
20201228,중앙선,아신,406,408,814,20201231
20201228,중앙선,오빈,251,233,484,20201231
20201228,중앙선,양평,2081,2048,4129,20201231
20201228,중앙선,원덕,228,205,433,20201231
20201228,중앙선,용문,1181,1157,2338,20201231
20201228,중앙선,지평,36,17,53,20201231
20201228,2호선,을지로4가,11452,11228,22680,20201231
20201228,우이신설선,삼양,1627,1818,3445,20201231
20201228,우이신설선,화계,2790,2588,5378,20201231
20201228,우이신설선,가오리,3225,3298,6523,20201231
20201228,우이신설선,4.19민주묘지,2232,2140,4372,20201231
20201228,우이신설선,솔밭공원,1915,1943,3858,20201231
20201228,우이신설선,북한산우이,1930,1748,3678,20201231
20201228,안산선,수리산,3383,2832,6215,20201231
20201228,중앙선,망우,6056,5951,12007,20201231
20201228,중앙선,상봉(시외버스터미널),4665,4655,9320,20201231
20201228,중앙선,중랑,4532,4350,8882,20201231
20201228,중앙선,회기,17737,17109,34846,20201231
20201228,장항선,신창(순천향대),759,806,1565,20201231
20201228,장항선,온양온천,2694,2643,5337,20201231
20201228,장항선,배방,749,736,1485,20201231
20201228,장항선,아산,2064,1966,4030,20201231
20201228,장항선,쌍용(나사렛대),1379,1331,2710,20201231
20201228,장항선,봉명,1013,982,1995,20201231
20201228,일산선,대화,10227,7934,18161,20201231
20201228,일산선,주엽,6925,6985,13910,20201231
20201228,일산선,정발산,5381,5254,10635,20201231
20201228,일산선,마두,5682,6023,11705,20201231
20201228,일산선,백석,8037,8205,16242,20201231
20201228,일산선,대곡,1415,1040,2455,20201231
20201228,일산선,화정,13091,13486,26577,20201231
20201228,일산선,원당,8879,8538,17417,20201231
20201228,일산선,삼송,14300,14047,28347,20201231
20201228,일산선,원흥,7259,7055,14314,20201231
20201228,우이신설선,신설동,1812,1672,3484,20201231
20201228,우이신설선,보문,1200,1229,2429,20201231
20201228,우이신설선,성신여대입구(돈암),2267,2485,4752,20201231
20201228,우이신설선,정릉,3501,3306,6807,20201231
20201228,우이신설선,북한산보국문,4555,4470,9025,20201231
20201228,우이신설선,솔샘,4514,4362,8876,20201231
20201228,우이신설선,삼양사거리,2010,1998,4008,20201231
20201228,1호선,서울역,30735,28256,58991,20201231
20201228,4호선,당고개,10207,9383,19590,20201231
20201228,분당선,복정,1,0,1,20201231
20201228,5호선,신금호,4951,5235,10186,20201231
20201228,5호선,청구,3223,3013,6236,20201231
20201228,5호선,동대문역사문화공원(DDP),2378,2742,5120,20201231
20201228,5호선,을지로4가,5327,5418,10745,20201231
20201228,5호선,종로3가,7627,7576,15203,20201231
20201228,5호선,광화문(세종문화회관),22939,23528,46467,20201231
20201228,5호선,서대문,13956,14277,28233,20201231
20201228,5호선,충정로(경기대입구),3932,3914,7846,20201231
20201228,5호선,애오개,5185,5276,10461,20201231
20201228,5호선,공덕,10908,11629,22537,20201231
20201228,5호선,마포,11192,11598,22790,20201231
20201228,5호선,여의나루,5593,5647,11240,20201231
20201228,5호선,여의도,20542,21367,41909,20201231
20201228,5호선,신길,3079,3516,6595,20201231
20201228,5호선,영등포시장,7615,7873,15488,20201231
20201228,5호선,영등포구청,3407,3456,6863,20201231
20201228,5호선,양평,6149,6251,12400,20201231
20201228,5호선,오목교(목동운동장앞),16736,17993,34729,20201231
20201228,5호선,목동,13455,14975,28430,20201231
20201228,5호선,신정(은행정),11542,9151,20693,20201231
20201228,5호선,까치산,23522,23066,46588,20201231
20201228,5호선,화곡,23026,21813,44839,20201231
20201228,5호선,우장산,11032,10998,22030,20201231
20201228,5호선,발산,14028,14097,28125,20201231
20201228,5호선,마곡,7575,7438,15013,20201231
20201228,5호선,송정,5493,5217,10710,20201231
20201228,5호선,김포공항,5125,4958,10083,20201231
20201228,5호선,개화산,4283,4083,8366,20201231
20201228,5호선,방화,5394,5083,10477,20201231
20201228,4호선,쌍문,24399,22642,47041,20201231
20201228,4호선,창동,20984,22043,43027,20201231
20201228,4호선,노원,14675,15998,30673,20201231
20201228,4호선,상계,15818,14732,30550,20201231
20201228,7호선,온수(성공회대입구),8805,8180,16985,20201231
20201228,7호선,천왕,8970,8467,17437,20201231
20201228,7호선,광명사거리,18870,18665,37535,20201231
20201228,7호선,철산,17116,17551,34667,20201231
20201228,7호선,가산디지털단지,39121,39269,78390,20201231
20201228,7호선,남구로,14127,14670,28797,20201231
20201228,7호선,대림(구로구청),6324,6237,12561,20201231
20201228,7호선,신풍,9465,9080,18545,20201231
20201228,7호선,보라매,7794,7801,15595,20201231
20201228,7호선,신대방삼거리,13384,13180,26564,20201231
20201228,7호선,장승배기,7968,7751,15719,20201231
20201228,7호선,상도,8263,8091,16354,20201231
20201228,7호선,숭실대입구(살피재),9168,9511,18679,20201231
20201228,7호선,남성,8768,8437,17205,20201231
20201228,7호선,이수,12067,11767,23834,20201231
20201228,7호선,내방,11769,11881,23650,20201231
20201228,7호선,고속터미널,12149,10041,22190,20201231
20201228,7호선,반포,4548,4435,8983,20201231
20201228,7호선,논현,16768,17774,34542,20201231
20201228,7호선,학동,19782,20726,40508,20201231
20201228,7호선,강남구청,12713,13743,26456,20201231
20201228,7호선,청담,15647,17118,32765,20201231
20201228,7호선,뚝섬유원지,5638,5613,11251,20201231
20201228,7호선,건대입구,9004,9378,18382,20201231
20201228,7호선,어린이대공원(세종대),8974,8829,17803,20201231
20201229,4호선,창동,20784,22281,43065,20210101
20201229,경인선,간석,4633,4428,9061,20210101
20201229,5호선,여의도,21205,21578,42783,20210101
20201229,5호선,신길,3116,3526,6642,20210101
20201229,5호선,영등포시장,7541,7886,15427,20210101
20201229,5호선,영등포구청,3325,3433,6758,20210101
20201229,5호선,양평,6288,6412,12700,20210101
20201229,5호선,오목교(목동운동장앞),17054,18245,35299,20210101
20201229,5호선,목동,13331,14895,28226,20210101
20201229,5호선,신정(은행정),11503,9290,20793,20210101
20201229,5호선,까치산,23604,23003,46607,20210101
20201229,5호선,화곡,23050,21773,44823,20210101
20201229,5호선,우장산,10709,10787,21496,20210101
20201229,5호선,발산,13934,14085,28019,20210101
20201229,5호선,마곡,7441,7177,14618,20210101
20201229,5호선,송정,5253,5040,10293,20210101
20201229,5호선,김포공항,4928,4727,9655,20210101
20201229,5호선,개화산,4214,4008,8222,20210101
20201229,5호선,방화,5235,5124,10359,20210101
20201229,4호선,쌍문,24579,22754,47333,20210101
20201229,4호선,노원,14665,16248,30913,20210101
20201229,4호선,상계,15889,14799,30688,20210101
20201229,4호선,당고개,10002,9292,19294,20210101
20201229,4호선,남태령,871,755,1626,20210101
20201229,4호선,사당,17761,15058,32819,20210101
20201229,4호선,총신대입구(이수),15138,16346,31484,20210101
20201229,4호선,동작(현충원),1832,1954,3786,20210101
20201229,4호선,이촌(국립중앙박물관),5013,5542,10555,20210101
20201229,4호선,신용산,11559,12086,23645,20210101
20201229,4호선,삼각지,3679,3917,7596,20210101
20201229,4호선,숙대입구(갈월),9707,9517,19224,20210101
20201229,4호선,서울역,8059,10481,18540,20210101
20201229,4호선,회현(남대문시장),18622,19084,37706,20210101
20201229,4호선,동대문,16660,17067,33727,20210101
20201229,4호선,명동,13207,13502,26709,20210101
20201229,4호선,충무로,22020,22575,44595,20210101
20201229,4호선,동대문역사문화공원(DDP),11552,10670,22222,20210101
20201229,1호선,서울역,30087,28255,58342,20210101
20201229,1호선,동묘앞,5987,6332,12319,20210101
20201229,1호선,시청,16663,16472,33135,20210101
20201229,1호선,종각,25008,24143,49151,20210101
20201229,1호선,종로3가,18236,16711,34947,20210101
20201229,1호선,종로5가,18004,17817,35821,20210101
20201229,1호선,동대문,8817,8361,17178,20210101
20201229,1호선,신설동,11056,11055,22111,20210101
20201229,1호선,제기동,14920,15416,30336,20210101
20201229,1호선,청량리(서울시립대입구),17123,17549,34672,20210101
20201229,2호선,시청,18914,18136,37050,20210101
20201229,2호선,을지로입구,30535,30908,61443,20210101
20201229,2호선,을지로3가,16556,16283,32839,20210101
20201229,2호선,을지로4가,11563,11142,22705,20210101
20201229,2호선,동대문역사문화공원(DDP),8611,9496,18107,20210101
20201229,2호선,신당,11126,11418,22544,20210101
20201229,2호선,상왕십리,10840,10651,21491,20210101
20201229,2호선,왕십리(성동구청),11439,9178,20617,20210101
20201229,2호선,한양대,5101,5145,10246,20210101
20201229,2호선,뚝섬,15979,17306,33285,20210101
20201229,2호선,성수,27511,30002,57513,20210101
20201229,2호선,건대입구,23933,25813,49746,20210101
20201229,2호선,구의(광진구청),19018,18901,37919,20210101
20201229,2호선,강변(동서울터미널),22200,21763,43963,20210101
20201229,2호선,잠실나루,11001,10768,21769,20210101
20201229,2호선,잠실(송파구청),46714,46092,92806,20210101
20201229,2호선,잠실새내,15315,15086,30401,20210101
20201229,2호선,종합운동장,4838,5175,10013,20210101
20201229,2호선,삼성(무역센터),37034,37133,74167,20210101
20201229,2호선,선릉,44533,40067,84600,20210101
20201229,2호선,역삼,39271,41964,81235,20210101
20201229,2호선,강남,60264,59100,119364,20210101
20201229,2호선,교대(법원.검찰청),26062,28957,55019,20210101
20201229,2호선,서초,16923,16618,33541,20210101
20201229,2호선,방배,12612,12973,25585,20210101
20201229,2호선,사당,26914,29067,55981,20210101
20201229,2호선,낙성대(강감찬),21358,20955,42313,20210101
20201229,2호선,서울대입구(관악구청),36464,35551,72015,20210101
20201229,2호선,봉천,19530,18588,38118,20210101
20201229,2호선,신림,50103,49291,99394,20210101
20201229,2호선,신대방,20989,20706,41695,20210101
20201229,2호선,구로디지털단지,49082,49702,98784,20210101
20201229,2호선,대림(구로구청),20118,20548,40666,20210101
20201229,2호선,신도림,37799,36496,74295,20210101
20201229,2호선,문래,17080,17294,34374,20210101
20201229,2호선,영등포구청,19392,19756,39148,20210101
20201229,2호선,당산,14598,16781,31379,20210101
20201229,2호선,합정,21969,22621,44590,20210101
20201229,2호선,홍대입구,31768,32287,64055,20210101
20201229,2호선,신촌,22772,23313,46085,20210101
20201229,2호선,이대,8706,9085,17791,20210101
20201229,2호선,아현,7933,7788,15721,20210101
20201229,2호선,충정로(경기대입구),8088,8380,16468,20210101
20201229,2호선,용답,2103,2077,4180,20210101
20201229,2호선,신답,1268,1519,2787,20210101
20201229,2호선,신설동,2509,2390,4899,20210101
20201229,2호선,도림천,1185,1203,2388,20210101
20201229,2호선,양천구청,5159,5599,10758,20210101
20201229,2호선,신정네거리,7818,8344,16162,20210101
20201229,2호선,용두(동대문구청),2049,2161,4210,20210101
20201229,3호선,지축,2603,2554,5157,20210101
20201229,3호선,구파발,16164,15241,31405,20210101
20201229,3호선,연신내,30201,28411,58612,20210101
20201229,3호선,불광,13220,14308,27528,20210101
20201229,3호선,녹번,12266,11317,23583,20210101
20201229,3호선,홍제,13888,13498,27386,20210101
20201229,3호선,무악재,3171,3207,6378,20210101
20201229,3호선,독립문,5583,5928,11511,20210101
20201229,3호선,경복궁(정부서울청사),13217,12729,25946,20210101
20201229,3호선,안국,13384,13481,26865,20210101
20201229,3호선,종로3가,7973,8924,16897,20210101
20201229,3호선,을지로3가,8356,8522,16878,20210101
20201229,3호선,동대입구,5299,5581,10880,20210101
20201229,3호선,약수,10280,10027,20307,20210101
20201229,3호선,금호,6376,6110,12486,20210101
20201229,3호선,옥수,6667,7086,13753,20210101
20201229,3호선,압구정,25679,27105,52784,20210101
20201229,3호선,신사,24275,24889,49164,20210101
20201229,3호선,잠원,3517,3504,7021,20210101
20201229,3호선,고속터미널,28119,27397,55516,20210101
20201229,3호선,교대(법원.검찰청),10776,7190,17966,20210101
20201229,3호선,남부터미널(예술의전당),22112,22926,45038,20210101
20201229,3호선,양재(서초구청),30020,32167,62187,20210101
20201229,3호선,매봉,9977,9544,19521,20210101
20201229,3호선,도곡,4009,4145,8154,20210101
20201229,3호선,대치,7744,7807,15551,20210101
20201229,3호선,학여울,1300,1363,2663,20210101
20201229,3호선,대청,7982,7138,15120,20210101
20201229,3호선,일원,7650,7559,15209,20210101
20201229,3호선,수서,11677,12118,23795,20210101
20201229,3호선,가락시장,7357,7192,14549,20210101
20201229,3호선,경찰병원,6169,6157,12326,20210101
20201229,3호선,오금,5019,4539,9558,20210101
20201229,4호선,수유(강북구청),28140,28051,56191,20210101
20201229,4호선,미아(서울사이버대학),12449,12162,24611,20210101
20201229,4호선,미아사거리,22803,22637,45440,20210101
20201229,4호선,길음,15922,15498,31420,20210101
20201229,4호선,성신여대입구(돈암),14843,14367,29210,20210101
20201229,장항선,아산,1851,1831,3682,20210101
20201229,장항선,쌍용(나사렛대),1442,1310,2752,20210101
20201229,장항선,봉명,1021,1026,2047,20210101
20201229,일산선,대화,9935,8078,18013,20210101
20201229,일산선,주엽,6610,6657,13267,20210101
20201229,일산선,정발산,5173,5104,10277,20210101
20201229,일산선,마두,5664,5884,11548,20210101
20201229,일산선,백석,8043,8194,16237,20210101
20201229,일산선,대곡,1308,995,2303,20210101
20201229,일산선,화정,12996,13523,26519,20210101
20201229,일산선,원당,8710,8336,17046,20210101
20201229,일산선,삼송,13933,13767,27700,20210101
20201229,일산선,원흥,7362,7130,14492,20210101
20201229,우이신설선,신설동,1823,1716,3539,20210101
20201229,우이신설선,보문,1252,1222,2474,20210101
20201229,우이신설선,성신여대입구(돈암),2379,2522,4901,20210101
20201229,우이신설선,정릉,3503,3360,6863,20210101
20201229,우이신설선,북한산보국문,4543,4468,9011,20210101
20201229,우이신설선,솔샘,4457,4245,8702,20210101
20201229,우이신설선,삼양사거리,1911,2055,3966,20210101
20201229,우이신설선,삼양,1702,1878,3580,20210101
20201229,우이신설선,화계,2696,2645,5341,20210101
20201229,우이신설선,가오리,3172,3216,6388,20210101
20201229,우이신설선,4.19민주묘지,2042,2046,4088,20210101
20201229,우이신설선,솔밭공원,1973,1912,3885,20210101
20201229,우이신설선,북한산우이,2059,1861,3920,20210101
20201229,안산선,수리산,3411,2818,6229,20210101
20201229,안산선,오이도,6319,6080,12399,20210101
20201229,안산선,정왕,5631,6123,11754,20210101
20201229,안산선,신길온천,1222,1167,2389,20210101
20201229,안산선,안산,9392,8471,17863,20210101
20201229,안산선,초지,3491,3542,7033,20210101
20201229,안산선,고잔,6689,6351,13040,20210101
20201229,안산선,중앙,11996,12343,24339,20210101
20201229,안산선,한대앞,6304,6378,12682,20210101
20201229,안산선,상록수,12879,12945,25824,20210101
20201229,안산선,반월,3381,3195,6576,20210101
20201229,안산선,대야미,3781,3471,7252,20210101
20201229,안산선,산본,12369,13173,25542,20210101
20201229,수인선,인천,685,1163,1848,20210101
20201229,수인선,신포,1285,1259,2544,20210101
20201229,수인선,숭의,3203,2999,6202,20210101
20201229,수인선,인하대,4079,3909,7988,20210101
20201229,수인선,송도,1948,1756,3704,20210101
20201229,수인선,연수,3302,3250,6552,20210101
20201229,수인선,원인재,3375,3471,6846,20210101
20201229,수인선,남동인더스파크,2028,2273,4301,20210101
20201229,수인선,호구포,3010,3163,6173,20210101
20201229,수인선,인천논현,4218,4407,8625,20210101
20201229,수인선,소래포구,3538,3350,6888,20210101
20201229,수인선,월곶,1902,1846,3748,20210101
20201229,수인선,달월,95,57,152,20210101
20201229,수인선,사리,2553,2466,5019,20210101
20201229,수인선,야목,159,132,291,20210101
20201229,수인선,어천,426,398,824,20210101
20201229,수인선,오목천,1566,1546,3112,20210101
20201229,수인선,고색,2626,2543,5169,20210101
20201229,분당선,매교,2113,2235,4348,20210101
20201229,분당선,수원시청,9063,9488,18551,20210101
20201229,분당선,매탄권선,3356,3263,6619,20210101
20201229,분당선,망포,10403,10029,20432,20210101
20201229,분당선,영통,5675,5782,11457,20210101
20201229,분당선,청명,3075,2989,6064,20210101
20201229,분당선,상갈,3994,3890,7884,20210101
20201229,분당선,기흥,6894,6620,13514,20210101
20201229,분당선,신갈,3474,3384,6858,20210101
20201229,분당선,구성,3586,3830,7416,20210101
20201229,분당선,죽전,10050,10884,20934,20210101
20201229,분당선,보정,1717,1511,3228,20210101
20201229,분당선,이매,3856,3725,7581,20210101
20201229,분당선,오리,9349,7862,17211,20210101
20201229,분당선,미금,12019,12728,24747,20210101
20201229,분당선,정자,11954,12630,24584,20210101
20201229,분당선,수내,10039,9973,20012,20210101
20201229,분당선,서현,18482,18756,37238,20210101
20201229,분당선,야탑,19651,20477,40128,20210101
20201229,분당선,모란,17415,17821,35236,20210101
20201229,분당선,태평,10895,10743,21638,20210101
20201229,분당선,가천대,9689,9989,19678,20210101
20201229,분당선,선정릉,6441,6867,13308,20210101
20201229,분당선,강남구청,7409,8510,15919,20210101
20201229,분당선,압구정로데오,13893,14820,28713,20210101
20201229,분당선,서울숲,6407,6455,12862,20210101
20201229,분당선,수원,5755,4646,10401,20210101
20201229,분당선,수서,9469,10040,19509,20210101
20201229,분당선,대모산입구,2900,2731,5631,20210101
20201229,분당선,개포동,2839,2894,5733,20210101
20201229,분당선,구룡,1234,1257,2491,20210101
20201229,분당선,도곡,4999,4890,9889,20210101
20201229,분당선,한티,10309,10995,21304,20210101
20201229,분당선,선릉,11037,15911,26948,20210101
20201229,과천선,범계,19348,18961,38309,20210101
20201229,과천선,평촌,14439,14323,28762,20210101
20201229,과천선,인덕원,18555,19344,37899,20210101
20201229,과천선,정부과천청사,7419,7392,14811,20210101
20201229,과천선,과천,3775,3507,7282,20210101
20201229,과천선,대공원,1252,1327,2579,20210101
20201229,과천선,경마공원,785,772,1557,20210101
20201229,과천선,선바위,6274,5656,11930,20210101
20201229,공항철도 1호선,영종,2082,2129,4211,20210101
20201229,공항철도 1호선,인천공항2터미널,1655,1631,3286,20210101
20201229,공항철도 1호선,인천공항1터미널,2889,3194,6083,20210101
20201229,공항철도 1호선,공항화물청사,2094,2252,4346,20210101
20201229,공항철도 1호선,운서,4715,4824,9539,20210101
20201229,공항철도 1호선,청라국제도시,5049,4599,9648,20210101
20201229,공항철도 1호선,검암,5522,5374,10896,20210101
20201229,공항철도 1호선,계양,7172,6756,13928,20210101
20201229,공항철도 1호선,김포공항,6681,4385,11066,20210101
20201229,공항철도 1호선,마곡나루(서울식물원),4858,4775,9633,20210101
20201229,공항철도 1호선,디지털미디어시티,10254,9408,19662,20210101
20201229,공항철도 1호선,홍대입구,5199,5358,10557,20210101
20201229,공항철도 1호선,공덕,1645,2072,3717,20210101
20201229,공항철도 1호선,서울역,4457,4053,8510,20210101
20201229,경춘선,춘천,718,644,1362,20210101
20201229,경춘선,남춘천,1419,1493,2912,20210101
20201229,경춘선,김유정,110,105,215,20210101
20201229,경춘선,강촌,225,241,466,20210101
20201229,경춘선,백양리,47,51,98,20210101
20201229,경춘선,굴봉산,66,72,138,20210101
20201229,경춘선,가평,1108,1032,2140,20210101
20201229,경춘선,상천,162,157,319,20210101
20201229,경춘선,청평,1102,1029,2131,20210101
20201229,경춘선,대성리,335,296,631,20210101
20201229,경춘선,마석,2970,2890,5860,20210101
20201229,경춘선,천마산,1276,1235,2511,20210101
20201229,경춘선,평내호평,4627,4567,9194,20210101
20201229,경춘선,금곡,1231,1162,2393,20210101
20201229,경춘선,사릉,2692,2596,5288,20210101
20201229,경춘선,퇴계원,2879,2697,5576,20210101
20201229,경춘선,별내,2163,2117,4280,20210101
20201229,경춘선,갈매,2474,2168,4642,20210101
20201229,경춘선,신내,1219,1192,2411,20210101
20201229,경인선,도화,3189,2991,6180,20210101
20201229,경인선,중동,7309,6983,14292,20210101
20201229,경인선,온수(성공회대입구),5095,5028,10123,20210101
20201229,경인선,도원,2393,2448,4841,20210101
20201229,경인선,부개,6756,6529,13285,20210101
20201229,경인선,소사,7563,6750,14313,20210101
20201229,경인선,구일,4739,4889,9628,20210101
20201229,경인선,인천,2286,1571,3857,20210101
20201229,경인선,동인천,10578,10188,20766,20210101
20201229,경인선,제물포,8042,7710,15752,20210101
20201229,경인선,주안,14347,13060,27407,20210101
20201229,경인선,동암,12341,12443,24784,20210101
20201229,경인선,백운,5619,5776,11395,20210101
20201229,경인선,부평,22146,23224,45370,20210101
20201229,경인선,송내,22078,22002,44080,20210101
20201229,경인선,부천,25817,25830,51647,20210101
20201229,경인선,역곡,21514,21544,43058,20210101
20201229,경인선,오류동,9658,9294,18952,20210101
20201229,경인선,개봉,17101,17950,35051,20210101
20201229,경의선,임진강,4,6,10,20210101
20201229,경의선,문산,3719,3699,7418,20210101
20201229,경의선,파주,883,619,1502,20210101
20201229,경의선,월롱,1522,1464,2986,20210101
20201229,경의선,금촌,4613,4709,9322,20210101
20201229,경의선,금릉,3332,3303,6635,20210101
20201229,경의선,운정,4688,4491,9179,20210101
20201229,경의선,야당,4515,4215,8730,20210101
20201229,경의선,탄현,5662,5637,11299,20210101
20201229,경의선,일산,6932,7060,13992,20210101
20201229,경의선,풍산,3970,3797,7767,20210101
20201229,경의선,백마,5009,4884,9893,20210101
20201229,경의선,곡산,415,441,856,20210101
20201229,경의선,능곡,2870,2594,5464,20210101
20201229,경의선,행신,5920,5956,11876,20210101
20201229,경의선,강매,2391,2033,4424,20210101
20201229,경의선,화전,1157,1062,2219,20210101
20201229,경의선,수색,1963,1993,3956,20210101
20201229,경의선,디지털미디어시티,1857,1829,3686,20210101
20201229,경의선,가좌,4083,3853,7936,20210101
20201229,경의선,홍대입구,1075,1165,2240,20210101
20201229,경의선,서강대,1500,1455,2955,20210101
20201229,경의선,공덕,2678,2464,5142,20210101
20201229,경의선,효창공원앞,2306,2684,4990,20210101
20201229,경의선,신촌,605,771,1376,20210101
20201229,경의선,서울역,3096,3745,6841,20210101
20201229,경원선,소요산,1862,1584,3446,20210101
20201229,7호선,먹골,8362,8190,16552,20210101
20201229,중앙선,망우,5973,5978,11951,20210101
20201229,중앙선,상봉(시외버스터미널),4581,4533,9114,20210101
20201229,중앙선,중랑,4400,4217,8617,20210101
20201229,중앙선,회기,17643,17185,34828,20210101
20201229,장항선,신창(순천향대),706,681,1387,20210101
20201229,장항선,온양온천,2831,2870,5701,20210101
20201229,장항선,배방,727,715,1442,20210101
20201229,중앙선,지평,34,29,63,20210101
20201229,중앙선,용문,1030,1043,2073,20210101
20201229,중앙선,원덕,209,193,402,20210101
20201229,중앙선,양평,1772,1761,3533,20210101
20201229,중앙선,오빈,206,207,413,20210101
20201229,중앙선,아신,374,348,722,20210101
20201229,중앙선,국수,494,465,959,20210101
20201229,중앙선,신원,130,111,241,20210101
20201229,중앙선,양수,1225,1245,2470,20210101
20201229,중앙선,운길산,506,446,952,20210101
20201229,중앙선,팔당,589,620,1209,20210101
20201229,중앙선,도심,1910,1454,3364,20210101
20201229,중앙선,덕소,4330,4292,8622,20210101
20201229,중앙선,양정,612,552,1164,20210101
20201229,중앙선,도농,7630,6971,14601,20210101
20201229,중앙선,구리,10430,10707,21137,20210101
20201229,중앙선,양원,1106,1134,2240,20210101
20201229,경원선,동두천,1494,1669,3163,20210101
20201229,경원선,보산,1103,1060,2163,20210101
20201229,경원선,동두천중앙,2436,2335,4771,20210101
20201229,경원선,지행,4716,4625,9341,20210101
20201229,경원선,덕정,4132,4073,8205,20210101
20201229,경원선,덕계,2177,1935,4112,20210101
20201229,경원선,양주,5837,5539,11376,20210101
20201229,경원선,녹양,3610,3465,7075,20210101
20201229,경원선,가능,5241,5199,10440,20210101
20201229,경원선,의정부,14102,14233,28335,20210101
20201229,경원선,회룡,9875,9721,19596,20210101
20201229,경원선,망월사,5655,5814,11469,20210101
20201229,경원선,도봉산,6092,3565,9657,20210101
20201229,경원선,도봉,4902,4787,9689,20210101
20201229,경원선,방학,7743,7587,15330,20210101
20201229,경원선,녹천,3857,3360,7217,20210101
20201229,경원선,월계,4790,4673,9463,20210101
20201229,경원선,광운대,6258,5862,12120,20210101
20201229,경원선,석계,6584,7500,14084,20210101
20201229,경원선,신이문,7113,6650,13763,20210101
20201229,경원선,외대앞,5496,5569,11065,20210101
20201229,경원선,청량리(서울시립대입구),10420,11422,21842,20210101
20201229,경원선,왕십리(성동구청),9862,11448,21310,20210101
20201229,경원선,응봉,1367,1188,2555,20210101
20201229,경원선,옥수,40,24,64,20210101
20201229,경원선,한남,3253,3060,6313,20210101
20201229,경원선,서빙고,1455,1345,2800,20210101
20201229,경원선,이촌(국립중앙박물관),2792,2157,4949,20210101
20201229,경부선,광명,2294,2009,4303,20210101
20201229,경부선,서동탄,1184,984,2168,20210101
20201229,경부선,당정,4907,4640,9547,20210101
20201229,경부선,천안,3323,3404,6727,20210101
20201229,경부선,두정,3691,3602,7293,20210101
20201229,경부선,직산,531,562,1093,20210101
20201229,경부선,성환,2353,2262,4615,20210101
20201229,경부선,평택,7972,7859,15831,20210101
20201229,경부선,지제,2071,1944,4015,20210101
20201229,경부선,서정리,4304,4070,8374,20210101
20201229,경부선,송탄,3049,2995,6044,20210101
20201229,경부선,진위,1245,1103,2348,20210101
20201229,경부선,오산,6845,6969,13814,20210101
20201229,경부선,오산대,2301,2011,4312,20210101
20201229,경부선,세마,1922,1801,3723,20210101
20201229,경부선,병점,9835,9591,19426,20210101
20201229,경부선,세류,2261,2214,4475,20210101
20201229,경부선,독산,14273,15195,29468,20210101
20201229,경부선,수원,22916,24209,47125,20210101
20201229,경부선,화서,5573,5484,11057,20210101
20201229,경부선,성균관대,10394,10306,20700,20210101
20201229,경부선,의왕,7112,7031,14143,20210101
20201229,경부선,군포,6602,6682,13284,20210101
20201229,경부선,금정,20842,21379,42221,20210101
20201229,경부선,명학,7433,7423,14856,20210101
20201229,경부선,안양,16168,16423,32591,20210101
20201229,경부선,관악,5752,5409,11161,20210101
20201229,경부선,석수,8070,7242,15312,20210101
20201229,경부선,금천구청,9316,9310,18626,20210101
20201229,경부선,가산디지털단지,14000,16884,30884,20210101
20201229,경부선,구로,15320,15402,30722,20210101
20201229,경부선,신길,7465,6324,13789,20210101
20201229,경부선,신도림,3283,3193,6476,20210101
20201229,경부선,영등포,28321,28849,57170,20210101
20201229,경부선,대방,10075,10509,20584,20210101
20201229,경부선,노량진,6012,6485,12497,20210101
20201229,경부선,용산,22209,22627,44836,20210101
20201229,경부선,남영,7464,8001,15465,20210101
20201229,경부선,서울역,2709,1062,3771,20210101
20201229,경강선,여주,1152,1144,2296,20210101
20201229,경강선,세종대왕릉,179,189,368,20210101
20201229,경강선,부발,1295,1175,2470,20210101
20201229,경강선,이천,1728,1764,3492,20210101
20201229,경강선,신둔도예촌,890,827,1717,20210101
20201229,경강선,곤지암,1491,1439,2930,20210101
20201229,경강선,초월,2237,2248,4485,20210101
20201229,경강선,경기광주,5243,5050,10293,20210101
20201229,경강선,삼동,1978,1738,3716,20210101
20201229,경강선,이매,788,711,1499,20210101
20201229,경강선,판교,3246,3112,6358,20210101
20201229,9호선2~3단계,중앙보훈병원,7441,6674,14115,20210101
20201229,9호선2~3단계,둔촌오륜,823,734,1557,20210101
20201229,9호선2~3단계,올림픽공원(한국체대),3768,3700,7468,20210101
20201229,9호선2~3단계,한성백제,1831,1685,3516,20210101
20201229,9호선2~3단계,송파나루,3507,3705,7212,20210101
20201229,9호선2~3단계,석촌,5868,5223,11091,20210101
20201229,9호선2~3단계,석촌고분,4557,4584,9141,20210101
20201229,9호선2~3단계,삼전,5173,5091,10264,20210101
20201229,9호선2~3단계,종합운동장,3171,3107,6278,20210101
20201229,9호선2~3단계,봉은사,11170,11076,22246,20210101
20201229,9호선2~3단계,삼성중앙,5270,5378,10648,20210101
20201229,9호선2~3단계,선정릉,7140,7812,14952,20210101
20201229,9호선2~3단계,언주,7856,7821,15677,20210101
20201229,9호선,신논현,23370,22747,46117,20210101
20201229,9호선,사평,2375,2363,4738,20210101
20201229,9호선,고속터미널,8058,10097,18155,20210101
20201229,9호선,신반포,2354,2327,4681,20210101
20201229,9호선,구반포,2074,2152,4226,20210101
20201229,9호선,동작(현충원),1290,1023,2313,20210101
20201229,9호선,흑석(중앙대입구),5796,6231,12027,20210101
20201229,9호선,노들,3406,3119,6525,20210101
20201229,9호선,노량진,17855,17126,34981,20210101
20201229,9호선,샛강,4411,4559,8970,20210101
20201229,9호선,여의도,17758,17088,34846,20210101
20201229,9호선,국회의사당,12392,12281,24673,20210101
20201229,9호선,당산,13628,13732,27360,20210101
20201229,9호선,선유도,6136,5931,12067,20210101
20201229,9호선,신목동,2889,2652,5541,20210101
20201229,9호선,염창,13374,13298,26672,20210101
20201229,9호선,등촌,8685,8676,17361,20210101
20201229,9호선,증미,5884,5986,11870,20210101
20201229,9호선,가양,16155,15797,31952,20210101
20201229,9호선,양천향교,7315,7492,14807,20210101
20201229,9호선,마곡나루(서울식물원),8182,8196,16378,20210101
20201229,9호선,신방화,5429,5274,10703,20210101
20201229,9호선,공항시장,2245,2544,4789,20210101
20201229,9호선,김포공항,5210,7010,12220,20210101
20201229,9호선,개화,1943,1410,3353,20210101
20201229,8호선,모란,3936,2800,6736,20210101
20201229,8호선,수진,3955,3722,7677,20210101
20201229,8호선,신흥,3650,4012,7662,20210101
20201229,8호선,단대오거리,8364,8164,16528,20210101
20201229,8호선,남한산성입구(성남법원.검찰청),10929,10102,21031,20210101
20201229,8호선,산성,5382,5421,10803,20210101
20201229,8호선,복정,8301,7283,15584,20210101
20201229,8호선,장지,13800,13426,27226,20210101
20201229,8호선,문정,17777,18363,36140,20210101
20201229,8호선,가락시장,6776,7538,14314,20210101
20201229,8호선,송파,6376,6428,12804,20210101
20201229,8호선,석촌,6215,7025,13240,20210101
20201229,8호선,잠실(송파구청),10713,11790,22503,20210101
20201229,8호선,몽촌토성(평화의문),4322,4492,8814,20210101
20201229,8호선,강동구청,8692,9093,17785,20210101
20201229,8호선,천호(풍납토성),12542,13878,26420,20210101
20201229,8호선,암사,15095,13806,28901,20210101
20201229,7호선,부평구청,9355,7840,17195,20210101
20201229,7호선,굴포천,6872,7244,14116,20210101
20201229,7호선,삼산체육관,3689,3264,6953,20210101
20201229,7호선,상동,9464,9656,19120,20210101
20201229,7호선,부천시청,9720,9691,19411,20210101
20201229,7호선,신중동,11397,11193,22590,20210101
20201229,7호선,춘의,8530,8460,16990,20210101
20201229,7호선,부천종합운동장,3595,3201,6796,20210101
20201229,7호선,까치울,5983,5841,11824,20210101
20201229,7호선,온수(성공회대입구),8811,8019,16830,20210101
20201229,7호선,천왕,8681,8336,17017,20210101
20201229,7호선,광명사거리,18713,18684,37397,20210101
20201229,7호선,철산,17159,17331,34490,20210101
20201229,7호선,가산디지털단지,39580,39423,79003,20210101
20201229,7호선,남구로,13871,14640,28511,20210101
20201229,7호선,대림(구로구청),6175,6234,12409,20210101
20201229,7호선,신풍,9475,9133,18608,20210101
20201229,7호선,보라매,7737,7724,15461,20210101
20201229,7호선,신대방삼거리,13480,13294,26774,20210101
20201229,7호선,장승배기,8033,7970,16003,20210101
20201229,7호선,상도,8202,8127,16329,20210101
20201229,7호선,숭실대입구(살피재),9083,9273,18356,20210101
20201229,7호선,남성,9031,8505,17536,20210101
20201229,7호선,이수,12096,11884,23980,20210101
20201229,7호선,내방,12004,12045,24049,20210101
20201229,7호선,고속터미널,11195,9947,21142,20210101
20201229,7호선,반포,4539,4490,9029,20210101
20201229,7호선,논현,16469,17879,34348,20210101
20201229,7호선,학동,19988,20864,40852,20210101
20201229,7호선,강남구청,13133,14195,27328,20210101
20201229,7호선,청담,16006,17586,33592,20210101
20201229,7호선,뚝섬유원지,5325,5391,10716,20210101
20201229,7호선,건대입구,9600,9636,19236,20210101
20201229,7호선,어린이대공원(세종대),8826,8794,17620,20210101
20201229,7호선,군자(능동),11961,9588,21549,20210101
20201229,7호선,중곡,8141,7963,16104,20210101
20201229,7호선,용마산(용마폭포공원),4873,4810,9683,20210101
20201229,7호선,사가정,13463,13514,26977,20210101
20201229,7호선,면목,12735,12750,25485,20210101
20201229,7호선,상봉(시외버스터미널),13777,13009,26786,20210101
20201229,7호선,중화,9171,9134,18305,20210101
20201229,7호선,태릉입구,6237,5800,12037,20210101
20201229,7호선,공릉(서울과학기술대),8906,9042,17948,20210101
20201229,7호선,하계,13770,13253,27023,20210101
20201229,7호선,중계,11472,10419,21891,20210101
20201229,7호선,노원,15585,16224,31809,20210101
20201229,7호선,마들,10113,9840,19953,20210101
20201229,7호선,수락산,10256,10360,20616,20210101
20201229,7호선,도봉산,7093,8377,15470,20210101
20201229,6호선,봉화산(서울의료원),7300,6854,14154,20210101
20201229,6호선,화랑대(서울여대입구),8801,7027,15828,20210101
20201229,6호선,태릉입구,4136,4502,8638,20210101
20201229,6호선,석계,9996,10181,20177,20210101
20201229,6호선,돌곶이,6772,6367,13139,20210101
20201229,6호선,상월곡(한국과학기술연구원),5018,4608,9626,20210101
20201229,6호선,월곡(동덕여대),9068,8963,18031,20210101
20201229,6호선,고려대(종암),5983,5822,11805,20210101
20201229,6호선,안암(고대병원앞),7640,7516,15156,20210101
20201229,6호선,보문,5803,5482,11285,20210101
20201229,6호선,창신,2822,2300,5122,20210101
20201229,6호선,동묘앞,6381,6433,12814,20210101
20201229,6호선,신당,6388,6755,13143,20210101
20201229,6호선,청구,3109,3428,6537,20210101
20201229,6호선,약수,2952,2930,5882,20210101
20201229,6호선,버티고개,1764,1725,3489,20210101
20201229,6호선,한강진,4812,5402,10214,20210101
20201229,6호선,이태원,6258,6463,12721,20210101
20201229,6호선,녹사평(용산구청),3389,3303,6692,20210101
20201229,6호선,삼각지,4107,3707,7814,20210101
20201229,6호선,효창공원앞,5698,5159,10857,20210101
20201229,6호선,공덕,14398,13946,28344,20210101
20201229,6호선,대흥(서강대앞),6093,6301,12394,20210101
20201229,6호선,광흥창(서강),6826,6728,13554,20210101
20201229,6호선,상수,5420,5720,11140,20210101
20201229,6호선,합정,9454,9132,18586,20210101
20201229,6호선,망원,10512,11437,21949,20210101
20201229,6호선,마포구청,11345,10348,21693,20210101
20201229,6호선,월드컵경기장(성산),3279,3386,6665,20210101
20201229,6호선,디지털미디어시티,11042,12133,23175,20210101
20201229,6호선,증산(명지대앞),8227,8201,16428,20210101
20201229,6호선,새절(신사),10197,9746,19943,20210101
20201229,6호선,구산,5905,4841,10746,20210101
20201229,6호선,연신내,1,0,1,20210101
20201229,6호선,독바위,2295,2462,4757,20210101
20201229,6호선,불광,3412,3554,6966,20210101
20201229,6호선,역촌,3086,3514,6600,20210101
20201229,6호선,응암,14449,14389,28838,20210101
20201229,5호선,하남풍산,3914,3895,7809,20210101
20201229,5호선,미사,10411,10347,20758,20210101
20201229,5호선,마천,4620,4685,9305,20210101
20201229,5호선,거여,6309,6106,12415,20210101
20201229,5호선,개롱,4809,5052,9861,20210101
20201229,5호선,오금,3029,2932,5961,20210101
20201229,4호선,한성대입구(삼선교),10280,10274,20554,20210101
20201229,4호선,혜화,22120,21761,43881,20210101
20201229,5호선,방이,5301,5548,10849,20210101
20201229,5호선,올림픽공원(한국체대),3106,2680,5786,20210101
20201229,5호선,둔촌동,6689,6871,13560,20210101
20201229,5호선,상일동,12908,11568,24476,20210101
20201229,5호선,고덕,6689,6652,13341,20210101
20201229,5호선,명일,6453,6707,13160,20210101
20201229,5호선,굽은다리(강동구민회관앞),7458,7074,14532,20210101
20201229,5호선,길동,6283,6593,12876,20210101
20201229,5호선,강동,15516,14623,30139,20210101
20201229,5호선,천호(풍납토성),14249,14277,28526,20210101
20201229,5호선,광나루(장신대),10175,9198,19373,20210101
20201229,5호선,아차산(어린이대공원후문),11365,11429,22794,20210101
20201229,5호선,군자(능동),8925,9641,18566,20210101
20201229,5호선,장한평,15161,15112,30273,20210101
20201229,5호선,답십리,13135,12226,25361,20210101
20201229,5호선,마장,4630,4475,9105,20210101
20201229,5호선,왕십리(성동구청),3564,3888,7452,20210101
20201229,5호선,행당,6297,5751,12048,20210101
20201229,5호선,신금호,4926,5113,10039,20210101
20201229,5호선,청구,3318,3100,6418,20210101
20201229,5호선,동대문역사문화공원(DDP),2462,2716,5178,20210101
20201229,5호선,을지로4가,5264,5313,10577,20210101
20201229,5호선,종로3가,7836,7751,15587,20210101
20201229,5호선,광화문(세종문화회관),23637,23926,47563,20210101
20201229,5호선,서대문,14179,14431,28610,20210101
20201229,5호선,충정로(경기대입구),3891,3955,7846,20210101
20201229,5호선,애오개,5412,5566,10978,20210101
20201229,5호선,공덕,11342,11891,23233,20210101
20201229,5호선,마포,11472,11811,23283,20210101
20201229,5호선,여의나루,4976,5108,10084,20210101
20201229,7호선,장암,1852,677,2529,20210101
20201230,7호선,가산디지털단지,37927,37430,75357,20210102
20201230,3호선,학여울,1220,1241,2461,20210102
20201230,3호선,대청,7180,6690,13870,20210102
20201230,3호선,일원,7113,6973,14086,20210102
20201230,3호선,수서,11317,11684,23001,20210102
20201230,3호선,가락시장,6669,6482,13151,20210102
20201230,3호선,경찰병원,5758,5825,11583,20210102
20201230,3호선,오금,4645,4240,8885,20210102
20201230,4호선,수유(강북구청),27329,27132,54461,20210102
20201230,4호선,미아(서울사이버대학),11701,11513,23214,20210102
20201230,4호선,미아사거리,21773,21434,43207,20210102
20201230,4호선,길음,15119,14744,29863,20210102
20201230,4호선,성신여대입구(돈암),14541,13884,28425,20210102
20201230,4호선,한성대입구(삼선교),9849,9699,19548,20210102
20201230,4호선,혜화,21812,21594,43406,20210102
20201230,안산선,산본,11593,12324,23917,20210102
20201230,3호선,약수,9689,9418,19107,20210102
20201230,4호선,동대문,16200,16459,32659,20210102
20201230,3호선,금호,5972,5853,11825,20210102
20201230,3호선,옥수,6290,6755,13045,20210102
20201230,3호선,압구정,24284,25721,50005,20210102
20201230,3호선,신사,23332,23968,47300,20210102
20201230,3호선,잠원,3411,3439,6850,20210102
20201230,3호선,고속터미널,28142,29702,57844,20210102
20201230,3호선,교대(법원.검찰청),10181,6950,17131,20210102
20201230,3호선,남부터미널(예술의전당),21547,22316,43863,20210102
20201230,3호선,양재(서초구청),28665,30565,59230,20210102
20201230,3호선,매봉,9499,9014,18513,20210102
20201230,3호선,도곡,3710,3778,7488,20210102
20201230,수인선,인천,695,1118,1813,20210102
20201230,수인선,신포,1159,1130,2289,20210102
20201230,수인선,숭의,2847,2759,5606,20210102
20201230,수인선,인하대,3907,3655,7562,20210102
20201230,수인선,송도,1786,1559,3345,20210102
20201230,수인선,연수,3082,3063,6145,20210102
20201230,수인선,원인재,3169,3208,6377,20210102
20201230,수인선,남동인더스파크,1811,2033,3844,20210102
20201230,수인선,호구포,2889,3022,5911,20210102
20201230,수인선,인천논현,3903,4119,8022,20210102
20201230,수인선,소래포구,2898,2841,5739,20210102
20201230,수인선,월곶,1713,1600,3313,20210102
20201230,수인선,달월,65,45,110,20210102
20201230,수인선,사리,2382,2241,4623,20210102
20201230,수인선,야목,125,99,224,20210102
20201230,분당선,수원시청,8786,9268,18054,20210102
20201230,분당선,매탄권선,3310,3140,6450,20210102
20201230,분당선,망포,9888,9530,19418,20210102
20201230,분당선,영통,5536,5666,11202,20210102
20201230,분당선,청명,3002,2785,5787,20210102
20201230,분당선,상갈,3694,3602,7296,20210102
20201230,분당선,기흥,6739,6452,13191,20210102
20201230,분당선,신갈,3143,3184,6327,20210102
20201230,분당선,구성,3314,3462,6776,20210102
20201230,분당선,죽전,9484,10331,19815,20210102
20201230,분당선,보정,1630,1348,2978,20210102
20201230,분당선,이매,3741,3528,7269,20210102
20201230,분당선,오리,8743,7443,16186,20210102
20201230,분당선,미금,11255,12056,23311,20210102
20201230,분당선,정자,11342,11963,23305,20210102
20201230,분당선,수내,9528,9658,19186,20210102
20201230,분당선,서현,18036,18052,36088,20210102
20201230,분당선,야탑,18579,19282,37861,20210102
20201230,분당선,모란,14917,14729,29646,20210102
20201230,분당선,태평,10232,10100,20332,20210102
20201230,분당선,가천대,4906,5613,10519,20210102
20201230,분당선,선정릉,6178,6514,12692,20210102
20201230,분당선,강남구청,7084,8073,15157,20210102
20201230,분당선,압구정로데오,13553,14221,27774,20210102
20201230,분당선,서울숲,6004,6052,12056,20210102
20201230,분당선,수원,5586,4581,10167,20210102
20201230,분당선,수서,9083,9689,18772,20210102
20201230,분당선,대모산입구,2617,2490,5107,20210102
20201230,분당선,개포동,2658,2810,5468,20210102
20201230,분당선,구룡,1392,1370,2762,20210102
20201230,7호선,대림(구로구청),6219,6300,12519,20210102
20201230,7호선,남구로,13202,14121,27323,20210102
20201230,분당선,도곡,4625,4635,9260,20210102
20201230,분당선,한티,10186,10762,20948,20210102
20201230,분당선,선릉,10383,15055,25438,20210102
20201230,과천선,범계,18631,18164,36795,20210102
20201230,과천선,평촌,13393,13291,26684,20210102
20201230,과천선,인덕원,17281,18156,35437,20210102
20201230,과천선,정부과천청사,6943,6940,13883,20210102
20201230,과천선,과천,3680,3455,7135,20210102
20201230,과천선,대공원,908,948,1856,20210102
20201230,과천선,경마공원,868,899,1767,20210102
20201230,과천선,선바위,5992,5553,11545,20210102
20201230,공항철도 1호선,영종,1995,1992,3987,20210102
20201230,공항철도 1호선,인천공항2터미널,1679,1581,3260,20210102
20201230,공항철도 1호선,인천공항1터미널,2867,3023,5890,20210102
20201230,공항철도 1호선,공항화물청사,1995,2186,4181,20210102
20201230,공항철도 1호선,운서,4658,4437,9095,20210102
20201230,공항철도 1호선,청라국제도시,4782,4476,9258,20210102
20201230,공항철도 1호선,검암,5209,5054,10263,20210102
20201230,공항철도 1호선,계양,6828,6397,13225,20210102
20201230,공항철도 1호선,김포공항,6427,4289,10716,20210102
20201230,공항철도 1호선,마곡나루(서울식물원),4249,4419,8668,20210102
20201230,공항철도 1호선,디지털미디어시티,9790,8919,18709,20210102
20201230,공항철도 1호선,홍대입구,5113,5326,10439,20210102
20201230,공항철도 1호선,공덕,1487,1999,3486,20210102
20201230,공항철도 1호선,서울역,4479,4462,8941,20210102
20201230,경춘선,춘천,645,563,1208,20210102
20201230,경춘선,남춘천,1377,1430,2807,20210102
20201230,경춘선,김유정,130,133,263,20210102
20201230,경춘선,강촌,160,180,340,20210102
20201230,4호선,동대문역사문화공원(DDP),11365,10589,21954,20210102
20201230,4호선,충무로,21367,21731,43098,20210102
20201230,4호선,명동,12439,12778,25217,20210102
20201230,4호선,회현(남대문시장),17926,18493,36419,20210102
20201230,4호선,서울역,7776,10831,18607,20210102
20201230,4호선,숙대입구(갈월),9225,9176,18401,20210102
20201230,4호선,삼각지,3529,3733,7262,20210102
20201230,4호선,신용산,11276,11973,23249,20210102
20201230,4호선,이촌(국립중앙박물관),4792,5324,10116,20210102
20201230,4호선,동작(현충원),1556,1655,3211,20210102
20201230,4호선,총신대입구(이수),14129,15267,29396,20210102
20201230,4호선,사당,17544,14403,31947,20210102
20201230,4호선,남태령,840,668,1508,20210102
20201230,4호선,당고개,9541,8710,18251,20210102
20201230,4호선,상계,15144,14162,29306,20210102
20201230,4호선,노원,14127,15617,29744,20210102
20201230,4호선,창동,19546,20991,40537,20210102
20201230,4호선,쌍문,23548,22156,45704,20210102
20201230,5호선,방화,5083,4878,9961,20210102
20201230,5호선,개화산,4038,3876,7914,20210102
20201230,5호선,김포공항,4752,4907,9659,20210102
20201230,5호선,송정,5127,4856,9983,20210102
20201230,5호선,마곡,7154,6982,14136,20210102
20201230,5호선,발산,13256,13465,26721,20210102
20201230,5호선,우장산,10359,10455,20814,20210102
20201230,5호선,화곡,22107,20706,42813,20210102
20201230,5호선,까치산,22565,22156,44721,20210102
20201230,5호선,신정(은행정),11106,8961,20067,20210102
20201230,5호선,목동,12699,14015,26714,20210102
20201230,5호선,오목교(목동운동장앞),16758,17704,34462,20210102
20201230,수인선,어천,400,352,752,20210102
20201230,수인선,오목천,1487,1462,2949,20210102
20201230,수인선,고색,2451,2424,4875,20210102
20201230,분당선,매교,1856,1907,3763,20210102
20201230,8호선,석촌,5942,6720,12662,20210102
20201230,1호선,서울역,29341,28829,58170,20210102
20201230,1호선,동묘앞,5256,5563,10819,20210102
20201230,1호선,시청,16066,15801,31867,20210102
20201230,1호선,종각,24395,23084,47479,20210102
20201230,1호선,종로3가,16825,15478,32303,20210102
20201230,1호선,종로5가,16874,16600,33474,20210102
20201230,1호선,동대문,8467,7819,16286,20210102
20201230,1호선,신설동,10770,10691,21461,20210102
20201230,1호선,제기동,12087,12244,24331,20210102
20201230,1호선,청량리(서울시립대입구),14754,14645,29399,20210102
20201230,2호선,시청,18749,18046,36795,20210102
20201230,2호선,을지로입구,29588,29880,59468,20210102
20201230,2호선,을지로3가,16238,15981,32219,20210102
20201230,2호선,을지로4가,10866,10492,21358,20210102
20201230,2호선,동대문역사문화공원(DDP),8480,9372,17852,20210102
20201230,2호선,신당,10646,11022,21668,20210102
20201230,2호선,상왕십리,10509,10238,20747,20210102
20201230,2호선,왕십리(성동구청),11377,9127,20504,20210102
20201230,2호선,한양대,5001,5039,10040,20210102
20201230,2호선,뚝섬,15237,16575,31812,20210102
20201230,2호선,성수,26207,28690,54897,20210102
20201230,2호선,건대입구,25703,26850,52553,20210102
20201230,2호선,구의(광진구청),18282,18261,36543,20210102
20201230,2호선,강변(동서울터미널),21444,21755,43199,20210102
20201230,2호선,잠실나루,10253,10059,20312,20210102
20201230,2호선,잠실(송파구청),46491,46302,92793,20210102
20201230,2호선,잠실새내,14966,14900,29866,20210102
20201230,2호선,종합운동장,4502,4956,9458,20210102
20201230,2호선,삼성(무역센터),36380,36195,72575,20210102
20201230,2호선,선릉,42780,38249,81029,20210102
20201230,2호선,역삼,38059,40371,78430,20210102
20201230,2호선,강남,59213,57657,116870,20210102
20201230,2호선,교대(법원.검찰청),25396,28021,53417,20210102
20201230,5호선,양평,6004,6127,12131,20210102
20201230,5호선,영등포구청,3142,3154,6296,20210102
20201230,5호선,영등포시장,7123,7396,14519,20210102
20201230,5호선,신길,3078,3445,6523,20210102
20201230,5호선,여의도,20642,20976,41618,20210102
20201230,5호선,여의나루,4621,4928,9549,20210102
20201230,5호선,마포,11219,11487,22706,20210102
20201230,5호선,공덕,10599,11215,21814,20210102
20201230,5호선,애오개,5141,5291,10432,20210102
20201230,5호선,충정로(경기대입구),3690,3798,7488,20210102
20201230,5호선,서대문,13909,14157,28066,20210102
20201230,5호선,광화문(세종문화회관),22575,22981,45556,20210102
20201230,5호선,종로3가,7291,7306,14597,20210102
20201230,5호선,을지로4가,4828,4929,9757,20210102
20201230,5호선,동대문역사문화공원(DDP),2361,2611,4972,20210102
20201230,5호선,청구,3064,2957,6021,20210102
20201230,5호선,신금호,4704,4895,9599,20210102
20201230,5호선,행당,6209,5570,11779,20210102
20201230,5호선,왕십리(성동구청),3391,3642,7033,20210102
20201230,5호선,마장,4302,4170,8472,20210102
20201230,5호선,답십리,12587,11680,24267,20210102
20201230,5호선,장한평,14396,14390,28786,20210102
20201230,5호선,군자(능동),8713,9236,17949,20210102
20201230,5호선,아차산(어린이대공원후문),10770,10745,21515,20210102
20201230,5호선,광나루(장신대),9488,8466,17954,20210102
20201230,5호선,천호(풍납토성),13740,13586,27326,20210102
20201230,5호선,강동,14979,14047,29026,20210102
20201230,5호선,길동,5979,6350,12329,20210102
20201230,5호선,굽은다리(강동구민회관앞),7235,6929,14164,20210102
20201230,5호선,명일,6088,6501,12589,20210102
20201230,5호선,고덕,6403,6349,12752,20210102
20201230,5호선,상일동,11874,10888,22762,20210102
20201230,5호선,둔촌동,6524,6537,13061,20210102
20201230,5호선,올림픽공원(한국체대),3111,2593,5704,20210102
20201230,5호선,방이,5131,5383,10514,20210102
20201230,5호선,오금,2903,2747,5650,20210102
20201230,5호선,개롱,4713,4964,9677,20210102
20201230,5호선,거여,5860,5531,11391,20210102
20201230,5호선,마천,4456,4580,9036,20210102
20201230,5호선,미사,9856,9699,19555,20210102
20201230,5호선,하남풍산,3747,3712,7459,20210102
20201230,6호선,응암,13729,13819,27548,20210102
20201230,6호선,역촌,2890,3392,6282,20210102
20201230,6호선,불광,3358,3414,6772,20210102
20201230,6호선,독바위,2128,2273,4401,20210102
20201230,6호선,연신내,1,0,1,20210102
20201230,6호선,구산,5756,4610,10366,20210102
20201230,6호선,새절(신사),9786,9214,19000,20210102
20201230,6호선,증산(명지대앞),7906,7940,15846,20210102
20201230,6호선,디지털미디어시티,10376,11203,21579,20210102
20201230,6호선,월드컵경기장(성산),2976,3135,6111,20210102
20201230,6호선,마포구청,10764,9977,20741,20210102
20201230,6호선,망원,10176,11069,21245,20210102
20201230,6호선,합정,9041,8909,17950,20210102
20201230,6호선,상수,5535,5888,11423,20210102
20201230,6호선,광흥창(서강),6409,6298,12707,20210102
20201230,6호선,대흥(서강대앞),5741,5988,11729,20210102
20201230,6호선,공덕,13714,13403,27117,20210102
20201230,6호선,효창공원앞,5534,5022,10556,20210102
20201230,6호선,삼각지,4010,3597,7607,20210102
20201230,6호선,녹사평(용산구청),3236,3203,6439,20210102
20201230,6호선,이태원,5979,6158,12137,20210102
20201230,6호선,한강진,4607,5253,9860,20210102
20201230,6호선,버티고개,1660,1594,3254,20210102
20201230,6호선,약수,2723,2695,5418,20210102
20201230,6호선,청구,3060,3224,6284,20210102
20201230,6호선,신당,6201,6471,12672,20210102
20201230,6호선,동묘앞,6160,6246,12406,20210102
20201230,6호선,창신,2751,2301,5052,20210102
20201230,6호선,보문,5616,5247,10863,20210102
20201230,6호선,안암(고대병원앞),7361,7163,14524,20210102
20201230,6호선,고려대(종암),5915,5687,11602,20210102
20201230,6호선,월곡(동덕여대),8460,8474,16934,20210102
20201230,6호선,상월곡(한국과학기술연구원),4956,4361,9317,20210102
20201230,6호선,돌곶이,6692,6259,12951,20210102
20201230,6호선,석계,9620,9894,19514,20210102
20201230,6호선,태릉입구,3931,4233,8164,20210102
20201230,6호선,화랑대(서울여대입구),8485,6783,15268,20210102
20201230,6호선,봉화산(서울의료원),7013,6593,13606,20210102
20201230,7호선,장암,1670,639,2309,20210102
20201230,7호선,도봉산,6742,7785,14527,20210102
20201230,7호선,수락산,9714,9846,19560,20210102
20201230,7호선,마들,9649,9274,18923,20210102
20201230,7호선,노원,15075,15567,30642,20210102
20201230,7호선,중계,10857,9834,20691,20210102
20201230,7호선,하계,13717,13182,26899,20210102
20201230,7호선,공릉(서울과학기술대),8692,8532,17224,20210102
20201230,7호선,태릉입구,6099,5634,11733,20210102
20201230,7호선,먹골,7985,7860,15845,20210102
20201230,7호선,중화,8869,8841,17710,20210102
20201230,7호선,상봉(시외버스터미널),13546,12554,26100,20210102
20201230,7호선,면목,12068,12060,24128,20210102
20201230,7호선,사가정,12980,13172,26152,20210102
20201230,7호선,용마산(용마폭포공원),4731,4554,9285,20210102
20201230,7호선,중곡,7845,7662,15507,20210102
20201230,7호선,군자(능동),11553,9250,20803,20210102
20201230,7호선,어린이대공원(세종대),10508,10571,21079,20210102
20201230,7호선,건대입구,13527,12930,26457,20210102
20201230,7호선,뚝섬유원지,5055,5036,10091,20210102
20201230,7호선,청담,15268,16857,32125,20210102
20201230,7호선,강남구청,12811,13832,26643,20210102
20201230,7호선,학동,19226,20226,39452,20210102
20201230,7호선,논현,15813,17376,33189,20210102
20201230,7호선,반포,4513,4270,8783,20210102
20201230,7호선,고속터미널,11043,9940,20983,20210102
20201230,7호선,내방,11517,11650,23167,20210102
20201230,7호선,이수,11637,11390,23027,20210102
20201230,7호선,남성,8703,8159,16862,20210102
20201230,7호선,숭실대입구(살피재),8807,8924,17731,20210102
20201230,7호선,상도,7865,7592,15457,20210102
20201230,7호선,장승배기,7566,7462,15028,20210102
20201230,7호선,신대방삼거리,12954,12588,25542,20210102
20201230,7호선,보라매,7336,7237,14573,20210102
20201230,7호선,신풍,9058,8813,17871,20210102
20201230,경춘선,백양리,45,40,85,20210102
20201230,중앙선,지평,13,19,32,20210102
20201230,중앙선,용문,978,1057,2035,20210102
20201230,중앙선,원덕,183,172,355,20210102
20201230,중앙선,양평,1609,1605,3214,20210102
20201230,중앙선,오빈,194,178,372,20210102
20201230,중앙선,아신,291,288,579,20210102
20201230,중앙선,국수,464,423,887,20210102
20201230,중앙선,신원,93,105,198,20210102
20201230,중앙선,양수,1013,1023,2036,20210102
20201230,중앙선,운길산,366,317,683,20210102
20201230,중앙선,팔당,523,526,1049,20210102
20201230,중앙선,도심,1728,1358,3086,20210102
20201230,중앙선,덕소,4038,4055,8093,20210102
20201230,중앙선,양정,575,482,1057,20210102
20201230,중앙선,도농,7117,6618,13735,20210102
20201230,중앙선,구리,9990,10182,20172,20210102
20201230,중앙선,양원,1213,1191,2404,20210102
20201230,중앙선,망우,5580,5620,11200,20210102
20201230,중앙선,상봉(시외버스터미널),4280,4348,8628,20210102
20201230,중앙선,중랑,4172,4036,8208,20210102
20201230,중앙선,회기,16974,16198,33172,20210102
20201230,장항선,신창(순천향대),734,622,1356,20210102
20201230,장항선,온양온천,2404,2507,4911,20210102
20201230,장항선,배방,766,622,1388,20210102
20201230,장항선,아산,2092,2142,4234,20210102
20201230,장항선,쌍용(나사렛대),1567,1329,2896,20210102
20201230,장항선,봉명,1062,995,2057,20210102
20201230,일산선,대화,9457,7788,17245,20210102
20201230,일산선,주엽,6085,6049,12134,20210102
20201230,일산선,정발산,4872,4803,9675,20210102
20201230,일산선,마두,5368,5550,10918,20210102
20201230,일산선,백석,7649,7777,15426,20210102
20201230,일산선,대곡,1166,871,2037,20210102
20201230,일산선,화정,11965,12546,24511,20210102
20201230,일산선,원당,8094,7770,15864,20210102
20201230,일산선,삼송,12776,12919,25695,20210102
20201230,일산선,지축,1,0,1,20210102
20201230,일산선,원흥,6917,6542,13459,20210102
20201230,우이신설선,신설동,1698,1594,3292,20210102
20201230,우이신설선,보문,1203,1179,2382,20210102
20201230,우이신설선,성신여대입구(돈암),2220,2449,4669,20210102
20201230,우이신설선,정릉,3213,3157,6370,20210102
20201230,우이신설선,북한산보국문,4235,4241,8476,20210102
20201230,우이신설선,솔샘,4309,4067,8376,20210102
20201230,우이신설선,삼양사거리,1778,1842,3620,20210102
20201230,우이신설선,삼양,1549,1691,3240,20210102
20201230,우이신설선,화계,2491,2399,4890,20210102
20201230,우이신설선,가오리,3074,3195,6269,20210102
20201230,우이신설선,4.19민주묘지,1870,1855,3725,20210102
20201230,우이신설선,솔밭공원,1769,1801,3570,20210102
20201230,우이신설선,북한산우이,1618,1436,3054,20210102
20201230,안산선,수리산,3204,2524,5728,20210102
20201230,안산선,오이도,5807,5634,11441,20210102
20201230,안산선,정왕,5473,5843,11316,20210102
20201230,안산선,신길온천,1143,1097,2240,20210102
20201230,안산선,안산,8956,8250,17206,20210102
20201230,안산선,초지,3222,3271,6493,20210102
20201230,안산선,고잔,6253,5881,12134,20210102
20201230,안산선,중앙,11402,11945,23347,20210102
20201230,안산선,한대앞,6044,6012,12056,20210102
20201230,안산선,상록수,12063,12198,24261,20210102
20201230,안산선,반월,3021,2908,5929,20210102
20201230,안산선,대야미,3567,3117,6684,20210102
20201230,2호선,서초,16028,15801,31829,20210102
20201230,2호선,방배,12084,12656,24740,20210102
20201230,2호선,사당,25570,27657,53227,20210102
20201230,2호선,낙성대(강감찬),20748,19756,40504,20210102
20201230,2호선,서울대입구(관악구청),35081,33687,68768,20210102
20201230,2호선,봉천,18934,17715,36649,20210102
20201230,2호선,신림,49326,47713,97039,20210102
20201230,2호선,신대방,20250,19752,40002,20210102
20201230,2호선,구로디지털단지,47171,47555,94726,20210102
20201230,2호선,대림(구로구청),18970,19511,38481,20210102
20201230,2호선,신도림,37190,35727,72917,20210102
20201230,2호선,문래,16365,16712,33077,20210102
20201230,2호선,영등포구청,18611,18940,37551,20210102
20201230,2호선,당산,13809,16133,29942,20210102
20201230,2호선,합정,21372,22015,43387,20210102
20201230,2호선,홍대입구,31786,32522,64308,20210102
20201230,2호선,신촌,22369,23133,45502,20210102
20201230,2호선,이대,8295,8434,16729,20210102
20201230,2호선,아현,7610,7521,15131,20210102
20201230,2호선,충정로(경기대입구),7609,7913,15522,20210102
20201230,2호선,용답,2023,1970,3993,20210102
20201230,2호선,신답,1202,1487,2689,20210102
20201230,2호선,신설동,2670,2556,5226,20210102
20201230,2호선,도림천,1227,1258,2485,20210102
20201230,2호선,양천구청,4948,5311,10259,20210102
20201230,2호선,신정네거리,7441,7759,15200,20210102
20201230,2호선,용두(동대문구청),1844,1941,3785,20210102
20201230,3호선,지축,2412,2340,4752,20210102
20201230,3호선,구파발,15009,14120,29129,20210102
20201230,3호선,연신내,28898,27224,56122,20210102
20201230,3호선,불광,12355,13055,25410,20210102
20201230,3호선,녹번,11553,10629,22182,20210102
20201230,3호선,홍제,12936,12593,25529,20210102
20201230,3호선,무악재,2966,3021,5987,20210102
20201230,3호선,독립문,4973,5146,10119,20210102
20201230,3호선,경복궁(정부서울청사),12504,12030,24534,20210102
20201230,3호선,안국,10745,11255,22000,20210102
20201230,3호선,종로3가,7817,8721,16538,20210102
20201230,3호선,을지로3가,8325,8634,16959,20210102
20201230,3호선,동대입구,5054,5161,10215,20210102
20201230,경춘선,굴봉산,51,52,103,20210102
20201230,경춘선,가평,869,903,1772,20210102
20201230,경춘선,상천,147,117,264,20210102
20201230,경춘선,청평,870,904,1774,20210102
20201230,경춘선,대성리,277,241,518,20210102
20201230,경춘선,마석,2714,2672,5386,20210102
20201230,경춘선,천마산,1182,1102,2284,20210102
20201230,경춘선,평내호평,4322,4218,8540,20210102
20201230,경춘선,금곡,1112,1028,2140,20210102
20201230,경춘선,사릉,2545,2481,5026,20210102
20201230,경춘선,퇴계원,2678,2483,5161,20210102
20201230,경춘선,별내,1947,1875,3822,20210102
20201230,경춘선,갈매,2253,1984,4237,20210102
20201230,경춘선,신내,1074,1125,2199,20210102
20201230,경인선,도화,2967,2760,5727,20210102
20201230,경인선,중동,6786,6498,13284,20210102
20201230,경인선,온수(성공회대입구),4610,4577,9187,20210102
20201230,경인선,도원,2177,2185,4362,20210102
20201230,경인선,간석,4123,3987,8110,20210102
20201230,경인선,부개,6429,6166,12595,20210102
20201230,경인선,소사,7186,6261,13447,20210102
20201230,경인선,구일,4390,4668,9058,20210102
20201230,경인선,인천,2072,1503,3575,20210102
20201230,경인선,동인천,9777,9416,19193,20210102
20201230,경인선,제물포,7538,7218,14756,20210102
20201230,경인선,주안,13772,12613,26385,20210102
20201230,경인선,동암,11675,11888,23563,20210102
20201230,경인선,백운,5212,5192,10404,20210102
20201230,경인선,부평,21493,22495,43988,20210102
20201230,경인선,송내,21033,20973,42006,20210102
20201230,경인선,부천,24726,24955,49681,20210102
20201230,경인선,역곡,20494,20514,41008,20210102
20201230,경인선,오류동,8949,8572,17521,20210102
20201230,경인선,개봉,16227,17032,33259,20210102
20201230,경의선,임진강,2,2,4,20210102
20201230,경의선,문산,3359,3369,6728,20210102
20201230,경의선,파주,807,551,1358,20210102
20201230,경의선,월롱,1443,1315,2758,20210102
20201230,경의선,금촌,4344,4406,8750,20210102
20201230,경의선,금릉,3100,3041,6141,20210102
20201230,경의선,운정,4398,4177,8575,20210102
20201230,경의선,야당,4186,3953,8139,20210102
20201230,경의선,탄현,5215,5168,10383,20210102
20201230,경의선,일산,6465,6533,12998,20210102
20201230,경의선,풍산,3605,3445,7050,20210102
20201230,경의선,백마,4699,4609,9308,20210102
20201230,경의선,곡산,396,377,773,20210102
20201230,경의선,능곡,2560,2352,4912,20210102
20201230,경의선,행신,5560,5534,11094,20210102
20201230,경의선,강매,2158,1875,4033,20210102
20201230,경의선,화전,1104,1003,2107,20210102
20201230,경의선,수색,1726,1776,3502,20210102
20201230,경의선,디지털미디어시티,1734,1721,3455,20210102
20201230,경의선,가좌,3687,3474,7161,20210102
20201230,경의선,홍대입구,1049,1092,2141,20210102
20201230,경의선,서강대,1443,1327,2770,20210102
20201230,경의선,공덕,2626,2176,4802,20210102
20201230,경의선,효창공원앞,2196,2492,4688,20210102
20201230,경의선,신촌,567,687,1254,20210102
20201230,경의선,서울역,2744,3487,6231,20210102
20201230,경원선,소요산,1461,1262,2723,20210102
20201230,경원선,동두천,1300,1506,2806,20210102
20201230,경원선,보산,1035,979,2014,20210102
20201230,경원선,동두천중앙,2237,2192,4429,20210102
20201230,경원선,지행,4409,4394,8803,20210102
20201230,경원선,덕정,3855,3787,7642,20210102
20201230,경원선,덕계,2020,1764,3784,20210102
20201230,경원선,양주,5428,5196,10624,20210102
20201230,경원선,녹양,3423,3261,6684,20210102
20201230,경원선,가능,4821,4715,9536,20210102
20201230,경원선,의정부,13345,13454,26799,20210102
20201230,경원선,회룡,9170,8977,18147,20210102
20201230,경원선,망월사,5087,5244,10331,20210102
20201230,경원선,도봉산,5227,3095,8322,20210102
20201230,경원선,도봉,4529,4367,8896,20210102
20201230,경원선,방학,7264,7091,14355,20210102
20201230,경원선,녹천,3695,3065,6760,20210102
20201230,경원선,월계,4588,4296,8884,20210102
20201230,경원선,광운대,5928,5676,11604,20210102
20201230,경원선,석계,6094,7043,13137,20210102
20201230,경원선,신이문,6610,6346,12956,20210102
20201230,경원선,외대앞,5323,5249,10572,20210102
20201230,경원선,청량리(서울시립대입구),9444,10574,20018,20210102
20201230,경원선,왕십리(성동구청),9720,11245,20965,20210102
20201230,경원선,응봉,1231,1041,2272,20210102
20201230,경원선,옥수,38,17,55,20210102
20201230,경원선,한남,3046,2915,5961,20210102
20201230,경원선,서빙고,1293,1216,2509,20210102
20201230,경원선,이촌(국립중앙박물관),2639,2023,4662,20210102
20201230,경부선,광명,2131,2032,4163,20210102
20201230,경부선,서동탄,1061,912,1973,20210102
20201230,경부선,당정,4492,4221,8713,20210102
20201230,경부선,천안,3428,3423,6851,20210102
20201230,경부선,두정,3652,3607,7259,20210102
20201230,경부선,직산,499,539,1038,20210102
20201230,경부선,성환,2365,2360,4725,20210102
20201230,경부선,평택,8234,7675,15909,20210102
20201230,경부선,지제,2074,1865,3939,20210102
20201230,경부선,서정리,4244,3854,8098,20210102
20201230,경부선,송탄,2900,2732,5632,20210102
20201230,경부선,진위,1150,986,2136,20210102
20201230,경부선,오산,6594,6538,13132,20210102
20201230,경부선,오산대,2171,1913,4084,20210102
20201230,경부선,세마,1686,1586,3272,20210102
20201230,경부선,병점,9476,9130,18606,20210102
20201230,경부선,세류,2164,2028,4192,20210102
20201230,경부선,독산,13413,14385,27798,20210102
20201230,경부선,수원,22958,24146,47104,20210102
20201230,경부선,화서,5227,4938,10165,20210102
20201230,경부선,성균관대,9920,9771,19691,20210102
20201230,경부선,의왕,6619,6522,13141,20210102
20201230,경부선,군포,6173,6222,12395,20210102
20201230,경부선,금정,19440,19990,39430,20210102
20201230,경부선,명학,6866,6899,13765,20210102
20201230,경부선,안양,15617,15542,31159,20210102
20201230,경부선,관악,5362,4904,10266,20210102
20201230,경부선,석수,7573,6679,14252,20210102
20201230,경부선,금천구청,8559,8758,17317,20210102
20201230,경부선,가산디지털단지,12817,15678,28495,20210102
20201230,경부선,구로,14614,14925,29539,20210102
20201230,경부선,신길,7063,5986,13049,20210102
20201230,경부선,신도림,2925,2846,5771,20210102
20201230,경부선,영등포,27935,29026,56961,20210102
20201230,경부선,대방,9556,10029,19585,20210102
20201230,경부선,노량진,5681,6092,11773,20210102
20201230,경부선,용산,22559,23878,46437,20210102
20201230,경부선,남영,7267,7684,14951,20210102
20201230,경부선,서울역,2744,1147,3891,20210102
20201230,경강선,여주,1082,1088,2170,20210102
20201230,경강선,세종대왕릉,158,174,332,20210102
20201230,경강선,부발,1342,1121,2463,20210102
20201230,경강선,이천,1570,1654,3224,20210102
20201230,경강선,신둔도예촌,777,776,1553,20210102
20201230,경강선,곤지암,1328,1286,2614,20210102
20201230,경강선,초월,2198,2139,4337,20210102
20201230,경강선,경기광주,4968,4732,9700,20210102
20201230,경강선,삼동,1662,1526,3188,20210102
20201230,경강선,이매,721,622,1343,20210102
20201230,경강선,판교,3076,2979,6055,20210102
20201230,9호선2~3단계,중앙보훈병원,7118,6242,13360,20210102
20201230,9호선2~3단계,둔촌오륜,995,856,1851,20210102
20201230,9호선2~3단계,올림픽공원(한국체대),3600,3552,7152,20210102
20201230,9호선2~3단계,한성백제,1705,1611,3316,20210102
20201230,9호선2~3단계,송파나루,3448,3650,7098,20210102
20201230,9호선2~3단계,석촌,5584,4826,10410,20210102
20201230,9호선2~3단계,석촌고분,4433,4595,9028,20210102
20201230,9호선2~3단계,삼전,4928,4925,9853,20210102
20201230,9호선2~3단계,종합운동장,3137,3049,6186,20210102
20201230,9호선2~3단계,봉은사,10732,10736,21468,20210102
20201230,9호선2~3단계,삼성중앙,5069,5117,10186,20210102
20201230,9호선2~3단계,선정릉,6773,7206,13979,20210102
20201230,9호선2~3단계,언주,7641,7582,15223,20210102
20201230,9호선,신논현,22353,21485,43838,20210102
20201230,9호선,사평,2262,2359,4621,20210102
20201230,9호선,고속터미널,7957,10296,18253,20210102
20201230,9호선,신반포,2189,2163,4352,20210102
20201230,9호선,구반포,2046,2161,4207,20210102
20201230,9호선,동작(현충원),1176,931,2107,20210102
20201230,9호선,흑석(중앙대입구),5412,5696,11108,20210102
20201230,9호선,노들,3302,3032,6334,20210102
20201230,9호선,노량진,17434,16566,34000,20210102
20201230,9호선,샛강,4234,4375,8609,20210102
20201230,9호선,여의도,17194,16697,33891,20210102
20201230,9호선,국회의사당,12286,11996,24282,20210102
20201230,9호선,당산,13504,13075,26579,20210102
20201230,9호선,선유도,6037,5902,11939,20210102
20201230,9호선,신목동,2754,2500,5254,20210102
20201230,9호선,염창,12809,12589,25398,20210102
20201230,9호선,등촌,8347,8414,16761,20210102
20201230,9호선,증미,5698,5936,11634,20210102
20201230,3호선,대치,7362,7272,14634,20210102
20201230,9호선,가양,15312,14977,30289,20210102
20201230,9호선,양천향교,7081,7348,14429,20210102
20201230,9호선,마곡나루(서울식물원),7774,7766,15540,20210102
20201230,9호선,신방화,5039,4955,9994,20210102
20201230,9호선,공항시장,2210,2454,4664,20210102
20201230,9호선,김포공항,5019,7180,12199,20210102
20201230,9호선,개화,1790,1234,3024,20210102
20201230,8호선,모란,3204,2205,5409,20210102
20201230,8호선,수진,4007,3630,7637,20210102
20201230,8호선,신흥,3575,3887,7462,20210102
20201230,8호선,단대오거리,8007,7751,15758,20210102
20201230,8호선,남한산성입구(성남법원.검찰청),10263,9567,19830,20210102
20201230,8호선,산성,5120,5085,10205,20210102
20201230,8호선,복정,7632,6722,14354,20210102
20201230,8호선,장지,13203,13225,26428,20210102
20201230,8호선,문정,16933,17784,34717,20210102
20201230,8호선,가락시장,6160,6854,13014,20210102
20201230,8호선,송파,6110,6246,12356,20210102
20201230,8호선,잠실(송파구청),10793,11721,22514,20210102
20201230,8호선,몽촌토성(평화의문),3995,4106,8101,20210102
20201230,8호선,강동구청,8233,8743,16976,20210102
20201230,8호선,천호(풍납토성),11922,13283,25205,20210102
20201230,8호선,암사,14735,13348,28083,20210102
20201230,7호선,부평구청,8949,7525,16474,20210102
20201230,7호선,굴포천,6656,7118,13774,20210102
20201230,7호선,삼산체육관,3418,3073,6491,20210102
20201230,7호선,상동,9132,9407,18539,20210102
20201230,7호선,부천시청,9488,9514,19002,20210102
20201230,7호선,신중동,11062,10915,21977,20210102
20201230,7호선,춘의,8265,8189,16454,20210102
20201230,7호선,부천종합운동장,3466,3010,6476,20210102
20201230,7호선,까치울,5547,5500,11047,20210102
20201230,7호선,온수(성공회대입구),8305,7708,16013,20210102
20201230,7호선,천왕,8373,7993,16366,20210102
20201230,7호선,광명사거리,17796,17823,35619,20210102
20201230,7호선,철산,16285,16575,32860,20210102
20201231,경원선,보산,1100,1123,2223,20210103
20201231,경원선,지행,4377,4530,8907,20210103
20201231,경원선,덕정,3898,3782,7680,20210103
20201231,경원선,덕계,1915,1675,3590,20210103
20201231,경원선,양주,5371,5212,10583,20210103
20201231,경원선,녹양,3200,3148,6348,20210103
20201231,경원선,가능,4732,4659,9391,20210103
20201231,경원선,의정부,13665,14364,28029,20210103
20201231,경원선,회룡,8694,8806,17500,20210103
20201231,경원선,망월사,5087,5264,10351,20210103
20201231,경원선,도봉산,5300,3195,8495,20210103
20201231,경원선,도봉,4462,4243,8705,20210103
20201231,경원선,방학,7088,7157,14245,20210103
20201231,경원선,녹천,3428,2869,6297,20210103
20201231,경원선,월계,4741,4370,9111,20210103
20201231,경원선,광운대,6074,5518,11592,20210103
20201231,경원선,석계,6071,6848,12919,20210103
20201231,경원선,신이문,6574,6108,12682,20210103
20201231,경원선,외대앞,5358,5117,10475,20210103
20201231,경원선,청량리(서울시립대입구),10246,11532,21778,20210103
20201231,경원선,왕십리(성동구청),10028,11438,21466,20210103
20201231,경원선,응봉,1185,1015,2200,20210103
20201231,경원선,옥수,36,17,53,20210103
20201231,경원선,한남,3144,2903,6047,20210103
20201231,경원선,서빙고,1253,1181,2434,20210103
20201231,경원선,이촌(국립중앙박물관),2579,1988,4567,20210103
20201231,경부선,광명,2135,1913,4048,20210103
20201231,경부선,서동탄,970,844,1814,20210103
20201231,경부선,당정,4128,3894,8022,20210103
20201231,경부선,천안,4203,4389,8592,20210103
20201231,경부선,두정,3992,3914,7906,20210103
20201231,경부선,직산,525,558,1083,20210103
20201231,경부선,성환,2649,2419,5068,20210103
20201231,경부선,평택,9898,9213,19111,20210103
20201231,경부선,지제,2656,2127,4783,20210103
20201231,경부선,서정리,5835,4084,9919,20210103
20201231,경부선,송탄,3582,3087,6669,20210103
20201231,경부선,진위,1165,936,2101,20210103
20201231,경부선,오산,7270,7107,14377,20210103
20201231,경부선,오산대,2146,1932,4078,20210103
20201231,경부선,세마,1748,1582,3330,20210103
20201231,경부선,병점,9529,9059,18588,20210103
20201231,경부선,세류,2258,2299,4557,20210103
20201231,경부선,독산,12030,12732,24762,20210103
20201231,경부선,수원,24525,26713,51238,20210103
20201231,경부선,화서,4685,4625,9310,20210103
20201231,경부선,성균관대,9645,9191,18836,20210103
20201231,경부선,의왕,6108,5979,12087,20210103
20201231,경부선,군포,5772,5656,11428,20210103
20201231,경부선,금정,17841,18642,36483,20210103
20201231,경부선,명학,6147,6062,12209,20210103
20201231,경부선,안양,15199,15727,30926,20210103
20201231,경부선,관악,4920,4708,9628,20210103
20201231,경부선,석수,7070,6291,13361,20210103
20201231,경부선,금천구청,8495,8700,17195,20210103
20201231,경부선,가산디지털단지,11444,13656,25100,20210103
20201231,경부선,구로,14358,14828,29186,20210103
20201231,경부선,신길,6900,5520,12420,20210103
20201231,경부선,신도림,2781,2807,5588,20210103
20201231,경부선,영등포,30252,31925,62177,20210103
20201231,경부선,대방,9099,9160,18259,20210103
20201231,경부선,노량진,6738,6934,13672,20210103
20201231,경부선,용산,24519,25810,50329,20210103
20201231,경부선,남영,6831,6893,13724,20210103
20201231,경부선,서울역,3140,1258,4398,20210103
20201231,경강선,여주,1139,1462,2601,20210103
20201231,경강선,세종대왕릉,172,178,350,20210103
20201231,경강선,부발,1853,1166,3019,20210103
20201231,경강선,이천,1807,2058,3865,20210103
20201231,경강선,신둔도예촌,827,884,1711,20210103
20201231,경강선,곤지암,1490,1394,2884,20210103
20201231,경강선,초월,2215,2020,4235,20210103
20201231,경강선,경기광주,4706,4712,9418,20210103
20201231,경강선,삼동,1589,1504,3093,20210103
20201231,경강선,이매,683,620,1303,20210103
20201231,경강선,판교,2919,2806,5725,20210103
20201231,9호선2~3단계,중앙보훈병원,5905,5261,11166,20210103
20201231,9호선2~3단계,둔촌오륜,722,649,1371,20210103
20201231,9호선2~3단계,올림픽공원(한국체대),3268,3321,6589,20210103
20201231,9호선2~3단계,한성백제,1584,1354,2938,20210103
20201231,9호선2~3단계,송파나루,3274,3342,6616,20210103
20201231,9호선2~3단계,석촌,5331,4600,9931,20210103
20201231,9호선2~3단계,석촌고분,4175,4171,8346,20210103
20201231,9호선2~3단계,삼전,4823,4562,9385,20210103
20201231,9호선2~3단계,종합운동장,2849,2717,5566,20210103
20201231,9호선2~3단계,봉은사,9944,9613,19557,20210103
20201231,9호선2~3단계,삼성중앙,4434,4429,8863,20210103
20201231,9호선2~3단계,선정릉,5864,6106,11970,20210103
20201231,9호선2~3단계,언주,6639,6262,12901,20210103
20201231,9호선,신논현,21984,20998,42982,20210103
20201231,9호선,사평,2127,2142,4269,20210103
20201231,9호선,고속터미널,8223,13065,21288,20210103
20201231,9호선,신반포,2037,2051,4088,20210103
20201231,9호선,구반포,1800,1827,3627,20210103
20201231,9호선,동작(현충원),1177,884,2061,20210103
20201231,9호선,흑석(중앙대입구),5324,5446,10770,20210103
20201231,9호선,노들,3105,2722,5827,20210103
20201231,9호선,노량진,17916,16669,34585,20210103
20201231,9호선,샛강,3709,3763,7472,20210103
20201231,9호선,여의도,15479,14399,29878,20210103
20201231,9호선,국회의사당,10532,10359,20891,20210103
20201231,9호선,당산,12637,12106,24743,20210103
20201231,9호선,선유도,5206,5026,10232,20210103
20201231,9호선,신목동,2518,2299,4817,20210103
20201231,9호선,염창,12130,11781,23911,20210103
20201231,9호선,등촌,7967,7844,15811,20210103
20201231,9호선,증미,5578,5636,11214,20210103
20201231,9호선,가양,14745,14324,29069,20210103
20201231,9호선,양천향교,6704,6593,13297,20210103
20201231,9호선,마곡나루(서울식물원),7157,7100,14257,20210103
20201231,9호선,신방화,4849,4806,9655,20210103
20201231,9호선,공항시장,2146,2291,4437,20210103
20201231,9호선,김포공항,5220,8990,14210,20210103
20201231,9호선,개화,1660,1178,2838,20210103
20201231,8호선,모란,3136,2329,5465,20210103
20201231,8호선,수진,4008,3707,7715,20210103
20201231,8호선,신흥,3734,3874,7608,20210103
20201231,8호선,단대오거리,7703,7388,15091,20210103
20201231,8호선,남한산성입구(성남법원.검찰청),9819,8871,18690,20210103
20201231,8호선,산성,4943,4895,9838,20210103
20201231,8호선,복정,6986,6197,13183,20210103
20201231,8호선,장지,12432,12039,24471,20210103
20201231,8호선,문정,13886,14277,28163,20210103
20201231,8호선,가락시장,6259,6504,12763,20210103
20201231,8호선,송파,5829,5836,11665,20210103
20201231,8호선,석촌,5603,6286,11889,20210103
20201231,8호선,잠실(송파구청),10848,12065,22913,20210103
20201231,8호선,몽촌토성(평화의문),3830,4001,7831,20210103
20201231,8호선,강동구청,7637,8028,15665,20210103
20201231,8호선,천호(풍납토성),11750,13670,25420,20210103
20201231,8호선,암사,14001,12615,26616,20210103
20201231,7호선,부평구청,8227,7004,15231,20210103
20201231,7호선,굴포천,6398,6996,13394,20210103
20201231,7호선,삼산체육관,3354,2953,6307,20210103
20201231,7호선,상동,8695,9332,18027,20210103
20201231,7호선,부천시청,9106,9237,18343,20210103
20201231,7호선,신중동,10237,10228,20465,20210103
20201231,7호선,부천종합운동장,3259,2895,6154,20210103
20201231,7호선,까치울,5347,5255,10602,20210103
20201231,7호선,온수(성공회대입구),7753,7053,14806,20210103
20201231,7호선,천왕,7953,7555,15508,20210103
20201231,7호선,광명사거리,17675,17935,35610,20210103
20201231,7호선,철산,15489,16057,31546,20210103
20201231,7호선,가산디지털단지,32090,31384,63474,20210103
20201231,7호선,남구로,12039,12662,24701,20210103
20201231,7호선,대림(구로구청),6518,6766,13284,20210103
20201231,7호선,신풍,8586,8158,16744,20210103
20201231,7호선,보라매,6734,6526,13260,20210103
20201231,7호선,신대방삼거리,12502,11773,24275,20210103
20201231,7호선,장승배기,7437,7116,14553,20210103
20201231,7호선,상도,7415,6854,14269,20210103
20201231,7호선,숭실대입구(살피재),8359,8101,16460,20210103
20201231,7호선,남성,8412,7713,16125,20210103
20201231,7호선,이수,11137,10817,21954,20210103
20201231,7호선,내방,10440,10435,20875,20210103
20201231,7호선,고속터미널,11076,10491,21567,20210103
20201231,7호선,반포,4299,4096,8395,20210103
20201231,7호선,논현,13913,14712,28625,20210103
20201231,7호선,학동,16160,16488,32648,20210103
20201231,7호선,강남구청,11122,11737,22859,20210103
20201231,7호선,청담,13663,15062,28725,20210103
20201231,7호선,뚝섬유원지,4868,4906,9774,20210103
20201231,7호선,건대입구,9703,9309,19012,20210103
20201231,7호선,어린이대공원(세종대),8143,7648,15791,20210103
20201231,7호선,군자(능동),11069,8712,19781,20210103
20201231,7호선,중곡,7391,7068,14459,20210103
20201231,7호선,용마산(용마폭포공원),4576,4384,8960,20210103
20201231,7호선,사가정,12629,12702,25331,20210103
20201231,7호선,면목,11743,11686,23429,20210103
20201231,7호선,상봉(시외버스터미널),12966,12417,25383,20210103
20201231,7호선,중화,8570,8308,16878,20210103
20201231,7호선,먹골,7891,7732,15623,20210103
20201231,7호선,태릉입구,5793,5367,11160,20210103
20201231,7호선,공릉(서울과학기술대),8364,8149,16513,20210103
20201231,7호선,하계,12829,12233,25062,20210103
20201231,7호선,중계,10360,9344,19704,20210103
20201231,7호선,노원,15016,15819,30835,20210103
20201231,7호선,마들,9382,9140,18522,20210103
20201231,7호선,수락산,9369,9395,18764,20210103
20201231,7호선,도봉산,6209,7512,13721,20210103
20201231,7호선,장암,1492,644,2136,20210103
20201231,6호선,봉화산(서울의료원),6552,6241,12793,20210103
20201231,6호선,화랑대(서울여대입구),7640,6027,13667,20210103
20201231,6호선,태릉입구,3900,4136,8036,20210103
20201231,6호선,석계,9325,9336,18661,20210103
20201231,6호선,돌곶이,6209,5877,12086,20210103
20201231,6호선,상월곡(한국과학기술연구원),4548,3983,8531,20210103
20201231,6호선,월곡(동덕여대),8195,8108,16303,20210103
20201231,6호선,고려대(종암),5579,5038,10617,20210103
20201231,6호선,안암(고대병원앞),6701,5879,12580,20210103
20201231,6호선,보문,5502,4893,10395,20210103
20201231,6호선,창신,2500,1968,4468,20210103
20201231,6호선,동묘앞,5869,5838,11707,20210103
20201231,6호선,신당,5067,4642,9709,20210103
20201231,6호선,청구,2824,2984,5808,20210103
20201231,6호선,약수,2593,2546,5139,20210103
20201231,6호선,버티고개,1574,1476,3050,20210103
20201231,6호선,한강진,4439,5001,9440,20210103
20201231,6호선,이태원,6279,6662,12941,20210103
20201231,6호선,녹사평(용산구청),3340,3298,6638,20210103
20201231,6호선,삼각지,3739,3290,7029,20210103
20201231,6호선,효창공원앞,5078,4595,9673,20210103
20201231,6호선,공덕,12824,12346,25170,20210103
20201231,6호선,대흥(서강대앞),5478,5416,10894,20210103
20201231,6호선,광흥창(서강),5953,5760,11713,20210103
20201231,6호선,상수,5308,5718,11026,20210103
20201231,6호선,망원,10180,11077,21257,20210103
20201231,6호선,마포구청,10400,9203,19603,20210103
20201231,6호선,월드컵경기장(성산),3255,3545,6800,20210103
20201231,6호선,디지털미디어시티,9446,10238,19684,20210103
20201231,6호선,증산(명지대앞),7753,7540,15293,20210103
20201231,6호선,새절(신사),9441,8854,18295,20210103
20201231,6호선,구산,5494,4316,9810,20210103
20201231,6호선,독바위,2058,2162,4220,20210103
20201231,6호선,불광,3247,3334,6581,20210103
20201231,6호선,역촌,2817,3134,5951,20210103
20201231,6호선,응암,13351,13260,26611,20210103
20201231,5호선,하남풍산,3536,3683,7219,20210103
20201231,5호선,미사,9412,9245,18657,20210103
20201231,5호선,마천,4139,4139,8278,20210103
20201231,5호선,거여,5446,5273,10719,20210103
20201231,5호선,개롱,4273,4418,8691,20210103
20201231,5호선,오금,2515,2403,4918,20210103
20201231,5호선,방이,4624,4787,9411,20210103
20201231,5호선,올림픽공원(한국체대),2715,2294,5009,20210103
20201231,5호선,둔촌동,5941,5985,11926,20210103
20201231,5호선,상일동,11257,10289,21546,20210103
20201231,5호선,고덕,6113,6331,12444,20210103
20201231,5호선,명일,5849,6067,11916,20210103
20201231,5호선,굽은다리(강동구민회관앞),7026,6740,13766,20210103
20201231,5호선,길동,5950,6354,12304,20210103
20201231,5호선,강동,13987,12818,26805,20210103
20201231,5호선,천호(풍납토성),14168,13726,27894,20210103
20201231,5호선,광나루(장신대),9045,8109,17154,20210103
20201231,5호선,아차산(어린이대공원후문),10477,10457,20934,20210103
20201231,5호선,군자(능동),8174,8635,16809,20210103
20201231,5호선,장한평,13548,13492,27040,20210103
20201231,5호선,답십리,12164,11501,23665,20210103
20201231,5호선,마장,4352,4037,8389,20210103
20201231,5호선,왕십리(성동구청),3346,3686,7032,20210103
20201231,5호선,행당,5964,5245,11209,20210103
20201231,5호선,신금호,4585,4640,9225,20210103
20201231,5호선,청구,2941,2690,5631,20210103
20201231,5호선,동대문역사문화공원(DDP),2123,2530,4653,20210103
20201231,5호선,을지로4가,4571,4687,9258,20210103
20201231,5호선,종로3가,7107,7203,14310,20210103
20201231,5호선,광화문(세종문화회관),20957,21321,42278,20210103
20201231,5호선,서대문,12794,12974,25768,20210103
20201231,5호선,충정로(경기대입구),3444,3314,6758,20210103
20201231,5호선,애오개,4798,4818,9616,20210103
20201231,5호선,공덕,9591,10276,19867,20210103
20201231,5호선,마포,9872,10194,20066,20210103
20201231,5호선,여의나루,4303,4425,8728,20210103
20201231,5호선,여의도,18110,18584,36694,20210103
20201231,5호선,신길,2840,3014,5854,20210103
20201231,5호선,영등포시장,7077,7142,14219,20210103
20201231,5호선,영등포구청,3063,2923,5986,20210103
20201231,5호선,양평,5536,5424,10960,20210103
20201231,5호선,오목교(목동운동장앞),15951,17549,33500,20210103
20201231,5호선,목동,12084,13124,25208,20210103
20201231,5호선,신정(은행정),10614,8398,19012,20210103
20201231,5호선,까치산,22095,21505,43600,20210103
20201231,5호선,화곡,21617,20082,41699,20210103
20201231,5호선,우장산,9902,10149,20051,20210103
20201231,5호선,발산,12035,12239,24274,20210103
20201231,5호선,마곡,6598,6395,12993,20210103
20201231,5호선,송정,5077,4753,9830,20210103
20201231,5호선,김포공항,5496,5984,11480,20210103
20201231,5호선,개화산,3892,3799,7691,20210103
20201231,5호선,방화,4791,4619,9410,20210103
20201231,4호선,쌍문,22734,21216,43950,20210103
20201231,4호선,창동,19293,21086,40379,20210103
20201231,4호선,노원,14181,15774,29955,20210103
20201231,4호선,상계,14555,13902,28457,20210103
20201231,4호선,당고개,9173,8804,17977,20210103
20201231,4호선,남태령,764,639,1403,20210103
20201231,4호선,사당,16569,13698,30267,20210103
20201231,4호선,총신대입구(이수),13751,14793,28544,20210103
20201231,4호선,동작(현충원),1492,1605,3097,20210103
20201231,4호선,이촌(국립중앙박물관),4583,5047,9630,20210103
20201231,4호선,신용산,10743,11254,21997,20210103
20201231,4호선,삼각지,3183,3502,6685,20210103
20201231,4호선,숙대입구(갈월),8845,8622,17467,20210103
20201231,4호선,서울역,7181,10355,17536,20210103
20201231,4호선,회현(남대문시장),16893,17392,34285,20210103
20201231,4호선,명동,12459,13023,25482,20210103
20201231,4호선,충무로,19622,19849,39471,20210103
20201231,4호선,동대문역사문화공원(DDP),10626,9490,20116,20210103
20201231,4호선,동대문,13800,14101,27901,20210103
20201231,4호선,혜화,21171,20069,41240,20210103
20201231,4호선,한성대입구(삼선교),9624,9079,18703,20210103
20201231,4호선,성신여대입구(돈암),14713,14015,28728,20210103
20201231,4호선,길음,14471,13922,28393,20210103
20201231,4호선,미아사거리,21711,21670,43381,20210103
20201231,4호선,미아(서울사이버대학),11513,11346,22859,20210103
20201231,4호선,수유(강북구청),26894,26911,53805,20210103
20201231,3호선,오금,4209,3793,8002,20210103
20201231,3호선,경찰병원,5122,5002,10124,20210103
20201231,3호선,가락시장,6626,6241,12867,20210103
20201231,3호선,수서,10844,11321,22165,20210103
20201231,3호선,일원,6902,6400,13302,20210103
20201231,3호선,대청,7224,6406,13630,20210103
20201231,3호선,학여울,1159,1162,2321,20210103
20201231,3호선,대치,7074,7085,14159,20210103
20201231,3호선,도곡,3564,3582,7146,20210103
20201231,3호선,매봉,8567,8012,16579,20210103
20201231,3호선,양재(서초구청),26250,26556,52806,20210103
20201231,3호선,남부터미널(예술의전당),20317,22271,42588,20210103
20201231,3호선,교대(법원.검찰청),9179,6005,15184,20210103
20201231,3호선,고속터미널,30872,40368,71240,20210103
20201231,3호선,잠원,3187,3088,6275,20210103
20201231,3호선,신사,20990,21585,42575,20210103
20201231,3호선,압구정,23327,24261,47588,20210103
20201231,3호선,옥수,6211,6531,12742,20210103
20201231,3호선,금호,6111,5702,11813,20210103
20201231,3호선,약수,9397,8854,18251,20210103
20201231,3호선,동대입구,4849,4917,9766,20210103
20201231,3호선,충무로,1,0,1,20210103
20201231,3호선,을지로3가,7690,7902,15592,20210103
20201231,3호선,종로3가,7461,8504,15965,20210103
20201231,3호선,안국,9691,9998,19689,20210103
20201231,3호선,경복궁(정부서울청사),11645,11096,22741,20210103
20201231,3호선,독립문,5029,5073,10102,20210103
20201231,3호선,무악재,2814,2914,5728,20210103
20201231,3호선,홍제,12692,12367,25059,20210103
20201231,3호선,녹번,10971,9901,20872,20210103
20201231,3호선,불광,12092,13008,25100,20210103
20201231,3호선,연신내,28496,26899,55395,20210103
20201231,3호선,구파발,14670,13979,28649,20210103
20201231,3호선,지축,2280,2189,4469,20210103
20201231,2호선,용두(동대문구청),1844,1905,3749,20210103
20201231,2호선,신정네거리,7149,7626,14775,20210103
20201231,2호선,양천구청,4671,4944,9615,20210103
20201231,2호선,도림천,1230,1254,2484,20210103
20201231,2호선,신설동,2557,2521,5078,20210103
20201231,2호선,신답,1139,1289,2428,20210103
20201231,2호선,용답,1922,1914,3836,20210103
20201231,2호선,충정로(경기대입구),7048,7400,14448,20210103
20201231,2호선,아현,7221,7102,14323,20210103
20201231,2호선,이대,7879,7704,15583,20210103
20201231,2호선,신촌,22728,23054,45782,20210103
20201231,2호선,홍대입구,31592,33025,64617,20210103
20201231,2호선,합정,20723,21460,42183,20210103
20201231,2호선,당산,13164,15264,28428,20210103
20201231,2호선,영등포구청,17845,17616,35461,20210103
20201231,2호선,문래,15526,15667,31193,20210103
20201231,2호선,신도림,36413,35403,71816,20210103
20201231,2호선,대림(구로구청),18607,19215,37822,20210103
20201231,2호선,구로디지털단지,42920,42657,85577,20210103
20201231,2호선,신대방,20098,19167,39265,20210103
20201231,2호선,신림,48806,45435,94241,20210103
20201231,2호선,봉천,18235,16584,34819,20210103
20201231,2호선,서울대입구(관악구청),34844,31574,66418,20210103
20201231,2호선,낙성대(강감찬),20545,18414,38959,20210103
20201231,2호선,사당,24540,26261,50801,20210103
20201231,2호선,방배,10960,11235,22195,20210103
20201231,2호선,서초,14121,13914,28035,20210103
20201231,2호선,교대(법원.검찰청),22388,24612,47000,20210103
20201231,2호선,강남,54149,52740,106889,20210103
20201231,2호선,역삼,32102,33753,65855,20210103
20201231,2호선,선릉,36789,32451,69240,20210103
20201231,2호선,삼성(무역센터),32518,32559,65077,20210103
20201231,2호선,종합운동장,4290,4483,8773,20210103
20201231,2호선,잠실새내,14312,14435,28747,20210103
20201231,2호선,잠실(송파구청),45296,45848,91144,20210103
20201231,2호선,잠실나루,9717,9414,19131,20210103
20201231,2호선,강변(동서울터미널),21135,24718,45853,20210103
20201231,2호선,구의(광진구청),17588,17091,34679,20210103
20201231,2호선,건대입구,23591,24927,48518,20210103
20201231,2호선,성수,22858,24836,47694,20210103
20201231,2호선,뚝섬,14029,14809,28838,20210103
20201231,2호선,한양대,4453,4244,8697,20210103
20201231,2호선,왕십리(성동구청),11170,8888,20058,20210103
20201231,2호선,상왕십리,10185,9509,19694,20210103
20201231,2호선,신당,10467,10577,21044,20210103
20201231,2호선,동대문역사문화공원(DDP),7926,8366,16292,20210103
20201231,2호선,을지로4가,10122,10059,20181,20210103
20201231,2호선,을지로3가,14475,14581,29056,20210103
20201231,2호선,을지로입구,28487,28751,57238,20210103
20201231,2호선,시청,16193,15618,31811,20210103
20201231,1호선,청량리(서울시립대입구),15635,15369,31004,20210103
20201231,1호선,제기동,12913,13165,26078,20210103
20201231,1호선,신설동,10660,10116,20776,20210103
20201231,1호선,동대문,8387,7452,15839,20210103
20201231,1호선,종로5가,16665,16299,32964,20210103
20201231,1호선,종로3가,16680,15408,32088,20210103
20201231,1호선,종각,22516,21119,43635,20210103
20201231,1호선,시청,14889,14539,29428,20210103
20201231,1호선,동묘앞,5611,5743,11354,20210103
20201231,1호선,서울역,28417,28710,57127,20210103
20201231,6호선,합정,8964,9006,17970,20210103
20201231,중앙선,국수,448,464,912,20210103
20201231,중앙선,신원,115,97,212,20210103
20201231,중앙선,양수,970,1122,2092,20210103
20201231,중앙선,운길산,354,350,704,20210103
20201231,중앙선,팔당,545,575,1120,20210103
20201231,중앙선,도심,1627,1254,2881,20210103
20201231,중앙선,덕소,3820,4021,7841,20210103
20201231,중앙선,양정,562,480,1042,20210103
20201231,중앙선,도농,6674,6208,12882,20210103
20201231,중앙선,구리,9360,9938,19298,20210103
20201231,중앙선,양원,961,964,1925,20210103
20201231,중앙선,망우,5448,5506,10954,20210103
20201231,중앙선,상봉(시외버스터미널),4522,4338,8860,20210103
20201231,중앙선,중랑,4134,4043,8177,20210103
20201231,중앙선,회기,17307,15517,32824,20210103
20201231,장항선,신창(순천향대),903,717,1620,20210103
20201231,장항선,온양온천,2790,2885,5675,20210103
20201231,장항선,배방,800,693,1493,20210103
20201231,장항선,아산,2296,2414,4710,20210103
20201231,장항선,쌍용(나사렛대),1433,1294,2727,20210103
20201231,장항선,봉명,961,876,1837,20210103
20201231,일산선,대화,8989,7554,16543,20210103
20201231,중앙선,지평,19,17,36,20210103
20201231,중앙선,용문,863,1162,2025,20210103
20201231,중앙선,원덕,189,201,390,20210103
20201231,중앙선,양평,1571,1778,3349,20210103
20201231,중앙선,오빈,165,194,359,20210103
20201231,중앙선,아신,288,330,618,20210103
20201231,7호선,춘의,7338,7272,14610,20210103
20201231,일산선,주엽,5648,6010,11658,20210103
20201231,일산선,정발산,4911,4885,9796,20210103
20201231,일산선,마두,5098,5226,10324,20210103
20201231,일산선,백석,7446,7673,15119,20210103
20201231,일산선,대곡,1087,816,1903,20210103
20201231,일산선,화정,11738,12310,24048,20210103
20201231,일산선,원당,7679,7549,15228,20210103
20201231,일산선,삼송,12487,12707,25194,20210103
20201231,일산선,원흥,6582,6191,12773,20210103
20201231,우이신설선,신설동,1597,1574,3171,20210103
20201231,우이신설선,보문,1135,1154,2289,20210103
20201231,우이신설선,성신여대입구(돈암),2228,2481,4709,20210103
20201231,우이신설선,정릉,3268,3085,6353,20210103
20201231,우이신설선,북한산보국문,4161,4014,8175,20210103
20201231,우이신설선,솔샘,4036,3747,7783,20210103
20201231,우이신설선,삼양사거리,1750,1866,3616,20210103
20201231,우이신설선,삼양,1473,1673,3146,20210103
20201231,우이신설선,화계,2492,2340,4832,20210103
20201231,우이신설선,가오리,2887,2960,5847,20210103
20201231,우이신설선,4.19민주묘지,1899,1880,3779,20210103
20201231,우이신설선,솔밭공원,1717,1721,3438,20210103
20201231,우이신설선,북한산우이,1644,1458,3102,20210103
20201231,안산선,수리산,2946,2263,5209,20210103
20201231,안산선,오이도,5871,5909,11780,20210103
20201231,안산선,정왕,5764,6091,11855,20210103
20201231,안산선,신길온천,1155,1114,2269,20210103
20201231,안산선,안산,9334,9016,18350,20210103
20201231,안산선,초지,3073,3111,6184,20210103
20201231,안산선,고잔,5874,5755,11629,20210103
20201231,안산선,중앙,11278,12201,23479,20210103
20201231,안산선,한대앞,5964,6125,12089,20210103
20201231,안산선,상록수,11823,12078,23901,20210103
20201231,안산선,반월,3099,2882,5981,20210103
20201231,안산선,대야미,3446,3006,6452,20210103
20201231,안산선,산본,10929,11900,22829,20210103
20201231,수인선,인천,718,1197,1915,20210103
20201231,수인선,신포,1243,1309,2552,20210103
20201231,수인선,숭의,2841,2721,5562,20210103
20201231,수인선,인하대,3789,3591,7380,20210103
20201231,수인선,송도,1644,1605,3249,20210103
20201231,수인선,연수,3051,3145,6196,20210103
20201231,수인선,원인재,3311,3332,6643,20210103
20201231,수인선,남동인더스파크,1558,1794,3352,20210103
20201231,수인선,호구포,2884,2861,5745,20210103
20201231,수인선,인천논현,3882,4132,8014,20210103
20201231,수인선,소래포구,3095,3289,6384,20210103
20201231,수인선,월곶,1782,1703,3485,20210103
20201231,수인선,달월,84,59,143,20210103
20201231,수인선,사리,2447,2184,4631,20210103
20201231,수인선,야목,125,106,231,20210103
20201231,수인선,어천,494,380,874,20210103
20201231,수인선,오목천,1486,1314,2800,20210103
20201231,수인선,고색,2226,2093,4319,20210103
20201231,분당선,매교,1842,1840,3682,20210103
20201231,분당선,수원시청,8691,9397,18088,20210103
20201231,분당선,매탄권선,3379,3090,6469,20210103
20201231,분당선,망포,9713,8813,18526,20210103
20201231,분당선,영통,5624,5599,11223,20210103
20201231,분당선,청명,2790,2594,5384,20210103
20201231,분당선,상갈,3516,3364,6880,20210103
20201231,분당선,기흥,6322,6016,12338,20210103
20201231,분당선,신갈,2990,2985,5975,20210103
20201231,분당선,구성,3073,3284,6357,20210103
20201231,분당선,죽전,9370,10106,19476,20210103
20201231,분당선,보정,1468,1278,2746,20210103
20201231,분당선,이매,3538,3434,6972,20210103
20201231,분당선,오리,7987,6725,14712,20210103
20201231,분당선,미금,10753,11335,22088,20210103
20201231,분당선,정자,10359,10798,21157,20210103
20201231,분당선,수내,8836,8753,17589,20210103
20201231,분당선,서현,17501,17709,35210,20210103
20201231,분당선,야탑,17417,18826,36243,20210103
20201231,분당선,모란,14683,14626,29309,20210103
20201231,분당선,태평,10533,10483,21016,20210103
20201231,분당선,가천대,4716,5102,9818,20210103
20201231,분당선,선정릉,4996,5164,10160,20210103
20201231,분당선,강남구청,6213,6908,13121,20210103
20201231,분당선,압구정로데오,12774,13350,26124,20210103
20201231,분당선,서울숲,5318,5369,10687,20210103
20201231,분당선,수원,5947,4982,10929,20210103
20201231,분당선,수서,8235,9266,17501,20210103
20201231,분당선,대모산입구,2444,2241,4685,20210103
20201231,분당선,개포동,2552,2617,5169,20210103
20201231,분당선,구룡,1396,1277,2673,20210103
20201231,분당선,도곡,4368,4330,8698,20210103
20201231,분당선,한티,9500,9977,19477,20210103
20201231,분당선,선릉,8891,12702,21593,20210103
20201231,과천선,범계,17330,17208,34538,20210103
20201231,과천선,평촌,11053,11010,22063,20210103
20201231,과천선,인덕원,15540,16073,31613,20210103
20201231,과천선,정부과천청사,5986,6055,12041,20210103
20201231,과천선,과천,3418,3122,6540,20210103
20201231,과천선,대공원,978,1023,2001,20210103
20201231,과천선,경마공원,728,708,1436,20210103
20201231,과천선,선바위,5539,5067,10606,20210103
20201231,공항철도 1호선,영종,1901,2310,4211,20210103
20201231,공항철도 1호선,인천공항2터미널,1700,1723,3423,20210103
20201231,공항철도 1호선,인천공항1터미널,2964,3398,6362,20210103
20201231,공항철도 1호선,공항화물청사,1935,2042,3977,20210103
20201231,공항철도 1호선,운서,4664,4608,9272,20210103
20201231,공항철도 1호선,청라국제도시,4467,4326,8793,20210103
20201231,공항철도 1호선,검암,4969,4993,9962,20210103
20201231,공항철도 1호선,계양,6259,6154,12413,20210103
20201231,공항철도 1호선,김포공항,7263,5226,12489,20210103
20201231,공항철도 1호선,마곡나루(서울식물원),3483,3587,7070,20210103
20201231,공항철도 1호선,디지털미디어시티,8669,7642,16311,20210103
20201231,공항철도 1호선,홍대입구,5479,5299,10778,20210103
20201231,공항철도 1호선,공덕,1501,1910,3411,20210103
20201231,공항철도 1호선,서울역,4877,4836,9713,20210103
20201231,경춘선,춘천,808,772,1580,20210103
20201231,경춘선,남춘천,1634,1803,3437,20210103
20201231,경춘선,김유정,132,147,279,20210103
20201231,경춘선,강촌,157,237,394,20210103
20201231,경춘선,백양리,44,36,80,20210103
20201231,경춘선,굴봉산,55,73,128,20210103
20201231,경춘선,가평,863,1139,2002,20210103
20201231,경춘선,상천,121,128,249,20210103
20201231,경춘선,청평,898,1079,1977,20210103
20201231,경춘선,대성리,279,287,566,20210103
20201231,경춘선,마석,2570,2540,5110,20210103
20201231,경춘선,천마산,1121,1121,2242,20210103
20201231,경춘선,평내호평,4013,4161,8174,20210103
20201231,경춘선,금곡,968,955,1923,20210103
20201231,경춘선,사릉,2372,2372,4744,20210103
20201231,경춘선,퇴계원,2519,2371,4890,20210103
20201231,경춘선,별내,1853,1773,3626,20210103
20201231,경춘선,갈매,2002,1780,3782,20210103
20201231,경춘선,신내,953,943,1896,20210103
20201231,경인선,도화,2968,2655,5623,20210103
20201231,경인선,중동,6435,6357,12792,20210103
20201231,경인선,온수(성공회대입구),4759,4621,9380,20210103
20201231,경인선,도원,2134,2269,4403,20210103
20201231,경인선,간석,4045,3906,7951,20210103
20201231,경인선,부개,6225,6027,12252,20210103
20201231,경인선,소사,6875,6300,13175,20210103
20201231,경인선,구일,4323,4415,8738,20210103
20201231,경인선,인천,2197,1758,3955,20210103
20201231,경인선,동인천,9921,9762,19683,20210103
20201231,경인선,제물포,7340,7048,14388,20210103
20201231,경인선,주안,13700,12747,26447,20210103
20201231,경인선,동암,11567,12110,23677,20210103
20201231,경인선,백운,5145,5165,10310,20210103
20201231,경인선,부평,22446,24645,47091,20210103
20201231,경인선,송내,20072,20289,40361,20210103
20201231,경인선,부천,25286,26301,51587,20210103
20201231,경인선,역곡,19833,19979,39812,20210103
20201231,경인선,오류동,8968,8382,17350,20210103
20201231,경인선,개봉,15889,16570,32459,20210103
20201231,경의선,임진강,1,2,3,20210103
20201231,경의선,문산,3337,3503,6840,20210103
20201231,경의선,파주,724,513,1237,20210103
20201231,경의선,월롱,1568,1227,2795,20210103
20201231,경의선,금촌,4610,4555,9165,20210103
20201231,경의선,금릉,2983,3022,6005,20210103
20201231,경의선,운정,4160,4020,8180,20210103
20201231,경의선,야당,4048,3900,7948,20210103
20201231,경의선,탄현,5000,5129,10129,20210103
20201231,경의선,일산,6028,6391,12419,20210103
20201231,경의선,풍산,3491,3454,6945,20210103
20201231,경의선,백마,4303,4369,8672,20210103
20201231,경의선,곡산,356,377,733,20210103
20201231,경의선,능곡,2517,2336,4853,20210103
20201231,경의선,행신,5268,5381,10649,20210103
20201231,경의선,강매,2083,1775,3858,20210103
20201231,경의선,화전,930,853,1783,20210103
20201231,경의선,수색,1568,1599,3167,20210103
20201231,경의선,디지털미디어시티,1684,1630,3314,20210103
20201231,경의선,가좌,3643,3396,7039,20210103
20201231,경의선,홍대입구,1054,1120,2174,20210103
20201231,경의선,서강대,1376,1286,2662,20210103
20201231,경의선,공덕,2414,2122,4536,20210103
20201231,경의선,효창공원앞,2124,2436,4560,20210103
20201231,경의선,신촌,541,633,1174,20210103
20201231,경의선,서울역,2512,3329,5841,20210103
20201231,경원선,소요산,1522,1401,2923,20210103
20201231,경원선,동두천,1379,1589,2968,20210103
20201231,경원선,동두천중앙,2155,2219,4374,20210103
